"Address A","Port A","Address B","Port B","Packets","Bytes","Packets A → B","Bytes A → B","Packets B → A","Bytes B → A","Rel Start","Duration","Bits/s A → B","Bits/s B → A"
"41.106.176.15","40923","41.177.241.46","443","4698","592698","1721","279642","2977","313056","0.019084000","234.4461","9542.22","10682.40"
"244.3.176.118","3389","244.3.153.55","2637","2351","254190","1009","108440","1342","145750","0.019254000","234.4460","3700.30","4973.43"
"41.177.3.224","9504","41.177.143.72","1744","1949","1856026","1122","1436618","827","419408","0.015751000","234.3549","49040.77","14317.02"
"41.177.3.224","43836","41.177.117.184","1607","2630","1250479","1341","663090","1289","587389","0.363297000","233.9071","22678.75","20089.65"
"68.157.168.194","47365","41.177.26.91","80","7078","6313548","2972","256804","4106","6056744","0.012384000","233.8482","8785.32","207202.59"
"41.177.244.185","51175","244.3.210.254","5900","1113","250602","544","38080","569","212522","0.470995000","233.4103","1305.17","7284.06"
"253.213.108.81","1729","253.37.253.43","23","52","53430","0","0","52","53430","0.621005000","233.3997","N/A","1831.37"
"41.177.244.177","56182","244.3.210.254","5900","1325","295173","649","45430","676","249743","0.460614000","233.3884","1557.23","8560.60"
"244.3.93.198","4112","41.177.241.108","3389","443","39132","221","14144","222","24988","0.305426000","233.3106","484.98","856.81"
"41.177.241.254","3389","244.3.93.198","1904","484","34682","242","18802","242","15880","0.663992000","233.1708","645.09","544.84"
"68.33.164.161","7746","244.3.160.239","80","2319","2051481","856","59920","1463","1991561","0.707266000","233.0317","2057.06","68370.48"
"244.3.160.239","60101","176.41.89.210","80","2300","2027573","837","53568","1463","1974005","0.706013000","233.0057","1839.20","67775.33"
"41.177.31.94","49240","244.3.47.39","3260","234","23868","156","14664","78","9204","0.269200000","231.2613","507.27","318.39"
"244.3.64.188","49647","41.177.241.46","443","48","3720","24","1968","24","1752","2.423047000","231.0318","68.15","60.67"
"41.177.3.224","47468","41.177.117.184","1610","205","79718","126","38941","79","40777","0.816327000","230.3041","1352.68","1416.46"
"41.177.3.224","51349","41.177.117.184","1618","206","79825","126","38933","80","40892","0.013152000","230.2673","1352.62","1420.68"
"41.177.3.224","51334","41.177.117.184","1618","206","79829","126","38941","80","40888","0.025954000","230.2545","1352.97","1420.62"
"41.177.3.203","58386","41.177.3.224","1791","161","57267","102","27521","59","29746","3.718803000","230.2520","956.20","1033.51"
"41.177.3.224","50412","41.177.117.184","1613","157","55314","102","26713","55","28601","3.388644000","230.2517","928.13","993.73"
"41.177.3.224","51236","41.177.117.184","1613","196","75384","122","37102","74","38282","0.454080000","230.2463","1289.12","1330.12"
"41.177.3.224","50391","41.177.117.184","1610","205","79714","126","38933","79","40781","1.520654000","230.2297","1352.84","1417.05"
"41.177.3.224","50371","41.177.117.184","1605","157","55361","102","26713","55","28648","1.318037000","230.2223","928.25","995.49"
"41.177.3.224","51281","41.177.117.184","1605","203","78934","125","38558","78","40376","0.073228000","230.2072","1339.94","1403.12"
"41.177.3.203","58381","41.177.3.224","1791","201","78371","122","38505","79","39866","3.556787000","230.2040","1338.12","1385.41"
"41.177.3.224","51186","41.177.117.184","1606","203","78868","125","38546","78","40322","0.313034000","230.1774","1339.70","1401.42"
"41.177.3.224","51146","41.177.117.184","1606","205","79686","126","38921","79","40765","0.766625000","230.1438","1352.93","1417.03"
"41.177.3.224","49020","41.177.117.184","1606","157","55314","102","26713","55","28601","1.620516000","230.1299","928.62","994.26"
"41.177.3.224","51211","41.177.117.184","1607","205","79722","126","38941","79","40781","0.991600000","230.1288","1353.71","1417.68"
"41.177.3.224","50327","41.177.117.184","1618","158","55425","102","26713","56","28712","1.840434000","230.1199","928.66","998.16"
"41.177.3.224","50382","41.177.117.184","1607","157","55314","102","26713","55","28601","0.796332000","230.1141","928.69","994.32"
"41.106.176.15","29201","41.177.241.46","443","80","8180","40","5218","40","2962","0.037766000","230.0041","181.49","103.02"
"41.177.3.224","51255","41.177.117.184","1605","203","78938","125","38566","78","40372","0.073223000","229.9972","1341.44","1404.26"
"41.106.176.15","41343","41.177.241.46","443","2996","789426","1199","139851","1797","649575","4.521062000","229.9517","4865.40","22598.65"
"41.177.117.203","1632","244.3.153.177","1554","138","19734","46","6394","92","13340","1.716578000","229.6908","222.70","464.62"
"244.3.160.248","46938","41.177.26.193","80","1021","840320","387","24768","634","815552","2.316278000","229.5732","863.10","28419.76"
"244.3.160.248","46646","41.177.26.193","80","841","726746","313","20032","528","706714","4.236257000","229.1996","699.20","24667.20"
"122.244.155.71","35022","41.177.98.127","210","250","107862","136","13192","114","94670","0.092827000","228.4511","461.96","3315.20"
"41.177.3.224","39054","41.177.117.184","1606","559","309391","284","179083","275","130308","2.306721000","227.9737","6284.34","4572.74"
"244.3.153.13","1485","41.177.202.249","22","225","22806","134","11980","91","10826","0.372072000","227.3356","421.58","380.97"
"41.177.3.224","65162","41.177.117.184","1606","290","84022","154","43474","136","40548","3.382916000","227.3175","1529.98","1427.01"
"41.177.93.176","1340","244.3.41.84","23","84","31866","45","3726","39","28140","0.504793000","226.7087","131.48","992.99"
"151.77.15.90","1211","41.177.241.46","443","54","4418","27","2406","27","2012","3.327555000","226.4074","85.01","71.09"
"41.177.3.224","51372","41.177.117.184","1618","250","71067","134","37168","116","33899","7.028420000","226.4019","1313.35","1197.83"
"244.3.31.117","58914","41.177.98.220","7000","26","3388","14","1839","12","1549","2.935638000","226.4005","64.98","54.73"
"253.213.108.56","1191","253.37.253.43","23","25","25092","0","0","25","25092","1.183065000","226.3181","N/A","886.96"
"41.177.3.224","40080","41.177.117.184","1610","428","256880","216","148248","212","108632","0.077169000","225.5933","5257.18","3852.31"
"41.177.3.224","58575","41.177.117.184","1605","421","253308","219","145312","202","107996","1.224651000","225.5416","5154.24","3830.64"
"41.177.3.224","51309","41.177.117.184","1605","435","149952","225","67456","210","82496","6.103592000","225.4368","2393.79","2927.51"
"41.177.3.224","51373","41.177.117.184","1618","241","77952","128","40064","113","37888","4.953722000","225.3267","1422.43","1345.18"
"41.177.3.224","51312","41.177.117.184","1605","208","57856","112","30656","96","27200","2.866182000","225.3143","1088.47","965.76"
"41.177.3.224","48741","41.177.117.184","1607","202","78840","124","38502","78","40338","4.561166000","225.2993","1367.14","1432.33"
"41.177.3.224","51307","41.177.117.184","1605","210","58016","112","30656","98","27360","2.889652000","225.2908","1088.58","971.54"
"41.177.3.224","65161","41.177.117.184","1606","208","57696","112","30592","96","27104","0.601967000","225.2785","1086.37","962.51"
"41.177.3.224","40064","41.177.117.184","1610","208","57616","112","30624","96","26992","0.609342000","225.2711","1087.54","958.56"
"41.177.3.224","65238","41.177.117.184","1613","337","126592","176","65952","161","60640","2.493073000","225.2674","2342.18","2153.53"
"41.177.3.224","51374","41.177.117.184","1618","208","57680","112","30624","96","27056","0.630171000","225.2503","1087.64","960.92"
"41.177.3.224","65167","41.177.117.184","1606","209","57840","113","30656","96","27184","0.650767000","225.2297","1088.88","965.56"
"41.177.3.224","65164","41.177.117.184","1606","209","57776","113","30592","96","27184","0.650772000","225.2297","1086.61","965.56"
"41.177.3.224","51306","41.177.117.184","1605","208","59168","112","30656","96","28512","2.950761000","225.2297","1088.88","1012.73"
"41.177.3.224","51313","41.177.117.184","1605","208","57792","112","30592","96","27200","7.161544000","225.2188","1086.66","966.17"
"41.177.3.224","65168","41.177.117.184","1606","240","77920","128","39968","112","37952","0.669245000","225.2112","1419.75","1348.14"
"41.177.3.224","65163","41.177.117.184","1606","208","57956","112","30592","96","27364","0.673827000","225.2067","1086.72","972.05"
"41.177.13.249","1052","244.3.41.84","23","35","17025","20","1407","15","15618","9.043239000","225.1814","49.99","554.86"
"41.177.3.224","40058","41.177.117.184","1610","240","78080","128","40064","112","38016","0.706905000","225.1736","1423.40","1350.64"
"41.177.3.224","38682","41.177.117.184","1607","240","78112","128","40096","112","38016","0.706913000","225.1736","1424.54","1350.64"
"41.177.3.224","40052","41.177.117.184","1610","209","57904","112","30624","97","27280","4.904326000","225.1661","1088.05","969.24"
"41.177.3.224","38681","41.177.117.184","1607","208","57648","112","30656","96","26992","3.859969000","225.1604","1089.21","959.03"
"41.177.3.224","50396","41.177.117.184","1610","154","54436","100","26282","54","28154","4.712698000","225.1477","933.86","1000.37"
"41.177.93.64","1156","244.3.41.84","23","176","86454","88","10559","88","75895","6.795338000","224.6828","375.96","2702.30"
"41.106.176.15","56908","41.177.241.46","443","1403","351021","549","86721","854","264300","9.311269000","223.9749","3097.53","9440.34"
"41.106.180.77","1269","41.177.241.46","443","48","3720","24","1968","24","1752","1.716062000","223.8522","70.33","62.61"
"244.3.39.224","52661","41.177.241.46","443","48","3720","24","1968","24","1752","0.051774000","223.7001","70.38","62.66"
"41.106.176.15","33082","41.177.241.46","443","86","9098","43","5805","43","3293","6.856902000","223.3893","207.89","117.93"
"41.106.176.15","40950","41.177.241.46","443","129","13574","60","7982","69","5592","10.368854000","223.1159","286.20","200.51"
"41.177.117.153","35504","244.3.41.84","1522","189","61870","95","38634","94","23236","11.019640000","222.2987","1390.35","836.21"
"151.77.15.210","1127","41.177.241.46","443","50","3953","25","2137","25","1816","10.572791000","222.2795","76.91","65.36"
"41.106.176.15","44756","41.177.241.46","443","112","12562","54","7900","58","4662","9.981291000","222.2455","284.37","167.81"
"244.3.77.239","51805","41.177.241.46","443","56","4232","24","1968","32","2264","8.092332000","221.6724","71.02","81.71"
"151.77.15.118","1678","41.177.241.46","443","50","4249","25","2224","25","2025","12.084037000","221.5904","80.29","73.11"
"244.3.31.117","58832","41.177.98.220","7000","289","51170","158","22620","131","28550","2.921981000","220.6432","820.15","1035.16"
"244.3.90.4","59976","41.177.98.92","22","7885","7318830","2741","213338","5144","7105492","8.766078000","220.5568","7738.16","257729.27"
"151.77.15.248","49363","41.177.241.46","443","48","3720","24","1968","24","1752","11.880557000","220.2747","71.47","63.63"
"244.3.210.254","52502","41.177.244.142","548","49","3912","20","1672","29","2240","13.228724000","220.2226","60.74","81.37"
"41.106.176.15","47278","41.177.241.46","443","102","10978","49","7075","53","3903","4.232573000","220.1753","257.07","141.81"
"244.3.153.142","49633","41.177.31.98","22","46","4462","23","2990","23","1472","6.449515000","220.1413","108.66","53.49"
"244.3.34.165","1093","41.177.3.224","22","46","4462","23","2990","23","1472","4.696294000","220.1342","108.66","53.49"
"244.3.153.25","49421","41.177.24.241","5222","10","980","5","660","5","320","2.661192000","220.0933","23.99","11.63"
"41.177.24.241","5222","244.3.153.13","1201","12","1512","6","788","6","724","5.566691000","220.0719","28.65","26.32"
"41.177.24.108","5222","244.3.153.77","1368","10","980","5","320","5","660","4.521248000","220.0572","11.63","23.99"
"244.3.153.142","50867","244.3.124.145","22","46","4462","23","2990","23","1472","7.007545000","220.0167","108.72","53.52"
"244.3.153.142","55544","244.3.124.153","22","46","4462","23","2990","23","1472","7.247756000","220.0165","108.72","53.52"
"41.177.98.220","7010","244.3.185.188","2031","104","19807","44","12897","60","6910","9.362081000","218.5484","472.10","252.94"
"41.177.98.220","7010","41.177.168.251","1365","50","15175","23","8691","27","6484","5.437749000","218.2011","318.64","237.73"
"77.139.113.224","2347","41.177.241.46","443","48","3885","24","2047","24","1838","9.428022000","217.3861","75.33","67.64"
"244.3.153.30","1770","244.3.176.224","445","46452","34019200","18173","1392547","28279","32626653","0.001961000","216.6563","51419.58","1204733.95"
"244.3.41.84","2643","244.3.31.67","1592","191","65228","102","35812","89","29416","16.707697000","215.5142","1329.36","1091.94"
"41.177.244.177","49192","244.3.210.90","548","72","5644","36","2872","36","2772","5.620335000","215.1431","106.79","103.08"
"41.177.98.220","7010","244.3.79.181","1234","178","64826","82","54642","96","10184","10.803434000","215.0853","2032.38","378.79"
"41.177.66.219","3259","41.177.98.176","80","6","5430","0","0","6","5430","6.333923000","214.5423","N/A","202.48"
"41.177.98.220","7010","244.3.79.176","1531","280","113663","120","84601","160","29062","4.668582000","214.5282","3154.87","1083.75"
"41.106.180.77","49572","41.177.241.46","443","48","3720","24","1968","24","1752","4.367445000","214.2044","73.50","65.43"
"244.3.41.84","2626","244.3.31.67","1592","550","230228","294","136128","256","94100","4.536014000","213.9353","5090.44","3518.82"
"151.77.15.40","2382","41.177.241.46","443","46","3565","23","1877","23","1688","6.630262000","213.8913","70.20","63.13"
"41.177.93.251","1619","244.3.41.84","23","75","38086","38","5004","37","33082","13.874328000","213.8882","187.16","1237.36"
"41.106.180.77","25958","41.177.241.46","443","43","3415","22","1882","21","1533","4.476612000","213.1430","70.64","57.54"
"151.77.15.128","1123","41.177.241.46","443","51","4338","25","2245","26","2093","17.549151000","213.0000","84.32","78.61"
"244.3.153.77","1386","244.3.176.224","445","30","3402","19","1977","11","1425","12.964020000","212.9604","74.27","53.53"
"244.3.153.89","2282","244.3.176.224","445","24","2288","16","1400","8","888","20.525331000","212.9595","52.59","33.36"
"244.3.153.156","2788","41.177.202.0","445","30","3194","19","1823","11","1371","9.920399000","212.9264","68.49","51.51"
"151.77.15.152","49420","41.177.241.46","443","46","3565","23","1877","23","1688","4.722112000","212.7775","70.57","63.47"
"244.3.153.156","1543","41.177.202.249","445","39","4372","23","2357","16","2015","9.920336000","212.7559","88.63","75.77"
"151.77.15.155","3876","41.177.241.46","443","46","3643","23","1982","23","1661","16.926997000","212.7363","74.53","62.46"
"151.77.15.128","3055","41.177.241.46","443","44","3410","22","1813","22","1597","11.978265000","212.6384","68.21","60.08"
"151.77.15.13","49197","41.177.241.46","443","44","3602","22","2005","22","1597","13.806904000","212.2364","75.58","60.20"
"41.106.180.77","47084","41.177.241.46","443","46","3565","23","1877","23","1688","8.570756000","212.0908","70.80","63.67"
"41.177.98.220","7030","41.177.199.31","1555","243","39322","123","24082","120","15240","17.514318000","211.8895","909.23","575.39"
"41.177.3.224","52682","41.177.117.184","1618","567","316029","286","180189","281","135840","9.241135000","211.8094","6805.70","5130.65"
"90.48.117.203","49370","41.177.241.46","443","46","3565","23","1877","23","1688","5.933240000","211.6883","70.93","63.79"
"41.177.3.224","9510","41.177.143.72","1275","1733","1653558","1006","1288447","727","365111","0.096389000","211.3419","48772.04","13820.68"
"41.177.98.220","7030","41.177.168.68","1416","203","33776","103","21154","100","12622","9.213905000","211.0175","801.98","478.52"
"41.177.3.224","43838","41.177.117.184","1607","2540","1202251","1292","637186","1248","565065","0.740497000","210.6501","24198.84","21459.85"
"41.177.3.224","40016","41.177.117.184","1607","381","235911","195","136356","186","99555","13.004788000","210.5657","5180.56","3782.38"
"41.177.3.203","36735","41.177.3.224","1791","381","243055","198","141734","183","101321","13.901567000","210.4221","5388.56","3852.10"
"41.177.3.224","40118","41.177.117.184","1613","377","236443","196","136760","181","99683","10.277091000","210.3909","5200.22","3790.39"
"41.106.176.15","42496","41.177.241.46","443","106","12244","51","6898","55","5346","17.360305000","210.3554","262.34","203.31"
"41.177.3.224","51305","41.177.117.184","1605","195","54210","105","28680","90","25530","14.717115000","210.3233","1090.89","971.08"
"41.177.3.224","38680","41.177.117.184","1607","195","54045","105","28740","90","25305","13.638277000","210.1422","1094.12","963.35"
"41.177.244.142","49225","244.3.210.90","548","78","6273","39","3129","39","3144","5.620364000","210.0125","119.19","119.76"
"244.3.153.197","49699","41.177.24.241","5222","27","5354","16","2024","11","3330","2.423617000","209.7873","77.18","126.99"
"244.3.153.13","1251","41.177.202.249","445","96017","15805073","48231","7753233","47786","8051840","27.538439000","206.9393","299729.77","311273.52"
"253.254.77.24","3601","253.37.253.43","23","44","37326","0","0","44","37326","19.161195000","205.9649","N/A","1449.80"
"244.3.210.254","19813","41.177.244.128","2743","12","804","6","402","6","402","12.408417000","203.7873","15.78","15.78"
"168.67.39.121","1450","244.3.210.197","80","384","313896","167","42691","217","271205","13.954360000","201.6032","1694.06","10761.93"
"41.177.3.224","9506","41.177.143.106","2879","2850","2773167","1682","2144716","1168","628451","0.097684000","200.6062","85529.39","25062.08"
"244.3.210.254","19813","41.177.244.90","3965","12","804","6","402","6","402","0.781917000","200.5577","16.04","16.04"
"244.3.153.67","1359","41.177.202.249","445","1512","213206","760","114204","752","99002","28.829773000","200.5424","4555.80","3949.37"
"244.3.210.254","19813","41.177.244.38","2157","12","804","6","402","6","402","23.857609000","200.5385","16.04","16.04"
"244.3.210.254","19813","41.177.244.142","4944","12","804","6","402","6","402","16.891444000","200.5044","16.04","16.04"
"244.3.210.254","19813","244.3.106.254","4227","12","804","6","402","6","402","33.923606000","200.4727","16.04","16.04"
"244.3.210.254","19813","41.177.244.141","4752","12","804","6","402","6","402","14.724942000","200.4707","16.04","16.04"
"244.3.210.254","19813","244.3.3.185","1742","12","804","6","402","6","402","15.931146000","200.4401","16.04","16.04"
"244.3.210.254","19813","41.177.244.220","2860","12","804","6","402","6","402","10.558545000","200.4369","16.04","16.04"
"41.177.3.224","43840","41.177.117.184","1607","2473","1174448","1257","620440","1216","554008","0.073240000","200.4076","24767.13","22115.25"
"41.177.244.177","63123","244.3.210.254","19813","12","912","6","456","6","456","30.130125000","200.2303","18.22","18.22"
"41.106.176.15","30525","41.177.241.46","443","84","9083","42","6019","42","3064","17.936169000","200.1900","240.53","122.44"
"41.177.244.124","55919","244.3.210.254","19813","12","912","6","456","6","456","23.758208000","200.1188","18.23","18.23"
"41.106.176.15","28445","41.177.241.46","443","175","23422","74","12296","101","11126","15.489897000","200.0984","491.60","444.82"
"41.177.244.177","54781","244.3.210.254","19813","13","1022","7","532","6","490","18.058024000","199.9037","21.29","19.61"
"41.177.93.203","1133","244.3.41.84","23","48","25864","20","2262","28","23602","4.475289000","199.1743","90.86","947.99"
"41.177.98.143","8001","82.181.188.253","1305","61","6563","29","3328","32","3235","35.501461000","198.5592","134.09","130.34"
"41.177.98.220","7010","244.3.185.203","1299","103","75781","64","72248","39","3533","16.016401000","197.2778","2929.80","143.27"
"41.177.98.220","7010","244.3.185.201","2175","24","3447","9","1638","15","1809","25.456746000","197.2687","66.43","73.36"
"244.3.153.117","49379","41.177.24.241","5222","30","5228","15","3264","15","1964","22.297417000","197.2013","132.41","79.67"
"41.177.93.17","1149","244.3.41.84","23","29","2279","29","2279","0","0","35.316613000","196.6747","92.70","N/A"
"244.3.153.209","4213","244.3.176.224","445","2944","1072932","1431","343024","1513","729908","27.284333000","196.3792","13973.94","29734.64"
"41.177.3.224","9508","41.177.143.72","1400","1896","1827393","1102","1412387","794","415006","0.673339000","196.3273","57552.34","16910.78"
"244.3.79.176","1684","41.177.98.167","1521","465","65103","234","27738","231","37365","27.183119000","195.7255","1133.75","1527.24"
"41.177.3.224","9507","41.177.143.106","3576","3058","3004118","1806","2291065","1252","713053","0.358150000","195.5330","93736.21","29173.72"
"244.3.41.84","2652","244.3.31.67","1592","202","70934","105","39829","97","31105","11.245901000","195.3698","1630.92","1273.69"
"41.177.56.222","1620","244.3.41.84","23","126","31026","57","4784","69","26242","28.556408000","195.2498","196.02","1075.22"
"41.177.98.220","7030","41.177.110.39","1758","67","12263","32","8063","35","4200","25.644454000","194.7796","331.16","172.50"
"41.177.98.220","7010","244.3.142.138","2387","138","46622","64","38611","74","8011","37.128845000","194.6752","1586.68","329.20"
"244.3.241.204","2309","244.3.160.239","80","5","328","0","0","5","328","10.924426000","191.9977","N/A","13.67"
"253.213.108.188","1894","253.37.253.43","23","26","27786","0","0","26","27786","0.925973000","191.7583","N/A","1159.21"
"41.177.3.224","9502","41.177.143.106","3079","2453","2403365","1450","1860132","1003","543233","0.960302000","190.3366","78182.82","22832.51"
"41.177.244.224","63522","244.3.210.254","19813","14","1104","8","614","6","490","32.922588000","190.2551","25.82","20.60"
"244.3.111.39","1450","244.3.41.84","23","35","16133","16","3945","19","12188","16.646944000","189.6887","166.38","514.02"
"253.213.108.145","1509","253.37.253.43","23","46","51959","0","0","46","51959","18.793381000","188.0735","N/A","2210.16"
"203.22.116.204","1711","244.3.41.84","23","44","15659","25","1721","19","13938","32.453113000","187.9052","73.27","593.41"
"253.180.108.127","1230","253.37.253.43","23","138","47987","0","0","138","47987","12.478209000","184.0039","N/A","2086.35"
"194.66.204.209","4513","244.3.41.84","23","212","93014","103","8277","109","84737","44.182863000","183.5694","360.71","3692.86"
"41.177.24.241","5222","244.3.153.156","1191","33","5796","17","4028","16","1768","21.822691000","183.3398","175.76","77.15"
"244.3.41.84","2632","244.3.31.67","1592","111","48284","58","28811","53","19473","0.283521000","183.1210","1258.67","850.72"
"41.177.98.220","7010","244.3.142.22","1125","364","263297","208","249271","156","14026","3.561020000","182.5799","10922.17","614.57"
"244.3.153.48","1513","244.3.176.224","445","21","2002","14","1225","7","777","28.081244000","182.5596","53.68","34.05"
"244.3.153.48","1519","41.177.3.117","445","21","2002","14","1225","7","777","28.082437000","182.5585","53.68","34.05"
"223.72.203.218","50967","41.177.26.151","80","16","7840","8","822","8","7018","51.359228000","182.4906","36.03","307.65"
"244.3.41.84","2636","244.3.31.67","1592","84","28069","45","13578","39","14491","30.774819000","182.4766","595.28","635.30"
"244.3.34.55","3888","244.3.31.40","22","12","1104","8","744","4","360","33.883948000","181.6667","32.76","15.85"
"244.3.153.34","52687","41.177.24.241","993","40","11121","22","5402","18","5719","25.360492000","181.5387","238.05","252.02"
"244.3.153.34","52684","41.177.24.241","993","25","2358","16","1392","9","966","25.308482000","181.1190","61.48","42.67"
"244.3.153.111","2450","41.177.3.117","445","68","14760","36","7480","32","7280","24.617065000","180.7163","331.13","322.27"
"244.3.31.84","31111","41.177.180.176","3938","8","728","0","0","8","728","34.737236000","180.5327","N/A","32.26"
"244.3.141.84","31100","244.3.41.84","2594","13","1202","5","398","8","804","6.989960000","180.4358","17.65","35.65"
"244.3.31.84","31100","244.3.41.84","2596","12","1132","4","328","8","804","6.998674000","180.4267","14.54","35.65"
"253.37.253.31","1132","253.37.253.254","1024","8","512","4","256","4","256","22.077482000","180.3789","11.35","11.35"
"244.3.31.84","61562","41.177.180.176","31111","4","328","0","0","4","328","34.849782000","180.3367","N/A","14.55"
"244.3.153.142","51016","41.177.24.241","5222","25","5165","14","1753","11","3412","32.477652000","180.2881","77.79","151.40"
"244.3.153.142","55497","244.3.176.68","445","18","1716","12","1050","6","666","29.551668000","180.2821","46.59","29.55"
"244.3.153.142","50774","41.177.46.23","445","397","176422","172","18727","225","157695","29.551743000","180.2821","831.01","6997.70"
"41.106.176.15","53786","41.177.241.46","443","32","7703","13","5140","19","2563","35.082644000","180.2657","228.11","113.74"
"244.3.31.84","61344","244.3.41.84","31100","12","1128","8","800","4","328","22.080874000","180.2486","35.51","14.56"
"41.106.180.77","60133","41.177.241.46","443","31","6911","13","4412","18","2499","45.156963000","180.2335","195.83","110.92"
"168.91.64.164","39710","244.3.210.255","1723","12","864","4","312","8","552","32.806014000","180.2017","13.85","24.51"
"244.3.141.84","47736","244.3.41.84","31100","12","1128","8","800","4","328","6.963820000","180.1653","35.52","14.56"
"151.77.15.128","1864","41.177.241.46","443","28","5724","12","3632","16","2092","12.818075000","180.1191","161.32","92.92"
"244.3.210.255","1152","242.194.160.18","80","16","8388","8","744","8","7644","45.494493000","180.0718","33.05","339.60"
"203.123.156.224","48891","41.177.98.156","25","4","480","0","0","4","480","49.346830000","180.0325","N/A","21.33"
"203.68.117.241","50074","41.177.26.91","8000","4","256","0","0","4","256","9.876327000","180.0324","N/A","11.38"
"41.177.26.151","8000","66.55.75.213","2123","4","256","4","256","0","0","30.886660000","180.0324","11.38","N/A"
"41.177.26.91","8000","214.111.3.85","4762","4","5672","4","5672","0","0","39.706967000","180.0323","252.04","N/A"
"244.3.153.34","52693","41.177.24.241","5222","21","4375","14","1687","7","2688","28.006113000","180.0060","74.98","119.46"
"244.3.153.34","52694","41.177.24.241","5222","21","4487","14","1687","7","2800","28.043619000","180.0056","74.98","124.44"
"168.82.82.108","2237","41.177.26.176","80","4","6040","0","0","4","6040","34.324318000","179.9999","N/A","268.44"
"165.160.217.193","55540","41.177.26.176","80","4","5032","0","0","4","5032","5.734425000","179.9998","N/A","223.64"
"41.177.176.156","16077","244.3.160.239","80","4","256","0","0","4","256","4.004497000","179.9979","N/A","11.38"
"90.210.201.231","8421","244.3.160.239","80","4","280","0","0","4","280","7.544479000","179.9979","N/A","12.44"
"254.204.39.13","11148","244.3.160.239","80","4","6072","0","0","4","6072","19.694523000","179.9979","N/A","269.87"
"244.3.153.197","49700","41.177.4.31","5222","15","3205","10","1205","5","2000","32.475215000","179.3840","53.74","89.19"
"244.3.153.239","1492","41.177.24.241","993","12","1008","8","616","4","392","54.324284000","178.4284","27.62","17.58"
"41.106.180.204","58774","41.177.241.46","443","10","640","0","0","10","640","45.831786000","175.4250","N/A","29.19"
"41.177.98.220","7010","244.3.142.57","1884","67","41876","37","25762","30","16114","58.801142000","175.3469","1175.36","735.18"
"41.177.93.84","1106","244.3.41.84","23","21","9284","10","815","11","8469","9.909858000","174.3085","37.40","388.69"
"244.3.41.84","2629","244.3.31.67","1592","82","32078","45","17857","37","14221","29.678890000","174.2107","820.02","653.05"
"122.244.155.71","52380","41.177.98.127","210","12","2529","8","862","4","1667","29.650705000","173.4847","39.75","76.87"
"41.177.24.241","5222","244.3.153.111","2490","10","1140","5","548","5","592","9.526783000","173.3108","25.30","27.33"
"41.177.98.143","8001","224.41.61.218","1316","85","14051","42","9919","43","4132","52.603581000","173.2320","458.07","190.82"
"253.116.23.165","3885","253.37.253.43","23","33","23013","0","0","33","23013","5.874253000","170.4123","N/A","1080.34"
"41.177.24.241","5222","244.3.153.67","1280","36","6216","18","2416","18","3800","9.811482000","170.1530","113.59","178.66"
"41.177.98.220","7080","244.3.79.201","1479","129","92850","79","88590","50","4260","57.269022000","169.3802","4184.20","201.20"
"244.3.79.176","1686","41.177.98.167","1521","3726","664668","1874","214270","1852","450398","31.656601000","168.1792","10192.46","21424.67"
"41.177.98.220","7010","244.3.79.176","1689","1126","358422","537","182793","589","175629","31.964199000","168.0722","8700.69","8359.69"
"41.177.13.164","1254","244.3.41.84","23","76","39324","36","5294","40","34030","12.186521000","166.4518","254.44","1635.55"
"41.177.24.241","5222","244.3.153.56","3885","8","784","4","256","4","528","14.772140000","165.1275","12.40","25.58"
"41.177.24.241","5222","244.3.153.106","2239","10","1316","5","724","5","592","30.785864000","165.1256","35.08","28.68"
"41.177.24.108","5222","244.3.153.235","1659","8","784","4","256","4","528","52.773992000","165.1239","12.40","25.58"
"41.177.24.247","5222","244.3.153.55","1560","8","784","4","256","4","528","23.908045000","165.1226","12.40","25.58"
"41.177.24.241","5222","244.3.153.48","1175","8","784","4","256","4","528","29.547606000","165.0681","12.41","25.59"
"41.177.24.241","5222","244.3.153.209","3930","8","784","4","256","4","528","51.320331000","165.0621","12.41","25.59"
"41.177.24.241","5222","244.3.153.30","1160","8","784","4","256","4","528","44.775451000","165.0616","12.41","25.59"
"41.177.24.247","5222","244.3.153.40","1361","8","784","4","256","4","528","50.381583000","165.0521","12.41","25.59"
"41.177.24.241","5222","244.3.153.0","3066","24","3712","12","768","12","2944","24.740907000","165.0501","37.23","142.70"
"41.177.24.241","5222","244.3.153.33","1707","8","784","4","256","4","528","33.008347000","165.0433","12.41","25.59"
"41.177.98.220","7010","41.177.211.160","1338","128","30892","58","20823","70","10069","5.254938000","164.0058","1015.72","491.15"
"244.3.34.157","1448","244.3.41.84","23","388","150475","254","16986","134","133489","47.719471000","163.2084","832.60","6543.24"
"244.3.41.120","1032","244.3.41.185","1024","16","4382","7","452","9","3930","35.385286000","160.3773","22.55","196.04"
"244.3.41.47","1049","244.3.41.185","1024","16","4382","7","452","9","3930","35.385251000","160.3380","22.55","196.09"
"244.3.210.254","19813","244.3.77.218","1214","10","670","5","332","5","338","38.873606000","160.3215","16.57","16.87"
"253.37.253.251","1081","253.37.253.254","1024","32","9670","14","913","18","8757","42.097378000","160.2811","45.57","437.08"
"41.177.244.188","52599","244.3.210.254","19813","10","760","5","374","5","386","38.573365000","160.0726","18.69","19.29"
"253.213.108.105","1679","253.37.253.43","23","17","18277","0","0","17","18277","74.822710000","159.2761","N/A","918.00"
"41.177.4.139","54447","244.3.41.84","1522","155","29798","87","19530","68","10268","71.224578000","159.0735","982.19","516.39"
"244.3.153.111","2769","41.177.24.241","993","13","1054","7","528","6","526","45.252399000","157.4728","26.82","26.72"
"41.177.142.37","3279","244.3.41.84","23","8","1025","4","260","4","765","32.449104000","157.3812","13.22","38.89"
"41.177.132.22","32284","244.3.41.84","23","8","1025","4","260","4","765","32.457920000","157.3288","13.22","38.90"
"41.177.142.111","2758","244.3.41.84","23","7","957","3","194","4","763","32.469213000","157.1873","9.87","38.83"
"41.177.3.224","49373","41.177.117.184","1606","401","189656","204","98783","197","90873","43.511616000","156.9692","5034.52","4631.38"
"41.177.98.98","43556","244.3.31.94","7300","81","22657","45","7442","36","15215","2.947630000","156.4930","380.44","777.80"
"253.142.253.218","2470","253.37.253.43","23","11","4868","0","0","11","4868","53.585837000","153.4141","N/A","253.85"
"41.177.142.41","4924","244.3.41.84","23","26","12945","14","1985","12","10960","73.928311000","153.1894","103.66","572.36"
"18.132.77.186","7423","244.3.160.239","80","8","528","1","66","7","462","53.254016000","152.9981","N/A","24.16"
"18.132.77.186","14299","244.3.160.239","80","8","560","1","70","7","490","53.206422000","152.9957","N/A","25.62"
"253.213.108.150","1832","253.37.253.43","23","53","56481","0","0","53","56481","0.825773000","151.7906","N/A","2976.79"
"41.177.98.220","7030","244.3.79.181","1219","15","2720","6","1577","9","1143","79.387334000","151.4390","83.31","60.38"
"90.218.241.186","39830","244.3.210.197","80","342","311646","127","18761","215","292885","73.474080000","150.9021","994.60","15527.15"
"41.177.93.210","1175","244.3.41.84","23","12","5032","6","413","6","4619","0.973624000","150.0268","22.02","246.30"
"41.177.181.165","1687","244.3.41.84","23","45","19278","18","1737","27","17541","15.246269000","147.6292","94.13","950.54"
"41.177.3.224","50020","41.177.117.184","1606","490","237511","246","121431","244","116080","53.117830000","147.3629","6592.21","6301.72"
"41.177.98.143","8001","244.110.40.40","2085","82","10590","41","7936","41","2654","2.891278000","146.2779","434.02","145.15"
"77.139.113.224","2179","41.177.241.46","443","6","384","0","0","6","384","4.317934000","144.1059","N/A","21.32"
"244.3.160.239","61886","176.41.89.121","80","2021","1788585","733","48345","1288","1740240","93.577585000","140.7142","2748.55","98937.57"
"41.177.40.117","3251","244.3.160.239","80","1842","1777299","553","37017","1289","1740282","93.574274000","140.6214","2105.91","99005.23"
"68.83.168.127","3854","244.3.210.197","80","630","543095","242","42356","388","500739","9.547326000","138.9026","2439.46","28839.71"
"40.193.210.13","23561","244.3.210.197","80","223","169409","92","14975","131","154434","31.650668000","138.6318","864.16","8911.89"
"68.83.168.127","3883","244.3.210.197","80","314","242836","130","28083","184","214753","11.213708000","137.2363","1637.06","12518.73"
"41.177.98.98","43796","244.3.31.33","10030","17","2009","10","1240","7","769","17.042131000","136.3986","72.73","45.10"
"26.244.48.209","55686","41.177.26.91","8000","9","576","0","0","9","576","83.847573000","136.3716","N/A","33.79"
"244.3.153.177","1907","244.3.160.80","443","16","3749","8","1619","8","2130","52.046325000","135.2643","95.75","125.98"
"15.68.47.117","65486","244.3.210.197","80","47","39768","18","2859","29","36909","96.032587000","134.2502","170.37","2199.42"
"89.161.209.108","10897","244.3.210.197","80","234","179626","100","21274","134","158352","31.158994000","134.1235","1268.92","9445.15"
"89.161.209.108","10933","244.3.210.197","80","150","118036","64","12805","86","105231","31.667225000","133.6153","766.68","6300.54"
"90.218.241.186","39985","244.3.210.197","80","142","122212","58","13230","84","108982","86.041837000","133.3343","793.79","6538.87"
"244.3.160.248","45813","41.177.26.193","80","447","358666","171","10944","276","347722","1.096138000","132.7827","659.36","20949.83"
"246.121.210.224","63477","244.3.210.197","80","29","22451","11","1761","18","20690","62.729499000","132.5532","106.28","1248.71"
"46.194.188.194","49440","244.3.210.197","80","27","20803","11","1732","16","19071","73.020200000","132.2625","104.76","1153.52"
"15.225.3.77","54233","244.3.210.197","80","31","23732","13","1225","18","22507","3.888272000","131.3941","74.58","1370.35"
"15.225.3.77","41776","244.3.210.197","80","13","2277","7","1169","6","1108","3.888276000","131.3941","71.18","67.46"
"46.194.188.194","49444","244.3.210.197","80","8","2493","4","584","4","1909","74.630300000","130.6523","35.76","116.89"
"41.177.98.220","7020","41.177.225.164","2248","2242","741629","1183","609430","1059","132199","98.599965000","127.2887","38302.22","8308.61"
"244.3.34.194","34018","244.3.160.254","22","138","14521","88","7996","50","6525","10.685075000","126.6685","505.00","412.10"
"16.225.66.90","15032","41.177.26.176","80","38","21130","13","2195","25","18935","103.707261000","125.5470","139.87","1206.56"
"253.94.153.215","3086","253.37.253.167","22","156","14774","91","7814","65","6960","106.008242000","124.8550","500.68","445.96"
"244.3.153.248","49376","41.177.24.241","993","7","568","4","308","3","260","40.983891000","124.2044","19.84","16.75"
"41.106.180.77","18610","41.177.241.46","443","45","8358","20","2306","25","6052","93.848072000","123.3592","149.55","392.48"
"223.72.203.218","50967","41.177.26.151","8000","6","384","0","0","6","384","81.717448000","122.9526","N/A","24.99"
"253.213.108.77","1510","253.37.253.43","23","5","4971","0","0","5","4971","62.833196000","122.2427","N/A","325.32"
"244.3.164.145","3245","41.177.98.176","80","81","60137","30","7170","51","52967","96.229348000","121.6808","471.40","3482.36"
"41.177.3.224","9406","244.3.41.117","1618","6","2538","2","404","4","2134","78.866994000","121.5820","26.58","140.42"
"41.177.3.224","9403","244.3.41.117","2760","14","9961","6","3429","8","6532","78.828611000","121.4465","225.88","430.28"
"244.3.153.41","1360","41.177.24.241","993","6","504","4","308","2","196","16.402633000","121.0965","20.35","12.95"
"244.3.93.241","4827","41.177.241.253","139","4","256","2","128","2","128","63.522164000","120.7545","8.48","8.48"
"194.66.204.47","1173","244.3.41.84","23","24","14145","10","1095","14","13050","20.236499000","120.6480","72.61","865.33"
"244.3.153.34","56366","41.177.24.241","993","18","5308","10","2580","8","2728","86.154846000","120.4216","171.40","181.23"
"244.3.153.33","1803","244.3.176.224","445","4","256","2","128","2","128","95.068535000","120.4148","8.50","8.50"
"41.177.3.224","9404","244.3.41.117","4370","78","51205","39","37023","39","14182","53.079253000","120.3340","2461.35","942.84"
"244.3.153.41","1329","41.177.3.117","445","4","256","2","128","2","128","79.212501000","120.3283","8.51","8.51"
"244.3.153.103","1705","244.3.176.224","445","4","256","2","128","2","128","65.450757000","120.3151","8.51","8.51"
"244.3.153.108","3228","244.3.176.224","445","4","256","2","128","2","128","13.380499000","120.0997","8.53","8.53"
"244.3.153.22","1801","244.3.176.224","445","4","256","2","128","2","128","92.286138000","120.0984","8.53","8.53"
"244.3.153.0","3057","41.177.3.117","445","4","256","2","128","2","128","32.181984000","120.0367","8.53","8.53"
"244.3.153.177","1559","41.177.3.117","445","4","256","2","128","2","128","26.385233000","120.0328","8.53","8.53"
"83.155.208.75","36642","41.177.26.46","80","4","256","2","128","2","128","11.482240000","120.0003","8.53","8.53"
"83.155.208.75","13157","41.177.26.46","80","4","256","2","128","2","128","9.482322000","120.0000","8.53","8.53"
"90.210.201.231","10557","244.3.160.239","80","3","210","0","0","3","210","50.393961000","119.9986","N/A","14.00"
"90.210.201.231","16363","244.3.160.239","80","3","210","0","0","3","210","11.474387000","119.9986","N/A","14.00"
"90.210.201.231","7545","244.3.160.239","80","3","210","0","0","3","210","8.984425000","119.9986","N/A","14.00"
"151.77.192.83","6116","244.3.160.239","80","3","4554","0","0","3","4554","16.674573000","119.9986","N/A","303.60"
"90.210.201.231","13594","244.3.160.239","80","3","4554","0","0","3","4554","59.044095000","119.9986","N/A","303.60"
"90.210.201.231","10008","244.3.160.239","80","3","210","0","0","3","210","50.993977000","119.9985","N/A","14.00"
"244.3.153.25","50740","41.177.24.241","993","6","504","4","308","2","196","17.890831000","119.8680","20.56","13.08"
"68.164.185.120","10422","244.3.210.197","80","66","57253","26","5433","40","51820","97.173017000","119.6967","363.12","3463.42"
"41.177.98.220","7030","244.3.79.224","1804","187","93308","102","84649","85","8659","9.292590000","117.0142","5787.26","592.00"
"68.164.185.120","10425","244.3.210.197","80","38","30080","15","2278","23","27802","103.524455000","113.3452","160.78","1962.29"
"244.3.153.25","50818","244.3.160.80","443","8846","6925700","5743","6441644","3103","484056","75.455443000","113.2424","455069.48","34196.10"
"68.164.185.120","10427","244.3.210.197","80","35","28577","14","2205","21","26372","104.151611000","112.7214","156.49","1871.66"
"68.164.185.120","10426","244.3.210.197","80","14","7105","7","1803","7","5302","104.151616000","112.7214","127.96","376.29"
"244.3.144.142","3076","244.3.41.84","23","7","1553","4","275","3","1278","32.471508000","112.4430","19.57","90.93"
"244.3.64.176","49496","41.177.26.214","22","310","39332","197","17822","113","21510","4.109996000","111.4715","1279.04","1543.71"
"41.177.98.220","7010","244.3.164.138","1206","49","14327","22","11546","27","2781","105.099729000","109.8252","841.05","202.58"
"253.201.253.26","2047","253.37.253.43","23","12","10460","0","0","12","10460","4.828263000","106.2006","N/A","787.94"
"41.177.98.220","7010","244.3.185.209","1266","86","41071","42","19393","44","21678","19.802217000","105.0029","1477.52","1651.61"
"41.177.98.220","7020","244.3.93.229","1501","273","53821","139","36479","134","17342","87.329814000","103.9216","2808.19","1335.01"
"198.177.110.202","35239","41.177.26.22","80","11","1667","6","578","5","1089","87.159574000","100.2500","46.12","86.90"
"41.177.13.205","1099","244.3.41.84","23","24","7398","14","977","10","6421","32.458938000","99.6011","78.47","515.74"
"41.177.98.220","7010","244.3.185.209","1130","51","13293","25","9604","26","3689","13.470672000","96.9109","792.81","304.53"
"253.213.108.239","2313","253.37.253.43","23","16","16172","0","0","16","16172","28.539843000","95.4316","N/A","1355.69"
"253.142.253.106","1655","253.37.253.43","23","10","8957","0","0","10","8957","73.346059000","94.0476","N/A","761.91"
"90.218.193.20","3885","244.3.160.239","80","43","32198","12","1681","31","30517","105.581948000","93.1502","144.37","2620.88"
"41.177.181.91","1310","244.3.41.84","23","92","13409","61","4028","31","9381","14.984054000","92.2946","349.14","813.13"
"223.72.203.218","50968","41.177.26.151","80","1342","1316646","464","31173","878","1285473","51.360038000","91.4154","2728.03","112495.08"
"128.119.167.108","1089","41.177.26.15","80","1296","1134657","520","35430","776","1099227","79.013917000","90.9805","3115.39","96656.02"
"253.213.108.30","1510","253.37.253.43","23","22","20132","0","0","22","20132","143.508399000","90.4697","N/A","1780.22"
"41.177.98.220","7030","244.3.142.106","3950","1190","984291","756","949227","434","35064","137.170821000","89.5648","84785.68","3131.94"
"41.106.90.203","50774","244.3.210.197","80","98","76721","44","5977","54","70744","63.806920000","89.5331","534.06","6321.14"
"154.176.214.143","52910","41.177.26.91","8000","4","6072","0","0","4","6072","130.677978000","87.6013","N/A","554.51"
"71.138.110.40","1654","244.3.210.197","80","199","138494","92","29061","107","109433","5.932982000","87.4405","2658.81","10012.12"
"71.138.110.40","1655","244.3.210.197","80","191","134127","89","30414","102","103713","6.877549000","86.4963","2812.98","9592.37"
"244.3.79.15","1858","244.3.41.84","23","24","7243","14","969","10","6274","72.940874000","85.7731","90.38","585.17"
"241.157.67.72","3199","41.177.98.156","25","168","137869","92","132516","76","5353","113.524685000","85.5404","12393.31","500.63"
"41.177.98.220","7020","244.3.79.224","1409","693","170049","388","132806","305","37243","147.444742000","83.9308","12658.62","3549.88"
"168.84.123.138","59255","41.177.26.91","80","2900","3386586","672","43482","2228","3343104","93.778481000","83.3586","4173.01","320840.61"
"241.157.67.72","2979","41.177.98.156","25","22","10499","11","9558","11","941","30.774738000","82.5213","926.60","91.22"
"244.3.153.25","50815","244.3.160.80","443","37","15901","17","4621","20","11280","0.074868000","82.1737","449.88","1098.16"
"41.177.98.220","7010","244.3.79.163","1180","95","64955","53","61178","42","3777","147.737584000","81.6806","5991.92","369.93"
"198.208.198.164","14003","41.177.26.176","80","64","31248","27","4642","37","26606","54.861807000","80.4629","461.53","2645.30"
"198.208.198.164","14065","41.177.26.176","80","47","29638","22","2586","25","27052","55.240528000","80.2352","257.84","2697.27"
"244.3.160.248","47255","41.177.26.55","80","24","12361","11","2555","13","9806","28.821603000","79.6000","256.78","985.53"
"253.176.160.161","3754","253.37.253.43","23","50","25773","0","0","50","25773","77.998834000","78.4695","N/A","2627.57"
"90.108.47.67","16687","244.3.210.197","80","90","73965","37","9109","53","64856","127.967849000","77.4746","940.59","6697.01"
"90.108.47.67","16688","244.3.210.197","80","37","25542","18","5722","19","19820","127.975044000","77.4673","590.91","2046.80"
"90.108.47.67","16689","244.3.210.197","80","44","27925","22","7943","22","19982","127.978147000","77.4643","820.30","2063.61"
"90.108.47.67","16690","244.3.210.197","80","57","43239","24","8711","33","34528","127.978152000","77.4643","899.61","3565.83"
"90.108.47.67","16692","244.3.210.197","80","71","53415","32","9840","39","43575","127.978159000","77.4643","1016.21","4500.14"
"90.108.47.67","16691","244.3.210.197","80","37","19022","20","9127","17","9895","127.978156000","77.4642","942.58","1021.89"
"41.177.3.224","9505","41.177.143.106","3736","1630","1574019","948","1203963","682","370056","120.723972000","76.5734","125783.87","38661.55"
"41.106.90.203","65099","244.3.210.197","80","56","43318","26","2595","30","40723","64.400498000","75.8243","273.79","4296.56"
"244.3.188.241","1946","244.3.41.84","23","14","2511","7","454","7","2057","32.466932000","75.6481","48.01","217.53"
"15.205.242.71","2121","244.3.210.197","80","10","1505","6","1039","4","466","87.169779000","75.6235","109.91","49.30"
"41.106.90.203","57853","244.3.210.197","80","15","6878","8","1321","7","5557","64.459077000","75.2819","140.38","590.53"
"41.106.90.203","52461","244.3.210.197","80","25","15965","12","1612","13","14353","64.401269000","75.2765","171.32","1525.36"
"41.106.90.203","60371","244.3.210.197","80","15","6545","8","1311","7","5234","64.457718000","75.2619","139.35","556.35"
"41.106.90.203","53647","244.3.210.197","80","25","15576","12","1614","13","13962","64.400961000","75.2532","171.58","1484.27"
"41.77.105.0","3096","244.3.210.197","80","40","25665","22","7204","18","18461","72.229759000","75.1284","767.11","1965.81"
"41.106.90.203","58642","244.3.210.197","80","22","13632","11","1517","11","12115","64.350804000","75.1062","161.58","1290.44"
"41.106.90.203","64180","244.3.210.197","80","20","11918","10","1453","10","10465","64.348876000","75.1048","154.77","1114.71"
"41.106.90.203","52720","244.3.210.197","80","22","12687","11","1524","11","11163","64.347440000","75.0884","162.37","1189.32"
"41.106.90.203","59126","244.3.210.197","80","11","4347","6","1171","5","3176","64.457871000","75.0205","124.87","338.68"
"41.106.90.203","51542","244.3.210.197","80","11","4281","6","1177","5","3104","64.459758000","75.0192","125.51","331.01"
"41.106.90.203","56323","244.3.210.197","80","11","4194","6","1172","5","3022","64.456444000","75.0127","124.99","322.29"
"41.77.105.0","3099","244.3.210.197","80","58","43045","29","6831","29","36214","72.344010000","75.0123","728.52","3862.19"
"41.106.90.203","53248","244.3.210.197","80","11","3483","6","1172","5","2311","64.456366000","74.9989","125.02","246.51"
"41.106.90.203","52807","244.3.210.197","80","11","3245","6","1184","5","2061","64.456170000","74.9972","126.30","219.85"
"41.106.90.203","51869","244.3.210.197","80","67","56087","29","3065","38","53022","79.067947000","74.8304","327.67","5668.50"
"41.106.90.203","55202","244.3.210.197","80","36","24425","18","2281","18","22144","79.077351000","74.7586","244.09","2369.65"
"41.106.90.203","60208","244.3.210.197","80","48","36540","22","2565","26","33975","79.068174000","74.6951","274.72","3638.79"
"41.106.90.203","50211","244.3.210.197","80","26","16895","13","1932","13","14963","79.068687000","74.5833","207.23","1604.97"
"41.106.90.203","55043","244.3.210.197","80","20","12547","10","1709","10","10838","79.069566000","74.3701","183.84","1165.84"
"41.106.90.203","61565","244.3.210.197","80","17","9335","9","1674","8","7661","79.071159000","74.3516","180.12","824.30"
"41.106.90.203","56634","244.3.210.197","80","11","3938","6","1462","5","2476","79.073569000","74.3336","157.34","266.47"
"41.106.90.203","56207","244.3.210.197","80","11","4046","6","1462","5","2584","79.073061000","74.3331","157.35","278.10"
"41.106.90.203","49991","244.3.210.197","80","11","4077","6","1462","5","2615","79.074224000","74.3318","157.35","281.44"
"41.106.90.203","62675","244.3.210.197","80","11","4087","6","1462","5","2625","79.074004000","74.3295","157.35","282.53"
"41.106.90.203","62901","244.3.210.197","80","11","3956","6","1462","5","2494","79.071855000","74.3285","157.36","268.43"
"41.106.90.203","64726","244.3.210.197","80","10","2562","6","1426","4","1136","79.069127000","74.3231","153.49","122.28"
"41.106.90.203","56813","244.3.210.197","80","10","2701","6","1432","4","1269","79.068713000","74.3226","154.14","136.59"
"41.106.90.203","63433","244.3.210.197","80","10","2930","6","1427","4","1503","79.068885000","74.3210","153.60","161.78"
"244.3.153.25","50825","244.3.160.80","443","107","55281","50","16487","57","38794","124.592668000","74.3117","1774.90","4176.35"
"244.3.181.123","9363","244.3.160.239","80","6","1272","4","1142","2","130","30.718299000","74.1024","123.29","14.03"
"244.3.160.239","62175","40.248.176.156","80","531","494629","184","13207","347","481422","120.621615000","74.0405","1427.00","52017.17"
"253.142.108.39","4437","253.37.253.43","23","8","5448","0","0","8","5448","146.253789000","74.0344","N/A","588.70"
"41.202.64.43","58218","41.177.26.176","80","10","1536","6","599","4","937","36.914911000","74.0050","64.75","101.29"
"253.180.253.142","1259","253.37.253.43","23","10","8879","0","0","10","8879","102.812736000","73.9636","N/A","960.36"
"244.3.181.123","13213","244.3.160.239","80","6","1292","4","1162","2","130","30.906031000","73.9153","125.77","14.07"
"18.198.66.77","49640","244.3.210.197","80","61","47603","27","11561","34","36042","66.115780000","73.1108","1265.04","3943.82"
"18.198.66.77","49642","244.3.210.197","80","87","72987","36","10456","51","62531","66.663267000","72.5618","1152.78","6894.10"
"18.198.66.77","49641","244.3.210.197","80","56","43143","25","11324","31","31819","66.661508000","72.5599","1248.51","3508.16"
"18.198.66.77","49645","244.3.210.197","80","55","41969","25","11326","30","30643","66.669162000","72.5591","1248.75","3378.54"
"18.198.66.77","49644","244.3.210.197","80","46","33731","22","10266","24","23465","66.666716000","72.5567","1131.92","2587.22"
"18.198.66.77","49643","244.3.210.197","80","44","30692","21","11091","23","19601","66.664787000","72.5551","1222.91","2161.23"
"177.71.203.41","62680","244.3.210.197","80","240","206353","94","16216","146","190137","102.647386000","72.2014","1796.75","21067.40"
"244.3.176.118","3389","244.3.153.77","1449","1078","472863","600","425306","478","47557","163.229006000","71.0472","47889.96","5354.97"
"203.210.244.128","64395","244.3.210.197","80","92","82165","35","13581","57","68584","135.720867000","70.4545","1542.10","7787.60"
"48.244.145.177","2881","244.3.210.197","80","7","1516","5","1042","2","474","102.956188000","70.0319","119.03","54.15"
"203.210.244.128","64396","244.3.210.197","80","49","33041","24","14458","25","18583","136.220126000","69.9553","1653.40","2125.13"
"48.244.145.177","2883","244.3.210.197","80","75","68230","29","6357","46","61873","103.356798000","69.6327","730.35","7108.50"
"122.145.57.132","47465","244.3.210.197","80","102","73722","47","14099","55","59623","104.260899000","69.5187","1622.47","6861.23"
"41.203.225.103","1729","244.3.210.197","80","146","107816","69","35313","77","72503","43.376362000","69.1811","4083.55","8384.14"
"48.244.145.177","2885","244.3.210.197","80","45","35084","20","6438","25","28646","103.833981000","69.1563","744.75","3313.77"
"48.244.145.177","2887","244.3.210.197","80","42","32655","19","7397","23","25258","103.836206000","69.1550","855.70","2921.90"
"48.244.145.177","2886","244.3.210.197","80","35","25399","17","7175","18","18224","103.834845000","69.1543","830.03","2108.21"
"48.244.145.177","2889","244.3.210.197","80","44","33656","20","7659","24","25997","103.838017000","69.1520","886.05","3007.52"
"48.244.145.177","2888","244.3.210.197","80","35","26581","17","7206","18","19375","103.837774000","69.1519","833.64","2241.44"
"241.75.202.251","52678","41.177.98.143","8001","11","4096","0","0","11","4096","163.418429000","69.1109","N/A","474.14"
"122.145.57.132","63163","244.3.210.197","80","96","65448","49","20692","47","44756","105.158233000","68.6216","2412.30","5217.72"
"41.203.225.103","1732","244.3.210.197","80","193","159587","86","28944","107","130643","44.718152000","67.8415","3413.13","15405.68"
"177.71.203.41","22042","244.3.210.197","80","217","191891","82","14959","135","176932","103.720613000","67.5221","1772.34","20962.85"
"253.213.108.176","1597","253.37.253.43","23","32","33733","0","0","32","33733","61.228482000","67.3887","N/A","4004.59"
"68.67.164.34","4375","244.3.210.197","80","14","11902","6","1805","8","10097","1.153775000","67.3164","214.51","1199.95"
"244.3.31.64","2967","244.3.153.33","1818","20","3791","9","2117","11","1674","47.946674000","67.3116","251.61","198.96"
"68.67.164.34","4374","244.3.210.197","80","8","4414","5","1822","3","2592","1.163800000","67.3111","216.55","308.06"
"244.3.153.25","50817","244.3.160.80","443","19","6649","8","1555","11","5094","44.855371000","67.1819","185.17","606.59"
"41.177.241.61","51833","244.3.41.84","23","92","48888","46","3107","46","45781","0.822639000","66.6373","373.00","5496.14"
"41.177.98.220","7020","244.3.142.41","1103","478","91652","229","59972","249","31680","162.241007000","66.5240","7212.07","3809.75"
"215.203.31.218","49232","244.3.210.197","80","179","171120","66","13313","113","157807","43.302978000","66.4019","1603.93","19012.34"
"215.203.31.218","49234","244.3.210.197","80","728","782540","215","23338","513","759202","43.327432000","66.3832","2812.52","91493.27"
"215.203.31.218","49237","244.3.210.197","80","91","75279","37","11825","54","63454","43.331381000","66.3792","1425.14","7647.45"
"215.203.31.218","49235","244.3.210.197","80","206","189615","76","14567","130","175048","43.327437000","66.3775","1755.66","21097.28"
"215.203.31.218","49233","244.3.210.197","80","100","88126","40","12092","60","76034","43.327420000","66.3736","1457.45","9164.36"
"215.203.31.218","49236","244.3.210.197","80","117","111822","44","9828","73","101994","43.331376000","66.3697","1184.64","12294.05"
"18.181.90.197","53573","41.177.98.176","80","70","50994","29","6525","41","44469","113.390120000","66.2515","787.91","5369.72"
"41.177.57.211","51424","244.3.210.197","80","8","2452","5","611","3","1841","70.019001000","65.9085","74.16","223.46"
"244.3.160.248","47506","41.177.26.55","80","49","32445","21","6912","28","25533","42.525210000","65.8963","839.14","3099.78"
"41.77.105.0","3095","244.3.210.197","80","30","15868","18","6956","12","8912","72.227243000","65.1964","853.54","1093.56"
"41.77.105.0","3097","244.3.210.197","80","23","9452","15","5940","8","3512","72.296766000","65.1253","729.67","431.41"
"41.77.105.0","3098","244.3.210.197","80","24","11500","15","5943","9","5557","72.342505000","65.0827","730.52","683.07"
"41.77.105.0","3100","244.3.210.197","80","23","9560","15","5930","8","3630","72.345767000","65.0815","728.93","446.21"
"68.67.164.34","4376","244.3.210.197","80","8","4540","5","1814","3","2726","0.444800000","64.9984","223.27","335.52"
"41.177.98.220","7010","41.177.110.130","1262","39","20398","18","9815","21","10583","74.941796000","64.9556","1208.83","1303.41"
"68.67.164.34","4379","244.3.210.197","80","11","9062","5","1834","6","7228","0.803547000","64.6397","226.98","894.56"
"68.67.164.34","4377","244.3.210.197","80","8","4296","5","1817","3","2479","0.975633000","64.4676","225.48","307.63"
"168.223.67.89","2670","244.3.210.197","80","7","1527","5","1190","2","337","17.948294000","64.2642","148.14","41.95"
"244.3.224.188","1852","244.3.210.197","80","273","243232","101","16180","172","227052","82.398901000","63.7283","2031.12","28502.48"
"244.3.224.188","1853","244.3.210.197","80","502","473478","176","20330","326","453148","82.827295000","63.2999","2569.36","57269.96"
"244.3.153.25","50828","244.3.160.80","443","19","6649","8","1555","11","5094","158.109333000","63.2983","196.53","643.81"
"41.177.57.211","51413","244.3.210.197","80","83","69708","35","6697","48","63011","66.137392000","62.8362","852.63","8022.26"
"41.177.57.211","51414","244.3.210.197","80","129","107554","54","9294","75","98260","66.138147000","62.8355","1183.28","12510.13"
"41.177.57.211","51416","244.3.210.197","80","172","148765","68","10240","104","138525","66.138844000","62.8348","1303.74","17636.71"
"41.177.57.211","51417","244.3.210.197","80","134","110042","57","9088","77","100954","66.140343000","62.8334","1157.09","12853.55"
"41.177.57.211","51418","244.3.210.197","80","280","242087","113","12715","167","229372","66.141533000","62.8321","1618.92","29204.45"
"41.177.57.211","51415","244.3.210.197","80","97","77831","41","8007","56","69824","66.150283000","62.8232","1019.62","8891.49"
"15.205.242.71","2118","244.3.210.197","80","10","1505","6","1039","4","466","24.517967000","62.7018","132.56","59.46"
"177.71.203.41","61106","244.3.210.197","80","884","855118","299","27811","585","827307","103.718571000","61.4214","3622.32","107754.93"
"68.224.84.106","3323","244.3.210.197","80","49","39880","19","1621","30","38259","103.425248000","61.1354","212.12","5006.46"
"168.84.123.138","59255","41.177.26.91","8000","7","448","0","0","7","448","101.557484000","61.0509","N/A","58.71"
"68.67.164.34","4378","244.3.210.197","80","5","3035","3","947","2","2088","4.464735000","60.9785","124.24","273.93"
"41.177.3.18","5730","244.3.153.30","1297","52","7793","25","4724","27","3069","139.732666000","60.3279","626.44","406.98"
"41.177.3.18","5730","244.3.153.48","1211","40","6482","19","4293","21","2189","34.880539000","60.1654","570.83","291.06"
"41.177.37.95","1593","244.3.41.84","23","38","13589","21","1405","17","12184","32.463927000","60.1603","186.83","1620.21"
"41.177.66.219","3194","41.177.98.176","80","2","1810","0","0","2","1810","35.122850000","60.0078","N/A","241.30"
"41.177.164.128","52408","41.177.98.176","80","4","268","1","70","3","198","44.362570000","60.0077","N/A","26.40"
"18.132.77.186","11559","244.3.160.239","80","2","134","0","0","2","134","52.663910000","59.9993","N/A","17.87"
"254.204.210.149","11318","244.3.160.239","80","2","128","0","0","2","128","43.784022000","59.9993","N/A","17.07"
"90.210.201.231","8884","244.3.160.239","80","2","140","0","0","2","140","33.984148000","59.9993","N/A","18.67"
"254.204.210.149","11878","244.3.160.239","80","2","128","0","0","2","128","43.784027000","59.9993","N/A","17.07"
"254.204.210.149","13827","244.3.160.239","80","2","128","0","0","2","128","43.694052000","59.9993","N/A","17.07"
"244.3.153.34","58044","41.177.3.145","443","27","5551","16","3610","11","1941","81.727931000","59.9984","481.35","258.81"
"244.3.153.34","58042","41.177.3.145","443","27","5551","16","3610","11","1941","21.727712000","59.9983","481.35","258.81"
"244.3.153.34","58123","41.177.3.145","443","30","6523","18","3889","12","2634","141.736657000","59.9925","518.60","351.24"
"194.66.108.214","2934","244.3.41.84","23","10","3060","4","274","6","2786","153.459483000","59.8337","36.63","372.50"
"241.122.106.43","20749","244.3.210.197","80","70","37540","41","13724","29","23816","127.807739000","59.5918","1842.40","3197.22"
"48.90.252.46","60997","244.3.210.197","80","7","1586","5","1084","2","502","155.221901000","59.5110","145.72","67.48"
"41.177.98.220","7010","244.3.185.214","1173","46","23771","24","18370","22","5401","20.969377000","59.3094","2477.85","728.52"
"209.244.18.90","59472","244.3.210.197","80","48","39971","18","3078","30","36893","114.854149000","57.9717","424.76","5091.17"
"244.3.34.194","34028","41.177.26.210","22","834","93980","493","46404","341","47576","172.082897000","57.3792","6469.80","6633.20"
"106.37.181.3","52625","244.3.210.197","80","58","33203","27","2646","31","30557","69.338508000","56.7047","373.30","4311.04"
"41.177.64.33","1691","244.3.41.84","23","68","17297","32","2547","36","14750","168.289358000","56.4482","360.97","2090.41"
"177.71.203.41","64801","244.3.210.197","80","168","149760","63","12554","105","137206","103.719121000","56.2291","1786.12","19521.00"
"68.188.168.202","52241","244.3.210.197","80","4","280","2","140","2","140","3.969980000","55.8151","20.07","20.07"
"68.188.168.202","52240","244.3.210.197","80","4","280","2","140","2","140","3.969896000","55.8149","20.07","20.07"
"68.188.168.202","52239","244.3.210.197","80","4","280","2","140","2","140","3.969959000","55.8148","20.07","20.07"
"41.177.98.220","7010","244.3.79.218","3604","23","4237","9","2644","14","1593","16.030750000","55.3513","382.14","230.24"
"244.56.202.67","63638","41.177.98.143","8001","76","16192","40","4100","36","12092","170.623826000","54.8676","597.80","1763.08"
"68.188.168.202","52238","244.3.210.197","80","4","280","2","140","2","140","4.979795000","54.8053","20.44","20.44"
"253.142.108.12","3015","253.37.253.43","23","41","25742","0","0","41","25742","70.858487000","54.4875","N/A","3779.51"
"41.177.3.224","51332","41.177.117.184","1618","78","36026","39","18044","39","17982","31.990819000","54.1213","2667.19","2658.03"
"151.77.108.215","55704","41.177.98.176","80","132","95512","59","13069","73","82443","42.496037000","53.6325","1949.42","12297.47"
"41.177.98.220","7010","244.3.90.142","2460","24","7592","13","6471","11","1121","85.836357000","53.5392","966.92","167.50"
"15.128.184.13","28794","41.177.26.176","80","27","18545","9","1316","18","17229","180.998722000","53.0115","198.60","2600.04"
"244.3.160.248","47712","41.177.26.55","80","15","5554","8","1455","7","4099","55.727093000","52.6944","220.90","622.30"
"151.77.151.91","50049","41.177.98.176","80","164","142913","58","8066","106","134847","115.584002000","52.4244","1230.88","20577.73"
"244.3.176.118","3389","244.3.153.239","2091","5","411","2","186","3","225","84.794270000","52.1039","28.56","34.55"
"177.71.203.41","64718","244.3.210.197","80","205","185629","76","11771","129","173858","103.718687000","52.0124","1810.49","26741.03"
"244.3.153.13","1504","41.177.116.45","443","117","60169","45","5814","72","54355","161.461434000","51.9406","895.48","8371.87"
"177.71.203.41","23654","244.3.210.197","80","242","220650","88","13266","154","207384","103.720283000","51.8332","2047.49","32007.92"
"41.177.168.181","2707","244.3.160.239","80","67","46295","21","1344","46","44951","25.174443000","51.7686","207.69","6946.45"
"253.142.253.66","3312","253.37.253.43","23","26","11062","0","0","26","11062","128.566988000","51.0645","N/A","1733.02"
"89.160.185.98","49669","244.3.210.197","80","288","217578","150","34992","138","182586","39.010987000","50.9723","5491.92","28656.50"
"215.43.45.145","1327","41.177.26.15","80","31377","30461751","10508","673427","20869","29788324","99.918362000","50.8635","105919.07","4685216.83"
"244.3.160.239","61446","188.68.72.71","80","5","330","5","330","0","0","30.909538000","50.6140","52.16","N/A"
"244.3.160.239","61439","188.68.72.71","80","5","330","5","330","0","0","30.721943000","50.6116","52.16","N/A"
"41.177.105.80","57466","244.3.41.84","23","20","8013","10","938","10","7075","77.730405000","50.1426","149.65","1128.78"
"18.181.151.91","49813","41.177.98.176","80","51","37323","21","2717","30","34606","64.372599000","49.3630","440.33","5608.41"
"241.82.197.177","39818","41.177.26.176","80","890","781910","314","46044","576","735866","31.083510000","49.0618","7507.91","119989.96"
"151.239.66.180","57611","41.177.26.176","80","41","26424","17","2443","24","23981","53.657211000","48.7190","401.16","3937.85"
"41.177.98.220","7010","41.177.22.92","2891","239","206812","148","199963","91","6849","82.134474000","48.4719","33002.68","1130.39"
"41.177.98.220","7030","41.177.211.208","2231","24","4764","9","2964","15","1800","182.776310000","48.2336","491.61","298.55"
"244.3.31.117","59664","41.177.98.220","7000","49","7143","28","4600","21","2543","157.095713000","48.0964","765.13","422.98"
"244.3.247.116","4487","244.3.41.84","23","14","6502","8","768","6","5734","6.219558000","47.4692","129.43","966.35"
"241.82.197.177","61856","41.177.26.176","80","901","806174","329","43683","572","762491","33.115467000","47.1193","7416.57","129457.00"
"106.217.244.253","1427","41.177.26.176","80","156","129821","56","10240","100","119581","6.380141000","46.5696","1759.09","20542.33"
"241.82.197.204","43617","244.3.210.197","80","25","17337","11","2451","14","14886","1.535585000","46.5570","421.16","2557.90"
"117.218.106.199","50277","244.3.210.197","80","90","66443","42","19157","48","47286","115.328109000","46.0947","3324.81","8206.76"
"253.213.108.229","1840","253.37.253.43","23","16","14053","0","0","16","14053","124.192791000","45.9998","N/A","2444.01"
"244.3.153.13","1505","41.177.116.45","443","18","4149","10","2552","8","1597","167.688027000","45.7145","446.60","279.47"
"244.3.153.13","1506","41.177.116.45","443","26","8411","14","6197","12","2214","167.688996000","45.7126","1084.51","387.46"
"244.3.153.13","1508","41.177.116.45","443","79","48363","31","3912","48","44451","167.692545000","45.7104","684.66","7779.59"
"151.239.66.180","57623","41.177.26.176","80","85","44627","37","6234","48","38393","102.474248000","45.1325","1105.01","6805.38"
"254.204.205.197","46331","41.177.98.176","80","88","72486","33","5219","55","67267","70.055346000","45.0266","927.27","11951.52"
"244.3.34.194","34021","41.177.98.145","22","658","72940","378","31788","280","41152","95.572613000","44.9137","5662.06","7329.97"
"244.3.90.185","1366","41.177.98.176","80","97","76104","37","7026","60","69078","171.005571000","44.7754","1255.33","12342.13"
"244.3.164.145","3231","41.177.98.176","80","51","27389","26","11312","25","16077","47.412742000","44.4821","2034.44","2891.41"
"244.3.164.145","3237","41.177.98.176","80","83","64773","32","8500","51","56273","47.466296000","44.4285","1530.55","10132.78"
"244.3.153.239","2351","41.177.24.241","993","32","6146","16","1474","16","4672","88.295354000","43.6409","270.21","856.44"
"244.3.153.239","2349","41.177.24.241","993","33","4044","16","1562","17","2482","88.274400000","43.6180","286.49","455.23"
"244.3.153.239","2350","41.177.24.241","993","34","4057","16","1544","18","2513","88.295033000","43.6152","283.20","460.94"
"106.217.244.253","1431","41.177.26.176","80","206","167981","80","13710","126","154271","9.881682000","43.4467","2524.47","28406.49"
"106.217.244.253","1430","41.177.26.176","80","104","83720","39","6990","65","76730","9.880422000","43.0621","1298.59","14254.76"
"106.217.244.253","1432","41.177.26.176","80","127","97045","53","7817","74","89228","9.882600000","43.0582","1452.36","16578.11"
"41.177.98.220","7020","244.3.185.209","1133","79","21223","41","16560","38","4663","48.818152000","43.0370","3078.28","866.79"
"94.224.184.106","4415","41.177.26.13","80","112","94205","41","6210","71","87995","189.955563000","42.7055","1163.32","16484.07"
"151.77.151.91","50052","41.177.98.176","80","11","2132","6","1103","5","1029","125.331191000","42.6800","206.75","192.88"
"41.177.244.188","54423","244.3.210.197","80","17","9805","8","1455","9","8350","50.491121000","42.6573","272.87","1565.97"
"244.3.153.156","3684","41.177.116.45","443","317","168864","114","8384","203","160480","79.251488000","42.5126","1577.70","30199.07"
"151.77.205.22","50022","41.177.98.176","80","70","51267","30","6202","40","45065","154.218834000","42.4998","1167.44","8482.87"
"151.77.205.22","50021","41.177.98.176","80","111","95436","44","6484","67","88952","154.218653000","42.4996","1220.53","16744.05"
"41.177.98.220","7010","244.3.79.202","1231","66","23264","32","15311","34","7953","27.353246000","42.4855","2883.05","1497.55"
"89.160.185.98","54428","244.3.210.197","80","224","168043","117","26208","107","141835","31.968941000","41.9183","5001.73","27068.85"
"41.39.218.67","1692","244.3.210.197","80","11","1431","7","819","4","612","57.648122000","41.6982","157.13","117.42"
"177.149.224.75","41109","41.177.26.176","80","79","38998","31","5197","48","33801","18.908531000","41.6835","997.42","6487.17"
"41.39.218.67","1693","244.3.210.197","80","82","53021","39","5816","43","47205","57.960150000","41.3883","1124.18","9124.31"
"151.77.12.31","57696","41.177.98.176","80","117","84145","55","12351","62","71794","182.333064000","41.2015","2398.17","13940.09"
"41.177.98.220","7030","244.3.220.84","1730","35","5993","17","3707","18","2286","0.863083000","40.9146","724.83","446.98"
"244.3.160.248","47814","41.177.26.55","80","15","4875","8","1453","7","3422","67.793247000","40.6282","286.11","673.82"
"41.39.218.67","1694","244.3.210.197","80","202","151371","87","8586","115","142785","58.739876000","40.6108","1691.37","28127.50"
"244.3.164.145","3240","41.177.98.176","80","60","42807","23","7335","37","35472","51.303679000","40.5911","1445.64","6991.10"
"244.3.164.145","3241","41.177.98.176","80","122","112606","35","6847","87","105759","51.305719000","40.5890","1349.53","20844.87"
"41.39.218.67","1695","244.3.210.197","80","131","96527","57","6232","74","90295","58.771457000","40.5814","1228.54","17800.28"
"41.39.218.67","1696","244.3.210.197","80","77","51606","37","5311","40","46295","58.775744000","40.5793","1047.04","9126.82"
"41.39.218.67","1697","244.3.210.197","80","104","72538","48","6096","56","66442","58.780069000","40.5772","1201.86","13099.39"
"41.39.218.67","1698","244.3.210.197","80","235","181083","99","8877","136","172206","58.784409000","40.5749","1750.24","33953.17"
"198.208.198.164","11407","41.177.26.176","80","3","192","2","128","1","64","14.674223000","40.5663","25.24","N/A"
"177.149.224.75","41111","41.177.26.15","80","226","180346","80","6804","146","173542","20.026613000","40.5652","1341.84","34224.79"
"198.208.198.164","11445","41.177.26.176","80","3","192","2","128","1","64","14.724156000","40.1376","25.51","N/A"
"106.217.244.253","1442","41.177.26.176","80","50","32916","21","3015","29","29901","121.247192000","40.0410","602.38","5974.08"
"106.217.244.253","1440","41.177.26.176","80","98","70038","40","6278","58","63760","121.222562000","39.5546","1269.74","12895.61"
"106.217.244.253","1439","41.177.26.176","80","131","116356","46","6411","85","109945","119.561391000","39.3949","1301.89","22326.74"
"145.95.168.155","4051","41.177.98.176","80","47","27467","18","2790","29","24677","34.536234000","39.2479","568.69","5029.97"
"68.224.16.165","1786","41.177.26.15","80","2491","1995452","917","59185","1574","1936267","35.225843000","38.7324","12224.38","399926.83"
"18.181.151.91","49810","41.177.98.176","80","64","50567","26","3515","38","47052","3.409223000","38.2352","735.45","9844.75"
"151.77.12.31","57697","41.177.98.176","80","76","55634","35","9949","41","45685","185.591786000","37.9431","2097.67","9632.32"
"151.77.12.31","57698","41.177.98.176","80","28","16092","14","4320","14","11772","185.591904000","37.9430","910.84","2482.04"
"151.77.12.31","57700","41.177.98.176","80","109","86726","49","6154","60","80572","185.597574000","37.9374","1297.72","16990.54"
"106.217.244.253","1441","41.177.26.176","80","124","101723","48","5640","76","96083","121.241192000","37.7136","1196.39","20381.61"
"41.177.98.220","7030","244.3.79.219","1620","16","3223","6","2023","10","1200","68.134562000","37.7126","429.14","254.56"
"106.217.244.253","1444","41.177.26.176","80","43","27170","18","2948","25","24222","121.251670000","37.7099","625.41","5138.60"
"106.217.244.253","1443","41.177.26.176","80","67","45414","27","4163","40","41251","121.250667000","37.7098","883.17","8751.25"
"241.16.181.164","2846","41.177.98.127","210","14","1145","6","523","8","622","121.768315000","37.5940","111.29","132.36"
"194.66.204.94","1150","244.3.41.84","23","20","8073","10","769","10","7304","36.775186000","37.3898","164.54","1562.78"
"184.4.145.77","3012","244.3.41.84","23","46","9058","26","1860","20","7198","194.410639000","37.0615","401.49","1553.74"
"145.95.67.26","51163","41.177.98.176","80","83","69481","28","5591","55","63890","1.502883000","36.6999","1218.75","13927.03"
"92.244.186.20","55248","41.177.26.15","80","864","793245","308","21430","556","771815","82.517402000","36.4287","4706.18","169495.94"
"89.160.185.98","41717","244.3.210.197","80","261","197768","134","20463","127","177305","39.011123000","35.3896","4625.77","40080.73"
"253.213.108.79","1451","253.37.253.43","23","20","21357","0","0","20","21357","198.846186000","35.3785","N/A","4829.37"
"18.181.168.132","1068","244.3.210.197","80","38","23426","18","2592","20","20834","165.162663000","35.3641","586.36","4713.03"
"18.181.168.132","1067","244.3.210.197","80","38","23429","18","2601","20","20828","165.161214000","35.3640","588.39","4711.68"
"244.3.153.25","50813","244.3.160.80","443","6","3816","2","128","4","3688","14.256258000","35.2786","29.03","836.31"
"41.177.98.220","7010","244.3.185.176","1335","42","16615","20","7750","22","8865","167.021301000","35.1961","1761.56","2014.99"
"18.181.151.91","49812","41.177.98.176","80","28","14799","13","1508","15","13291","6.980766000","34.6676","347.99","3067.07"
"18.181.151.91","49811","41.177.98.176","80","26","14048","12","1439","14","12609","6.979360000","34.6666","332.08","2909.78"
"244.3.199.165","1498","41.177.98.142","80","50","34302","20","5796","30","28506","169.519238000","34.6082","1339.80","6589.42"
"18.181.90.197","53575","41.177.98.176","80","28","15479","14","3437","14","12042","115.385569000","34.2609","802.55","2811.83"
"18.181.90.197","53576","41.177.98.176","80","48","29941","22","4725","26","25216","115.389013000","34.2531","1103.55","5889.34"
"145.95.67.26","51164","41.177.98.176","80","85","77971","30","6294","55","71677","4.169444000","34.0332","1479.49","16848.70"
"145.95.67.26","51165","41.177.98.176","80","73","55549","28","7263","45","48286","4.170573000","34.0321","1707.33","11350.70"
"145.95.67.26","51166","41.177.98.176","80","40","27470","19","7166","21","20304","4.170693000","34.0320","1684.53","4772.92"
"145.95.67.26","51167","41.177.98.176","80","33","20535","15","4745","18","15790","4.174779000","34.0280","1115.55","3712.24"
"145.95.67.26","51168","41.177.98.176","80","39","26535","16","4777","23","21758","4.174824000","34.0280","1123.08","5115.32"
"41.177.13.251","50372","244.3.41.84","23","73","15887","42","4706","31","11181","118.048685000","33.6683","1118.20","2656.75"
"41.177.181.81","49207","41.177.98.176","80","98","79901","35","5528","63","74373","130.366394000","33.5142","1319.56","17753.21"
"244.3.160.248","49194","41.177.26.55","80","24","11509","11","2568","13","8941","163.240727000","33.4074","614.95","2141.08"
"145.95.168.155","4052","41.177.98.176","80","108","72076","40","5956","68","66120","85.982243000","32.9674","1445.31","16044.94"
"244.3.160.248","47903","41.177.26.193","80","1689","1626336","1123","1588737","566","37599","71.859380000","32.6470","389312.74","9213.46"
"41.202.64.43","58213","41.177.26.176","80","91","77056","33","3029","58","74027","36.049431000","32.2429","751.54","18367.32"
"151.77.135.33","49835","41.177.98.176","80","63","51497","25","5918","38","45579","108.843154000","32.2117","1469.78","11319.87"
"16.225.66.90","15021","41.177.26.176","80","34","16119","18","3267","16","12852","102.835927000","31.9913","816.97","3213.87"
"77.197.210.224","20380","41.177.26.91","80","25","19467","10","952","15","18515","69.961918000","31.5120","241.69","4700.44"
"90.218.72.90","58384","41.177.98.176","80","34","24816","13","2782","21","22034","186.563451000","31.4382","707.93","5606.93"
"41.177.181.81","49206","41.177.98.176","80","90","71824","32","4158","58","67666","99.071087000","31.2951","1062.91","17297.53"
"16.225.66.90","15029","41.177.26.176","80","119","69347","49","4778","70","64569","103.554863000","31.2764","1222.14","16515.73"
"16.225.66.90","15030","41.177.26.176","80","19","5424","10","2065","9","3359","103.557847000","31.2702","528.30","859.35"
"16.225.66.90","15031","41.177.26.176","80","19","5700","10","2052","9","3648","103.704089000","31.1228","527.46","937.70"
"41.177.98.220","7010","244.3.90.143","1120","31","5568","14","3116","17","2452","89.163120000","31.0134","803.78","632.50"
"40.138.160.255","2952","244.3.160.239","80","1476","1320536","570","41652","906","1278884","98.653895000","30.8758","10792.13","331361.96"
"252.77.177.67","3264","41.177.26.176","80","39","20314","16","3100","23","17214","7.932252000","30.8721","803.31","4460.73"
"151.77.205.22","50019","41.177.98.176","80","92","74920","36","6463","56","68457","152.381747000","30.7586","1680.96","17804.99"
"77.197.210.48","11922","41.177.26.91","80","6","634","4","504","2","130","69.153089000","30.7407","131.16","33.83"
"41.177.230.224","36831","41.177.26.46","80","24","12159","11","778","13","11381","55.019540000","30.7363","202.50","2962.23"
"244.3.153.13","1507","41.177.116.45","443","15","2626","8","1577","7","1049","167.690097000","30.7107","410.80","273.26"
"244.3.153.13","1509","41.177.116.45","443","16","2716","8","1577","8","1139","167.693862000","30.7065","410.86","296.75"
"77.197.210.231","53422","41.177.26.91","80","6","634","4","504","2","130","10.206128000","30.7028","131.32","33.87"
"244.3.199.218","2367","41.177.98.176","80","37","24548","15","3248","22","21300","25.134864000","30.6117","848.83","5566.50"
"77.197.128.117","31837","41.177.26.91","80","6","665","4","535","2","130","179.728711000","30.5962","139.89","33.99"
"244.3.153.25","50829","244.3.160.80","443","15","2961","7","1491","8","1470","188.701986000","30.5743","390.13","384.64"
"41.177.211.160","1672","41.177.98.176","80","78","35683","37","14559","41","21124","37.875782000","30.4415","3826.09","5551.36"
"204.41.197.117","12101","41.177.26.176","80","63","40925","27","3230","36","37695","146.265230000","30.4131","849.64","9915.48"
"41.177.176.198","1289","41.177.98.176","80","39","25417","16","3107","23","22310","84.104095000","30.3876","817.97","5873.45"
"41.177.176.198","1275","41.177.98.176","80","41","26550","17","3149","24","23401","24.339504000","30.1981","834.23","6199.33"
"41.177.194.186","2125","41.177.98.176","80","71","52363","28","6199","43","46164","0.390268000","30.0877","1648.25","12274.50"
"61.194.168.142","21891","41.177.26.176","80","30","15551","12","2047","18","13504","6.804563000","30.0299","545.32","3597.48"
"254.204.205.13","58344","41.177.98.176","80","11","1639","6","1108","5","531","34.388241000","30.0085","295.38","141.56"
"151.77.108.215","55709","41.177.98.176","80","24","14191","11","1514","13","12677","66.124427000","30.0045","403.67","3380.03"
"151.77.108.215","55710","41.177.98.176","80","25","14890","11","1519","14","13371","66.124596000","30.0043","405.01","3565.09"
"145.67.149.81","49164","41.177.98.176","80","11","1604","6","1073","5","531","29.747612000","29.9832","286.29","141.68"
"41.177.211.160","1675","41.177.98.176","80","57","17758","30","13737","27","4021","38.548705000","29.7687","3691.67","1080.60"
"41.13.93.230","52439","244.3.210.197","80","172","148923","58","8138","114","140785","139.879895000","29.6759","2193.84","37952.72"
"244.3.160.239","61929","198.123.241.156","80","1377","1290410","494","32487","883","1257923","99.683015000","29.4647","8820.58","341540.19"
"41.177.98.43","38594","41.177.26.155","8010","22","5430","12","3090","10","2340","131.365582000","29.4134","840.43","636.45"
"253.213.108.181","4700","253.37.253.43","23","14","13959","0","0","14","13959","54.231638000","29.2802","N/A","3813.91"
"90.218.155.193","52109","41.177.98.176","80","60","48813","23","5834","37","42979","58.483501000","29.2218","1597.16","11766.29"
"151.239.66.180","57625","41.177.26.176","80","36","18726","15","2916","21","15810","147.610839000","29.1975","798.97","4331.88"
"244.3.160.248","47976","41.177.26.55","80","60","41242","27","9135","33","32107","79.396224000","29.0252","2517.81","8849.42"
"117.218.106.199","50288","244.3.210.197","80","76","68226","31","7145","45","61081","132.434901000","28.9944","1971.41","16853.16"
"117.218.106.199","50290","244.3.210.197","80","41","27557","22","9338","19","18219","132.447740000","28.9880","2577.07","5028.02"
"117.218.106.199","50289","244.3.210.197","80","51","38425","24","7629","27","30796","132.440545000","28.9759","2106.30","8502.51"
"244.3.90.4","59984","41.177.98.92","22","222","49743","137","16327","85","33416","40.145959000","28.9682","4508.94","9228.32"
"151.77.205.22","50024","41.177.98.176","80","57","42856","23","4146","34","38710","154.226533000","28.9141","1147.12","10710.33"
"151.77.205.22","50023","41.177.98.176","80","91","69595","42","4701","49","64894","154.226162000","28.9097","1300.88","17957.70"
"253.176.108.193","2104","253.37.253.43","23","3","2732","0","0","3","2732","24.605236000","28.8631","N/A","757.23"
"117.218.106.199","50286","244.3.210.197","80","25","11148","15","7153","10","3995","132.421121000","28.8157","1985.86","1109.12"
"18.181.90.197","53598","41.177.98.176","80","37","23997","16","3008","21","20989","181.002931000","28.6450","840.08","5861.84"
"41.177.98.43","38539","41.177.26.155","8010","48","20124","26","9520","22","10604","0.669606000","28.6440","2658.85","2961.60"
"47.241.184.51","63020","41.177.26.91","8000","3","4314","0","0","3","4314","178.915334000","28.4237","N/A","1214.20"
"244.3.79.141","2927","41.177.98.176","80","38","25242","16","1920","22","23322","22.381166000","28.3236","542.30","6587.30"
"77.197.67.186","63045","244.3.210.197","80","375","428698","91","20793","284","407905","51.632981000","28.2896","5880.05","115351.43"
"151.77.205.22","50043","41.177.98.176","80","93","77569","39","9476","54","68093","196.718534000","28.2018","2688.06","19315.94"
"18.181.90.197","53574","41.177.98.176","80","29","18015","14","4209","15","13806","115.379939000","28.1526","1196.05","3923.19"
"41.177.194.186","2134","41.177.98.176","80","95","73974","34","6701","61","67273","47.391864000","28.1380","1905.18","19126.58"
"18.181.90.197","53577","41.177.98.176","80","90","71239","39","4450","51","66789","115.395418000","28.1349","1265.33","18991.06"
"18.181.90.197","53578","41.177.98.176","80","56","39458","24","4153","32","35305","115.398634000","28.1295","1181.11","10040.71"
"145.95.139.141","49838","41.177.98.176","80","49","39324","18","6816","31","32508","45.096950000","27.8615","1957.11","9334.18"
"106.217.244.253","1428","41.177.26.176","80","62","50938","22","5970","40","44968","8.162845000","27.7661","1720.08","12956.23"
"253.213.108.71","2466","253.37.253.43","23","13","9860","0","0","13","9860","64.144327000","27.5521","N/A","2862.94"
"41.177.98.220","7010","244.3.185.121","1131","37","17768","19","9969","18","7799","176.581360000","27.1861","2933.56","2295.00"
"18.181.168.132","1089","244.3.210.197","80","82","52883","40","8260","42","44623","185.490111000","27.0507","2442.82","13196.83"
"18.181.168.132","1095","244.3.210.197","80","36","10393","21","6204","15","4189","185.496014000","27.0462","1835.08","1239.07"
"106.217.244.253","1435","41.177.26.176","80","78","62735","29","3775","49","58960","25.937673000","27.0092","1118.14","17463.70"
"106.217.244.253","1436","41.177.26.176","80","93","55599","30","3579","63","52020","25.939918000","27.0040","1060.29","15411.06"
"244.3.199.165","1500","41.177.98.142","80","33","19595","14","4160","19","15435","177.748336000","26.9826","1233.39","4576.27"
"106.217.244.253","1438","41.177.26.176","80","47","33125","21","2353","26","30772","86.965723000","26.9825","697.64","9123.55"
"252.77.177.67","3266","41.177.26.176","80","42","23248","17","3100","25","20148","76.564858000","26.9403","920.55","5983.01"
"241.82.68.241","56545","41.177.98.176","80","70","47799","32","9699","38","38100","167.730627000","26.8876","2885.79","11336.08"
"244.3.199.165","1499","41.177.98.142","80","32","18104","14","4101","18","14003","177.748154000","26.8823","1220.43","4167.21"
"210.176.151.45","2000","41.177.26.15","80","779","737102","265","18252","514","718850","180.195946000","26.7939","5449.60","214630.88"
"154.130.246.40","3014","41.177.26.176","80","333","255204","131","10979","202","244225","178.098538000","26.5951","3302.56","73464.69"
"241.157.67.72","3492","41.177.98.156","25","21","9079","10","8045","11","1034","204.806479000","26.5099","2427.78","312.03"
"94.224.184.106","4403","41.177.26.13","80","152","122854","59","9598","93","113256","186.595572000","26.5073","2896.71","34181.10"
"94.224.184.106","4405","41.177.26.13","80","84","58314","35","7419","49","50895","186.643132000","26.4602","2243.06","15387.62"
"94.224.184.106","4407","41.177.26.13","80","86","57434","37","6986","49","50448","186.644337000","26.4586","2112.28","15253.41"
"244.3.160.248","49304","41.177.26.55","80","22","11308","10","2493","12","8815","170.259859000","26.3882","755.79","2672.41"
"94.224.184.106","4411","41.177.26.13","80","53","29311","23","5781","30","23530","186.758885000","26.3455","1755.44","7145.05"
"106.217.244.253","1451","41.177.26.176","80","203","181223","70","9082","133","172141","192.812859000","26.1502","2778.41","52662.23"
"90.218.155.193","52112","41.177.98.176","80","44","34359","16","3874","28","30485","61.571368000","26.1382","1185.70","9330.42"
"90.218.155.193","52115","41.177.98.176","80","28","15405","13","3527","15","11878","61.583225000","26.1263","1079.98","3637.10"
"90.218.155.193","52117","41.177.98.176","80","37","23355","16","3890","21","19465","61.587409000","26.1221","1191.33","5961.23"
"90.218.155.193","52116","41.177.98.176","80","83","79953","25","3727","58","76226","61.587395000","26.1221","1141.41","23344.49"
"90.218.155.193","52118","41.177.98.176","80","25","13105","13","3698","12","9407","61.587404000","26.1221","1132.53","2880.93"
"244.3.177.130","2417","41.177.98.176","80","42","25356","18","2560","24","22796","141.793725000","25.9671","788.69","7023.05"
"41.177.176.198","1291","41.177.98.176","80","44","29042","18","3227","26","25815","163.573129000","25.9198","996.00","7967.67"
"145.95.139.141","49839","41.177.98.176","80","20","6661","11","5272","9","1389","47.048693000","25.9103","1627.77","428.86"
"145.95.139.141","49840","41.177.98.176","80","20","6669","11","5281","9","1388","47.048876000","25.9097","1630.58","428.57"
"145.95.139.141","49841","41.177.98.176","80","45","31820","17","5999","28","25821","47.049120000","25.9097","1852.28","7972.62"
"145.95.139.141","49842","41.177.98.176","80","18","5489","10","4324","8","1165","47.049367000","25.9093","1335.12","359.72"
"145.95.139.141","49843","41.177.98.176","80","21","7387","12","5313","9","2074","47.050996000","25.9081","1640.57","640.42"
"253.116.108.124","1849","253.37.253.43","23","10","2805","0","0","10","2805","92.721366000","25.8965","N/A","866.53"
"106.217.244.253","1445","41.177.26.176","80","105","85143","39","5223","66","79920","163.169379000","25.7990","1619.60","24782.38"
"77.197.67.186","63074","244.3.210.197","80","220","226397","69","17211","151","209186","54.124293000","25.7984","5337.09","64868.02"
"117.218.106.199","50287","244.3.210.197","80","23","10902","13","5281","10","5621","132.427848000","25.5531","1653.34","1759.79"
"241.82.197.204","35865","244.3.210.197","80","10","2128","6","1256","4","872","5.885495000","25.4843","394.28","273.74"
"241.82.68.241","56522","41.177.98.176","80","342","300983","131","17633","211","283350","164.187017000","25.4309","5546.96","89135.76"
"208.51.205.98","1361","41.177.26.176","80","101","64168","37","4634","64","59534","77.436061000","25.2964","1465.51","18827.67"
"18.181.168.132","1084","244.3.210.197","80","27","5769","16","4237","11","1532","185.484437000","25.0759","1351.74","488.76"
"18.181.168.132","1091","244.3.210.197","80","22","4447","13","3248","9","1199","185.494526000","25.0594","1036.89","382.77"
"18.181.168.132","1100","244.3.210.197","80","22","4447","13","3248","9","1199","185.501693000","25.0540","1037.12","382.85"
"18.181.168.132","1101","244.3.210.197","80","22","4447","13","3248","9","1199","185.503412000","25.0537","1037.13","382.86"
"47.241.184.51","61840","41.177.26.91","8000","5","350","0","0","5","350","203.549193000","24.8900","N/A","112.49"
"215.43.45.145","1312","41.177.26.176","80","56","26530","23","7402","33","19128","22.340495000","24.8542","2382.54","6156.88"
"68.224.16.165","1784","41.177.26.15","80","27","8813","13","2081","14","6732","34.136916000","24.8225","670.68","2169.65"
"244.3.160.248","48259","41.177.26.55","80","41","27074","18","5794","23","21280","108.427436000","24.8193","1867.58","6859.17"
"68.157.168.139","56603","41.177.26.176","80","225","95171","111","10286","114","84885","137.775741000","24.8076","3317.04","27373.83"
"252.77.177.67","3272","41.177.26.176","80","45","24450","18","3155","27","21295","171.749768000","24.7305","1020.60","6888.67"
"204.41.197.117","12103","41.177.26.176","80","24","10624","12","1503","12","9121","205.755781000","24.6562","487.67","2959.42"
"244.3.160.248","47042","41.177.26.55","80","11","2146","6","1220","5","926","1.480974000","24.6539","395.88","300.48"
"106.217.244.253","1452","41.177.26.176","80","35","24187","14","1533","21","22654","194.464252000","24.5023","500.53","7396.54"
"106.217.244.253","1453","41.177.26.176","80","35","22211","16","1679","19","20532","194.479051000","24.4902","548.47","6707.02"
"106.217.244.253","1454","41.177.26.176","80","65","46608","28","3118","37","43490","194.480891000","24.4896","1018.55","14206.84"
"244.3.185.40","2618","41.177.98.176","80","170","140693","66","12765","104","127928","169.082788000","24.4758","4172.28","41813.70"
"106.217.244.253","1456","41.177.26.176","80","62","48547","23","2762","39","45785","194.528818000","24.4405","904.07","14986.58"
"106.217.244.253","1455","41.177.26.176","80","69","53681","28","3257","41","50424","194.526800000","24.4392","1066.16","16505.94"
"244.3.199.165","1503","41.177.98.142","80","11","2256","6","1359","5","897","181.111296000","24.4248","445.12","293.80"
"244.3.199.165","1501","41.177.98.142","80","11","2152","6","1360","5","792","181.110980000","24.4247","445.45","259.41"
"254.204.205.197","42652","41.177.98.176","80","87","68495","37","5142","50","63353","120.682273000","24.4012","1685.82","20770.42"
"154.130.246.40","3012","41.177.26.176","80","341","266372","134","18512","207","247860","176.921034000","24.2899","6097.01","81633.82"
"106.217.244.253","1446","41.177.26.176","80","33","20791","14","1533","19","19258","164.789994000","24.1780","507.24","6372.07"
"106.217.244.253","1447","41.177.26.176","80","31","20596","13","1469","18","19127","164.806673000","24.1581","486.46","6333.95"
"106.217.244.253","1449","41.177.26.176","80","31","19809","13","1469","18","18340","164.808713000","24.1546","486.53","6074.20"
"106.217.244.253","1448","41.177.26.176","80","32","19942","14","1533","18","18409","164.807932000","24.1532","507.76","6097.42"
"106.217.244.253","1450","41.177.26.176","80","35","22943","15","1615","20","21328","164.824598000","24.1342","535.34","7069.79"
"41.177.71.18","1181","244.3.41.84","23","11","2220","6","406","5","1814","5.208415000","24.1084","134.73","601.95"
"244.3.79.141","2931","41.177.98.176","80","38","25211","16","1900","22","23311","56.959663000","23.7463","640.10","7853.36"
"204.41.197.117","12102","41.177.26.176","80","34","17477","16","2412","18","15065","176.680050000","23.7294","813.17","5078.93"
"168.72.165.153","51056","41.177.26.176","80","111","38858","26","4032","85","34826","136.589036000","23.7187","1359.94","11746.32"
"41.177.93.67","1153","244.3.41.84","23","102","47264","52","3380","50","43884","18.494724000","23.7096","1140.47","14807.18"
"244.3.90.185","1355","41.177.98.176","80","63","47071","24","4872","39","42199","89.467341000","23.6510","1647.96","14273.89"
"244.3.160.248","47939","41.177.26.193","80","3118","3165958","1067","72279","2051","3093679","76.682299000","23.5939","24507.71","1048976.55"
"47.167.26.197","1321","244.3.41.84","23","10","4312","6","396","4","3916","2.805402000","23.4029","135.37","1338.64"
"41.177.98.43","38563","41.177.26.155","8010","34","10950","18","5126","16","5824","52.270248000","23.2604","1763.00","2003.06"
"186.136.103.68","8541","244.3.160.239","80","1933","1923209","656","48881","1277","1874328","97.862997000","23.2283","16834.96","645531.89"
"41.177.230.224","36828","41.177.26.46","80","11","1185","6","466","5","719","54.989240000","23.2139","160.59","247.78"
"41.177.230.224","36829","41.177.26.46","80","11","1188","6","469","5","719","54.999471000","23.2090","161.66","247.83"
"244.3.90.185","1364","41.177.98.176","80","42","28798","17","3545","25","25253","145.601229000","23.2084","1221.97","8704.80"
"41.177.230.224","36830","41.177.26.46","80","19","7985","9","662","10","7323","55.010699000","23.2033","228.24","2524.81"
"244.3.199.218","2372","41.177.98.176","80","37","24548","15","3248","22","21300","92.570688000","23.1926","1120.36","7347.17"
"145.51.132.23","56179","41.177.98.176","80","11","1369","6","759","5","610","46.026985000","23.0933","262.93","211.32"
"244.3.160.248","47992","41.177.26.72","80","13","3243","7","1213","6","2030","80.674337000","23.0470","421.05","704.65"
"18.181.168.132","1087","244.3.210.197","80","26","5691","15","4158","11","1533","185.488394000","23.0432","1443.55","532.22"
"18.181.168.132","1099","244.3.210.197","80","22","4442","13","3243","9","1199","185.500243000","23.0297","1126.54","416.51"
"244.3.160.248","49688","41.177.26.55","80","18","4197","10","3173","8","1024","192.798948000","22.9695","1105.12","356.65"
"151.77.135.33","49833","41.177.98.176","80","116","106561","45","5472","71","101089","82.871170000","22.9436","1907.98","35247.86"
"41.177.56.138","3557","244.3.41.84","23","97","54256","49","3184","48","51072","64.328081000","22.8975","1112.44","17843.69"
"68.157.168.209","48931","41.177.26.176","80","195","83223","98","9031","97","74192","1.835569000","22.8632","3160.02","25960.36"
"244.3.153.197","50539","41.177.3.145","443","27","6855","16","3889","11","2966","53.573640000","22.8435","1361.96","1038.72"
"41.177.230.224","37043","244.3.160.254","80","66","56798","25","1681","41","55117","85.756930000","22.7853","590.20","19351.74"
"41.177.230.224","36981","41.177.26.22","80","17","4582","9","759","8","3823","78.214703000","22.6950","267.55","1347.61"
"244.3.199.165","1502","41.177.98.142","80","11","2221","6","1359","5","862","181.111196000","22.5209","482.75","306.21"
"254.204.205.197","44925","41.177.98.176","80","35","24905","15","2733","20","22172","2.635193000","22.4458","974.08","7902.43"
"145.95.149.185","20466","41.177.98.176","80","62","46811","24","4342","38","42469","113.817710000","22.3746","1552.48","15184.75"
"168.72.165.153","51054","41.177.26.176","80","53","17518","16","2826","37","14692","114.249349000","22.3400","1012.00","5261.23"
"244.3.185.40","2625","41.177.98.176","80","85","66554","33","5962","52","60592","206.082556000","22.3358","2135.41","21702.20"
"41.177.75.18","64873","41.177.98.176","80","62","46121","24","4850","38","41271","15.366555000","22.2553","1743.40","14835.48"
"223.198.244.193","1965","41.177.26.46","80","94","72509","41","3505","53","69004","140.359349000","22.0301","1272.80","25058.04"
"244.3.160.248","47915","41.177.26.55","80","29","17675","13","2439","16","15236","72.538159000","21.9479","889.01","5553.51"
"244.3.160.239","61912","197.154.128.197","80","1844","1786225","659","42784","1185","1743441","98.063710000","21.9304","15607.22","635991.84"
"244.3.153.197","50541","41.177.3.145","443","24","5481","14","3610","10","1871","173.583581000","21.8941","1319.08","683.65"
"244.3.160.248","49775","41.177.26.55","80","15","4282","8","2636","7","1646","207.324500000","21.8510","965.08","602.63"
"68.157.168.39","54907","41.177.26.176","80","132","49691","66","6080","66","43611","65.798034000","21.8509","2226.00","15966.77"
"16.119.77.194","3453","41.177.26.15","80","21","9841","10","1122","11","8719","209.979346000","21.6652","414.30","3219.53"
"215.43.45.145","1320","41.177.26.176","80","43","21162","17","3047","26","18115","83.290454000","21.3823","1140.01","6777.58"
"55.161.39.39","43567","41.177.26.176","80","33","16001","15","2729","18","13272","37.417250000","21.1800","1030.78","5013.03"
"41.177.230.224","37059","41.177.98.176","80","19","8014","9","656","10","7358","87.935248000","21.0966","248.76","2790.21"
"48.90.252.46","61014","244.3.210.197","80","341","241507","174","23961","167","217546","155.853185000","21.0239","9117.61","82780.35"
"244.3.90.185","1363","41.177.98.176","80","65","48824","24","3913","41","44911","124.645468000","20.9555","1493.83","17145.28"
"244.3.153.197","50540","41.177.3.145","443","27","5711","16","3762","11","1949","114.565011000","20.9097","1439.33","745.68"
"41.177.230.224","37058","41.177.98.142","80","15","4970","8","591","7","4379","87.929312000","20.8565","226.69","1679.66"
"151.77.108.215","55705","41.177.98.176","80","47","31653","21","4503","26","27150","44.368354000","20.8300","1729.43","10427.25"
"151.77.108.215","55706","41.177.98.176","80","49","32671","23","6120","26","26551","44.371430000","20.8266","2350.84","10198.87"
"151.77.135.33","49828","41.177.98.176","80","115","106013","43","4268","72","101745","0.877273000","20.7866","1642.60","39157.93"
"151.77.108.215","55707","41.177.98.176","80","77","65827","31","2926","46","62901","44.427543000","20.7709","1126.96","24226.62"
"15.128.184.13","56828","41.177.26.46","80","17","7578","9","1223","8","6355","15.496795000","20.7655","471.17","2448.29"
"244.3.199.218","2370","41.177.98.176","80","37","24637","15","3246","22","21391","65.058502000","20.6884","1255.19","8271.67"
"85.186.116.57","1401","41.177.98.176","80","14","3021","8","2309","6","712","26.697582000","20.6260","895.57","276.16"
"252.77.177.67","3270","41.177.26.176","80","19","9142","9","1278","10","7864","132.478232000","20.5181","498.29","3066.17"
"92.244.186.20","55249","41.177.26.15","80","25","7821","12","1731","13","6090","83.443736000","20.4952","675.67","2377.14"
"145.95.168.155","4049","41.177.98.176","80","24","11693","10","1225","14","10468","14.077004000","20.4586","479.02","4093.34"
"41.177.181.81","49204","41.177.98.176","80","118","98770","42","4558","76","94212","38.376210000","20.4524","1782.88","36851.31"
"48.90.252.46","61027","244.3.210.197","80","538","422925","249","28394","289","394531","156.760988000","20.2133","11237.77","156147.32"
"95.34.105.67","1518","41.177.26.176","80","56","31923","25","5337","31","26586","136.647414000","20.2020","2113.46","10528.08"
"90.218.241.186","39692","244.3.210.197","80","56","41634","25","8446","31","33188","53.072559000","20.1944","3345.88","13147.40"
"15.225.98.142","1503","41.177.98.142","80","21","9188","12","1041","9","8147","155.096958000","20.1287","413.74","3237.96"
"151.77.135.33","49834","41.177.98.176","80","10","3209","6","1572","4","1637","85.795912000","20.0191","628.20","654.18"
"244.3.185.40","2626","41.177.98.176","80","11","2794","6","1094","5","1700","208.422269000","19.9960","437.69","680.14"
"244.3.180.219","55224","41.177.98.176","80","25","15091","10","1921","15","13170","4.846237000","19.7173","779.42","5343.54"
"244.3.160.239","61589","85.224.40.142","80","1071","1097667","360","23464","711","1074203","50.845686000","19.7115","9522.99","435971.15"
"244.3.93.239","2793","41.177.98.142","80","50","35231","19","5888","31","29343","69.750312000","19.6332","2399.20","11956.46"
"244.3.160.248","46987","41.177.26.193","80","44","29610","19","6337","25","23273","6.368305000","19.6166","2584.34","9491.15"
"253.98.22.203","1709","253.37.253.43","23","13","6400","0","0","13","6400","210.295247000","19.6053","N/A","2611.54"
"244.3.160.248","48470","41.177.26.193","80","164","156415","58","6108","106","150307","119.037971000","19.5890","2494.46","61384.13"
"198.98.203.67","65165","41.177.98.176","80","10","1260","6","839","4","421","101.057903000","19.5610","343.13","172.18"
"244.3.160.248","48475","41.177.26.193","80","57","45914","22","3998","35","41916","119.474765000","19.5321","1637.51","17168.03"
"244.3.160.248","49292","41.177.26.55","80","11","2399","6","1487","5","912","169.058459000","19.5010","610.02","374.14"
"41.177.92.61","2154","41.177.98.176","80","69","45197","31","13724","38","31473","209.725285000","19.4455","5646.13","12948.16"
"94.224.184.106","4421","41.177.26.13","80","12","1925","6","994","6","931","213.216216000","19.4408","409.04","383.11"
"94.224.184.106","4423","41.177.26.13","80","12","2651","6","993","6","1658","213.217686000","19.4357","408.73","682.45"
"18.181.151.91","49807","41.177.98.176","80","5","320","3","192","2","128","0.224163000","19.4066","79.15","52.77"
"151.77.192.83","15832","244.3.160.239","80","1073","1097791","360","23533","713","1074258","50.841957000","19.3555","9726.65","444011.93"
"151.77.135.33","49837","41.177.98.176","80","79","70357","32","7937","47","62420","169.737546000","19.3257","3285.57","25839.18"
"18.181.151.91","49809","41.177.98.176","80","5","320","3","192","2","128","0.324082000","19.3017","79.58","53.05"
"18.181.151.91","49803","41.177.98.176","80","5","320","3","192","2","128","0.424206000","19.2033","79.99","53.32"
"41.177.230.224","36980","41.177.26.13","80","25","16064","11","788","14","15276","78.209124000","19.1580","329.05","6378.96"
"18.181.151.91","49806","41.177.98.176","80","5","320","3","192","2","128","0.474067000","19.1549","80.19","53.46"
"68.157.168.192","54618","41.177.26.176","80","165","71753","82","7567","83","64186","195.127089000","19.0936","3170.48","26893.17"
"40.138.160.255","4900","244.3.160.239","80","2044","1860891","800","59772","1244","1801119","114.039852000","19.0593","25088.86","756006.56"
"66.116.46.204","50743","41.177.98.142","80","18","8988","9","846","9","8142","192.485636000","19.0533","355.21","3418.61"
"168.72.165.153","51046","41.177.26.176","80","16","7005","7","994","9","6011","94.975568000","19.0277","417.92","2527.27"
"244.3.160.248","48415","41.177.26.55","80","11","2087","6","1173","5","914","115.559271000","19.0175","493.44","384.49"
"244.3.160.248","48987","41.177.26.193","80","45","36393","18","2533","27","33860","140.212093000","18.9988","1066.59","14257.75"
"244.3.154.100","3883","244.3.41.84","23","15","1054","15","1054","0","0","63.256130000","18.9597","444.73","N/A"
"253.180.253.254","2436","253.37.253.43","623","70","23561","0","0","70","23561","209.330555000","18.8908","N/A","9977.79"
"151.77.135.33","49838","41.177.98.176","80","61","48650","25","8531","36","40119","170.312937000","18.7505","3639.80","17116.99"
"151.77.135.33","49844","41.177.98.176","80","20","9468","11","5325","9","4143","170.432070000","18.6317","2286.43","1778.90"
"151.77.135.33","49842","41.177.98.176","80","71","65118","26","2815","45","62303","170.430960000","18.6317","1208.70","26751.46"
"151.77.135.33","49843","41.177.98.176","80","22","12022","10","2940","12","9082","170.431859000","18.6312","1262.40","3899.69"
"151.77.135.33","49845","41.177.98.176","80","28","19045","12","3072","16","15973","170.432232000","18.6295","1319.20","6859.23"
"154.176.214.143","52910","41.177.26.91","80","2918","3009206","956","63009","1962","2946197","105.796040000","18.6219","27068.81","1265692.89"
"244.3.160.248","47111","41.177.26.193","80","247","234322","89","10839","158","223483","7.607572000","18.5874","4665.10","96186.96"
"241.82.68.241","56421","41.177.98.176","80","24","11812","11","2616","13","9196","143.210477000","18.5193","1130.07","3972.51"
"244.3.160.239","62119","198.123.241.156","80","1864","1816725","656","42855","1208","1773870","114.371498000","18.4397","18592.49","769587.11"
"249.18.39.225","1652","41.177.26.176","80","90","31430","40","4884","50","26546","215.997706000","18.4340","2119.56","11520.44"
"244.3.160.248","47112","41.177.26.193","80","73","54660","30","7031","43","47629","7.616400000","18.3384","3067.22","20777.79"
"244.3.160.248","47114","41.177.26.193","80","177","161317","65","9269","112","152048","7.691924000","18.3029","4051.38","66458.51"
"95.197.89.124","1708","41.177.98.176","80","19","9463","9","930","10","8533","1.755335000","18.2154","408.45","3747.60"
"253.108.164.75","1433","253.37.253.43","23","17","17077","0","0","17","17077","137.752168000","18.1923","N/A","7509.54"
"168.72.165.153","51048","41.177.26.176","80","12","2206","6","862","6","1344","95.810714000","18.1830","379.26","591.32"
"168.72.165.153","51047","41.177.26.176","80","66","54402","23","2443","43","51959","95.810691000","18.1830","1074.85","22860.48"
"168.72.165.153","51049","41.177.26.176","80","51","16421","15","2756","36","13665","95.817853000","18.1758","1213.04","6014.60"
"168.72.165.153","51050","41.177.26.176","80","22","7761","10","2103","12","5658","95.817926000","18.1755","925.64","2490.39"
"244.3.160.248","47432","41.177.26.193","80","1573","1610359","528","35106","1045","1575253","38.795608000","18.0497","15559.69","698184.06"
"244.3.160.248","47176","41.177.26.193","80","1417","1452649","476","31778","941","1420871","17.826982000","17.9880","14132.99","631920.10"
"244.3.160.248","48086","41.177.26.193","80","1574","1615397","528","35157","1046","1580240","86.589397000","17.9170","15697.75","705583.94"
"244.3.160.248","47566","41.177.26.55","80","11","2431","6","1539","5","892","45.067566000","17.8906","688.18","398.87"
"68.157.168.204","50809","41.177.26.176","80","191","78203","96","8908","95","69295","168.471061000","17.8897","3983.52","30987.67"
"168.176.95.55","10545","41.177.98.142","80","17","8922","8","777","9","8145","202.007220000","17.8708","347.83","3646.17"
"41.177.93.199","1141","244.3.41.84","23","16","6500","8","711","8","5789","138.215547000","17.8497","318.66","2594.55"
"46.144.210.156","49871","41.177.26.15","80","63","41056","32","2717","31","38339","47.136934000","17.6593","1230.85","17368.27"
"208.51.205.98","1353","41.177.26.176","80","30","14277","12","1879","18","12398","6.784854000","17.5977","854.20","5636.20"
"90.117.252.64","56486","41.177.98.142","80","17","8922","8","779","9","8143","147.696918000","17.5906","354.28","3703.34"
"117.218.106.199","50272","244.3.210.197","80","52","38233","22","6344","30","31889","114.622806000","17.5435","2892.93","14541.72"
"208.51.205.98","1363","41.177.26.15","80","175","160760","62","4897","113","155863","87.959029000","17.5394","2233.60","71091.71"
"244.3.160.248","47784","41.177.26.193","80","17","5040","9","3647","8","1393","64.817742000","17.5082","1666.42","636.50"
"244.3.160.248","48207","41.177.26.193","80","15","4303","8","2996","7","1307","103.643591000","17.4830","1370.93","598.07"
"208.51.205.98","1369","41.177.26.176","80","35","14852","17","2300","18","12552","203.111986000","17.4129","1056.69","5766.77"
"244.3.160.248","48474","41.177.26.193","80","233","228051","81","7815","152","220236","119.474735000","17.4121","3590.61","101187.58"
"209.57.198.106","2783","41.177.98.142","80","17","8914","8","771","9","8143","137.463553000","17.4096","354.29","3741.85"
"41.177.98.43","38619","41.177.26.155","8010","26","9176","14","2886","12","6290","193.523774000","17.4033","1326.65","2891.41"
"41.177.98.43","38601","41.177.26.155","8010","30","11024","16","3508","14","7516","148.432485000","17.3962","1613.23","3456.39"
"208.51.205.98","1355","41.177.26.15","80","180","165195","64","5045","116","160150","10.039514000","17.3540","2325.69","73827.31"
"208.51.205.98","1371","41.177.26.15","80","163","150052","57","4562","106","145490","205.545469000","17.3338","2105.48","67147.24"
"244.3.160.248","48476","41.177.26.193","80","21","8533","10","3256","11","5277","119.512269000","17.3248","1503.51","2436.73"
"244.3.160.248","48477","41.177.26.193","80","20","8255","10","3268","10","4987","119.512784000","17.3241","1509.11","2302.92"
"244.3.160.248","47130","41.177.26.55","80","33","21928","14","2174","19","19754","10.532414000","17.3224","1004.02","9122.98"
"41.177.98.43","38549","41.177.26.155","8010","26","8058","14","3200","12","4858","25.487715000","17.2755","1481.87","2249.66"
"208.51.205.98","1367","41.177.26.15","80","197","165234","82","6659","115","158575","127.715662000","17.2738","3083.98","73440.74"
"168.72.165.153","51053","41.177.26.176","80","37","19231","15","1518","22","17713","114.002951000","17.2667","703.32","8206.76"
"41.108.167.85","52749","244.3.210.197","443","2","128","2","128","0","0","2.857786000","17.2438","59.38","N/A"
"41.108.167.85","52748","244.3.210.197","443","2","128","2","128","0","0","2.857324000","17.2438","59.38","N/A"
"208.51.205.98","1365","41.177.26.176","80","35","15368","16","2205","19","13163","125.212544000","17.2333","1023.60","6110.49"
"244.3.199.218","2375","41.177.98.176","80","36","24417","14","1960","22","22457","128.571914000","17.2173","910.71","10434.60"
"41.177.98.43","38542","41.177.26.155","8010","26","6814","14","2912","12","3902","9.134148000","17.1896","1355.24","1815.98"
"41.177.98.43","38605","41.177.26.155","8010","26","7086","14","3214","12","3872","164.588687000","17.1795","1496.67","1803.08"
"244.3.160.248","47757","41.177.26.72","80","13","3419","7","1389","6","2030","58.866604000","17.1695","647.20","945.86"
"244.3.160.248","48465","41.177.26.72","80","13","3235","7","1205","6","2030","117.609315000","17.1694","561.46","945.87"
"244.3.160.248","47406","41.177.26.55","80","11","2304","6","1394","5","910","38.230555000","17.1548","650.08","424.37"
"41.177.98.43","38595","41.177.26.155","8010","22","4806","12","2468","10","2338","137.970287000","17.1387","1152.01","1091.33"
"41.177.98.43","38551","41.177.26.155","8010","22","5318","12","3060","10","2258","26.441474000","17.1317","1428.93","1054.42"
"151.77.135.33","49829","41.177.98.176","80","36","26430","15","3567","21","22863","46.453781000","17.1167","1667.14","10685.68"
"41.177.98.43","38567","41.177.26.155","8010","22","4710","12","2532","10","2178","62.711875000","17.1100","1183.87","1018.35"
"244.3.160.248","49513","41.177.26.55","80","25","13619","11","2558","14","11061","179.547726000","17.1003","1196.71","5174.65"
"117.218.106.199","50274","244.3.210.197","80","31","20178","16","5197","15","14981","115.294861000","17.0999","2431.36","7008.68"
"41.177.98.43","38568","41.177.26.155","8010","22","5164","12","3056","10","2108","66.108397000","17.0833","1431.11","987.17"
"41.177.98.43","38538","41.177.26.155","8010","16","4648","8","2318","8","2330","3.954904000","17.0694","1086.39","1092.01"
"41.177.98.43","38585","41.177.26.155","8010","22","5318","12","3060","10","2258","93.666097000","17.0646","1434.55","1058.57"
"41.177.98.43","38612","41.177.26.155","8010","22","5092","12","2744","10","2348","187.916899000","17.0604","1286.72","1101.03"
"41.177.98.43","38593","41.177.26.155","8010","22","5018","12","2524","10","2494","125.302626000","17.0570","1183.80","1169.73"
"244.3.160.248","47698","41.177.26.55","80","16","6432","8","1317","8","5115","53.710107000","17.0557","617.74","2399.20"
"41.177.98.43","38586","41.177.26.155","8010","22","5050","12","2858","10","2192","95.195627000","17.0550","1340.60","1028.20"
"244.3.160.248","47796","41.177.26.55","80","22","12116","10","990","12","11126","66.281930000","17.0439","464.68","5222.28"
"244.3.160.248","49206","41.177.26.55","80","22","12095","10","976","12","11119","165.114433000","17.0433","458.13","5219.18"
"244.3.160.248","49426","41.177.26.55","80","22","12041","10","985","12","11056","175.646662000","17.0412","462.41","5190.23"
"244.3.160.248","47950","41.177.26.55","80","24","12225","11","1044","13","11181","77.805027000","17.0410","490.11","5248.98"
"253.201.253.231","3852","253.37.253.43","23","4","3771","0","0","4","3771","105.844968000","17.0403","N/A","1770.39"
"244.3.160.248","48795","41.177.26.55","80","22","12037","10","983","12","11054","131.798389000","17.0388","461.54","5190.05"
"244.3.160.248","49229","41.177.26.55","80","22","12099","10","978","12","11121","167.190610000","17.0371","459.23","5222.02"
"244.3.160.248","48693","41.177.26.55","80","22","12112","10","988","12","11124","127.689924000","17.0370","463.93","5223.45"
"244.3.160.248","48824","41.177.26.55","80","24","12398","11","1034","13","11364","134.150643000","17.0365","485.55","5336.30"
"244.3.160.248","47853","41.177.26.55","80","11","2692","6","1610","5","1082","69.220287000","17.0357","756.06","508.11"
"244.3.160.248","47137","41.177.26.55","80","22","12095","10","976","12","11119","12.839710000","17.0352","458.34","5221.65"
"244.3.160.248","47131","41.177.26.55","80","24","12547","11","1051","13","11496","10.999751000","17.0351","493.57","5398.72"
"244.3.160.248","49025","41.177.26.55","80","22","12109","10","983","12","11126","143.312453000","17.0348","461.64","5225.07"
"244.3.160.248","49766","41.177.26.55","80","11","2429","6","1497","5","932","206.064646000","17.0338","703.07","437.72"
"244.3.160.248","49225","41.177.26.55","80","24","12678","11","1052","13","11626","167.034110000","17.0336","494.08","5460.26"
"244.3.160.248","47938","41.177.26.55","80","22","12104","10","984","12","11120","76.333026000","17.0330","462.16","5222.80"
"244.3.160.248","48469","41.177.26.55","80","22","12099","10","978","12","11121","118.693966000","17.0328","459.35","5223.32"
"244.3.160.248","47198","41.177.26.55","80","22","12107","10","982","12","11125","25.114443000","17.0328","461.23","5225.22"
"244.3.160.248","49657","41.177.26.55","80","22","12099","10","978","12","11121","190.796789000","17.0313","459.39","5223.79"
"41.177.98.43","38582","41.177.26.155","8010","22","4928","12","3082","10","1846","85.293224000","17.0277","1447.99","867.29"
"244.3.160.248","47272","41.177.26.55","80","22","12037","10","983","12","11054","29.778645000","17.0266","461.86","5193.75"
"244.3.160.248","49695","41.177.26.55","80","22","12109","10","983","12","11126","196.282091000","17.0263","461.87","5227.69"
"244.3.160.248","48250","41.177.26.55","80","22","12096","10","977","12","11119","107.901699000","17.0262","459.06","5224.42"
"41.177.98.43","38557","41.177.26.155","8010","22","4650","12","2932","10","1718","38.927774000","17.0250","1377.74","807.28"
"244.3.160.248","49570","41.177.26.55","80","22","12103","10","980","12","11123","184.383958000","17.0241","460.52","5226.96"
"244.3.160.248","49576","41.177.26.55","80","24","12667","11","1045","13","11622","186.024968000","17.0231","491.10","5461.77"
"244.3.160.248","47708","41.177.26.55","80","22","12109","10","983","12","11126","54.778964000","17.0193","462.06","5229.82"
"55.161.39.39","58705","41.177.26.176","80","24","16012","9","1446","15","14566","83.633845000","17.0165","679.81","6847.93"
"41.202.64.43","58215","41.177.26.176","80","21","7450","10","1412","11","6038","36.292868000","17.0007","664.45","2841.30"
"117.218.106.199","50276","244.3.210.197","80","24","10021","13","7455","11","2566","115.321655000","16.9964","3508.97","1207.78"
"117.218.106.199","50273","244.3.210.197","80","63","50777","27","8369","36","42408","115.272400000","16.9696","3945.40","19992.40"
"41.202.64.43","58216","41.177.26.176","80","19","4772","9","1453","10","3319","36.341127000","16.9524","685.69","1566.27"
"41.202.64.43","58217","41.177.26.176","80","37","24551","15","1890","22","22661","36.342660000","16.9514","891.96","10694.60"
"68.157.168.51","45835","41.177.26.176","80","116","39466","58","5153","58","34313","15.189838000","16.9219","2436.14","16221.84"
"244.3.160.248","48148","41.177.26.55","80","24","11503","11","2552","13","8951","91.514795000","16.9065","1207.58","4235.53"
"244.3.117.205","1321","244.3.41.84","23","52","11128","24","2019","28","9109","68.353415000","16.8543","958.33","4323.64"
"244.3.160.248","48569","41.177.26.193","80","13","3900","7","1818","6","2082","123.368899000","16.8153","864.93","990.53"
"244.3.160.248","47944","41.177.26.55","80","22","12114","10","989","12","11125","77.388606000","16.7943","471.11","5299.42"
"117.218.106.199","50275","244.3.210.197","80","33","15496","19","11910","14","3586","115.304935000","16.7854","5676.36","1709.10"
"241.82.197.177","62523","41.177.26.176","80","120","69786","49","5399","71","64387","118.663091000","16.7269","2582.19","30794.44"
"41.122.117.224","55803","41.177.26.176","80","17","7017","8","1152","9","5865","87.292662000","16.7264","550.99","2805.15"
"85.108.117.193","49946","41.177.26.176","80","10","1629","6","703","4","926","82.120870000","16.7070","336.63","443.41"
"41.177.181.81","49205","41.177.98.176","80","14","5513","7","2310","7","3203","42.134804000","16.6938","1107.00","1534.94"
"41.177.98.43","38545","41.177.26.155","8010","22","5292","12","3040","10","2252","20.991218000","16.6314","1462.29","1083.25"
"117.98.57.20","47289","41.177.26.15","80","3","192","2","128","1","64","13.614336000","16.5536","61.86","N/A"
"165.33.138.84","1360","244.3.210.197","443","132","116426","54","9898","78","106528","135.265531000","16.5350","4788.86","51540.52"
"117.98.57.20","47288","41.177.26.176","80","3","192","2","128","1","64","13.644177000","16.5238","61.97","N/A"
"223.72.203.218","50968","41.177.26.151","8000","4","256","0","0","4","256","107.027693000","16.5201","N/A","123.97"
"40.193.23.224","49885","41.177.98.176","80","69","52363","28","2558","41","49805","204.087466000","16.4886","1241.10","24164.62"
"40.193.23.224","49886","41.177.98.176","80","23","9004","11","1701","12","7303","204.088028000","16.4882","825.32","3543.38"
"40.193.23.224","49887","41.177.98.176","80","32","16964","14","2003","18","14961","204.089897000","16.4868","971.93","7259.64"
"40.193.23.224","49888","41.177.98.176","80","22","9237","11","1702","11","7535","204.090681000","16.4855","825.94","3656.54"
"40.193.23.224","49889","41.177.98.176","80","25","13059","11","1367","14","11692","204.091082000","16.4847","663.40","5674.12"
"48.176.68.231","33085","41.177.26.15","80","167","150608","62","5045","105","145563","215.056767000","16.4789","2449.20","70666.44"
"244.3.153.197","49684","41.177.24.241","993","9","960","6","624","3","336","9.638891000","16.3692","304.96","164.21"
"68.157.168.43","54693","41.177.26.176","80","150","51112","74","6598","76","44514","177.882221000","16.3646","3225.50","21761.12"
"151.77.205.22","50020","41.177.98.176","80","47","33756","20","4612","27","29144","154.218074000","16.3131","2261.74","14292.29"
"203.22.116.24","1195","244.3.41.84","23","10","2956","6","554","4","2402","3.974039000","16.3040","271.84","1178.61"
"244.3.160.248","47290","41.177.26.55","80","24","12584","11","1050","13","11534","32.431151000","16.2951","515.49","5662.56"
"252.77.177.67","3268","41.177.26.176","80","21","10207","9","1242","12","8965","116.255260000","16.2231","612.46","4420.86"
"89.160.185.98","57928","244.3.210.197","80","286","217575","147","23623","139","193952","38.901328000","16.1733","11684.92","95936.77"
"106.217.244.253","1429","41.177.26.176","80","103","61194","35","6899","68","54295","9.880059000","16.1689","3413.47","26863.97"
"18.181.168.132","1080","244.3.210.197","80","10","1646","6","1181","4","465","184.446671000","16.0769","587.68","231.39"
"18.181.168.132","1079","244.3.210.197","80","10","1654","6","1190","4","464","184.445197000","16.0766","592.17","230.89"
"40.193.23.224","49898","41.177.98.176","80","24","13602","11","1037","13","12565","204.510964000","16.0655","516.39","6256.88"
"225.176.204.185","49909","41.177.26.13","80","93","85022","31","3499","62","81523","206.838754000","15.8259","1768.75","41209.97"
"151.239.66.180","57626","41.177.26.176","80","19","8951","9","1264","10","7687","176.806453000","15.8155","639.37","3888.34"
"68.157.168.192","45036","41.177.26.176","80","106","39739","53","4804","53","34935","23.147595000","15.7966","2432.93","17692.44"
"41.177.98.43","38560","41.177.26.155","8010","26","8620","14","3620","12","5000","47.791971000","15.7794","1835.31","2534.95"
"151.77.135.33","49836","41.177.98.176","80","56","47674","22","2883","34","44791","148.079552000","15.7012","1468.93","22821.70"
"244.3.160.248","48113","41.177.26.72","80","13","3265","7","1235","6","2030","88.057899000","15.6633","630.77","1036.82"
"244.3.185.40","2621","41.177.98.176","80","163","134636","63","13813","100","120823","172.980963000","15.5776","7093.77","62049.56"
"215.43.45.145","1316","41.177.26.15","80","155","141049","54","3869","101","137180","32.000317000","15.5686","1988.10","70490.41"
"41.177.98.43","38592","41.177.26.155","8010","22","5270","12","2852","10","2418","120.641744000","15.5513","1467.14","1243.88"
"41.177.98.43","38625","41.177.26.155","8010","26","6886","14","1916","12","4970","205.034942000","15.5428","986.18","2558.11"
"244.3.153.177","1910","244.3.160.80","443","14","2662","7","1416","7","1246","187.311016000","15.5425","728.84","641.34"
"244.3.164.145","3238","41.177.98.176","80","18","4775","9","3552","9","1223","51.301282000","15.5281","1829.97","630.08"
"244.3.164.145","3239","41.177.98.176","80","16","3777","8","2778","8","999","51.302918000","15.5264","1431.36","514.73"
"244.3.153.30","1790","244.3.160.80","443","28","12897","11","1815","17","11082","45.611643000","15.4502","939.79","5738.18"
"215.43.45.145","1314","41.177.26.176","80","18","5095","9","3821","9","1274","31.692006000","15.4485","1978.70","659.74"
"16.45.55.23","1847","41.177.98.176","80","19","8191","9","790","10","7401","29.127316000","15.4140","410.02","3841.18"
"145.188.2.106","32853","41.177.26.176","80","30","15019","15","2524","15","12495","167.570803000","15.2631","1322.93","6549.11"
"244.3.153.48","1881","244.3.160.80","443","18","5486","8","2514","10","2972","180.160905000","15.2534","1318.53","1558.74"
"203.117.47.177","50369","41.177.98.176","80","9","1314","5","853","4","461","51.792726000","15.2491","447.50","241.85"
"241.82.68.241","56428","41.177.98.176","80","13","5525","7","1264","6","4261","143.911626000","15.2008","665.23","2242.52"
"41.177.98.43","38574","41.177.26.155","8010","22","4714","12","2654","10","2060","76.727826000","15.1681","1399.78","1086.49"
"215.43.45.145","1322","41.177.26.176","80","11","1723","6","1227","5","496","89.656256000","15.1667","647.21","261.62"
"15.38.91.90","43725","41.177.26.176","80","26","10654","11","1201","15","9453","195.248318000","15.1595","633.79","4988.55"
"165.33.138.84","1367","244.3.210.197","443","166","164723","58","5695","108","159028","137.450685000","15.1540","3006.46","83952.79"
"198.177.110.202","36545","41.177.26.22","80","9","1539","5","514","4","1025","211.688225000","15.1415","271.57","541.56"
"41.177.98.43","38565","41.177.26.155","8010","22","5278","12","2858","10","2420","57.825825000","15.1343","1510.74","1279.22"
"244.3.153.25","50830","244.3.160.80","443","15","3024","7","1268","8","1756","188.742259000","15.1122","671.25","929.58"
"215.43.45.145","1310","41.177.26.176","80","8","1556","4","1153","4","403","4.558990000","15.0792","611.71","213.80"
"244.3.153.34","58154","41.177.3.145","443","24","5310","14","3433","10","1877","201.730380000","15.0192","1828.60","999.79"
"165.33.138.84","1366","244.3.210.197","443","93","88932","34","5068","59","83864","137.446543000","14.9558","2710.91","44859.51"
"15.128.184.13","2928","41.177.26.176","80","27","14452","10","1398","17","13054","61.199788000","14.8636","752.44","7026.04"
"165.33.138.84","1365","244.3.210.197","443","91","82747","35","5121","56","77626","137.446537000","14.6088","2804.34","42509.25"
"145.219.142.106","51672","41.177.26.176","80","197","149827","67","13538","130","136289","219.313230000","14.5652","7435.82","74857.42"
"68.157.168.121","34111","41.177.26.176","80","134","51792","67","6143","67","45649","92.482653000","14.5387","3380.23","25118.70"
"68.157.168.111","44965","41.177.26.176","80","97","38521","49","4526","48","33995","0.498135000","14.3051","2531.13","19011.46"
"165.33.138.84","1368","244.3.210.197","443","26","19880","13","3720","13","16160","138.100570000","14.3018","2080.85","9039.41"
"145.219.142.106","51673","41.177.26.176","80","188","161983","64","12025","124","149958","219.339235000","14.2595","6746.38","84130.92"
"41.177.98.220","7030","244.3.79.4","1541","42","6972","20","4248","22","2724","4.193379000","14.1970","2393.75","1534.98"
"68.157.168.224","45627","41.177.26.15","80","279","236059","113","9059","166","227000","26.269862000","14.1624","5117.20","128226.47"
"249.18.39.225","1657","41.177.26.176","80","19","7322","9","1918","10","5404","220.314677000","14.1571","1083.84","3053.74"
"165.33.138.84","1364","244.3.210.197","443","63","55286","26","4540","37","50746","137.441255000","14.1560","2565.69","28678.07"
"68.157.168.224","38492","41.177.26.15","80","351","320379","126","9737","225","310642","52.924430000","14.1321","5511.98","175850.18"
"253.142.253.37","1710","253.37.253.43","23","12","8891","0","0","12","8891","220.174445000","14.1079","N/A","5041.71"
"68.157.168.253","60576","41.177.26.176","80","123","41436","59","5131","64","36305","103.114301000","14.0576","2919.99","20660.71"
"68.157.168.204","35851","41.177.26.176","80","93","38650","47","4362","46","34288","213.853919000","13.8903","2512.26","19747.90"
"68.157.168.224","63935","41.177.26.15","80","271","240572","102","8070","169","232502","168.408616000","13.8894","4648.15","133916.26"
"68.157.168.209","55638","41.177.26.176","80","115","38606","57","5079","58","33527","133.827228000","13.8790","2927.59","19325.35"
"68.157.168.106","37807","41.177.26.176","80","95","37563","48","4408","47","33155","91.182333000","13.8468","2546.72","19155.32"
"41.13.93.230","52443","244.3.210.197","80","115","92353","46","7435","69","84918","160.450494000","13.8399","4297.73","49086.02"
"244.3.199.218","2379","41.177.98.176","80","63","49344","23","4811","40","44533","206.850451000","13.7416","2800.83","25925.87"
"145.219.142.106","51667","41.177.26.176","80","157","134709","56","11120","101","123589","218.232768000","13.7301","6479.22","72010.79"
"68.157.168.160","63317","41.177.26.176","80","95","39754","48","4466","47","35288","68.519418000","13.6073","2625.65","20746.49"
"41.106.90.203","61111","244.3.210.197","80","37","21549","19","5644","18","15905","64.879624000","13.5912","3322.15","9361.94"
"151.77.205.22","50044","41.177.98.176","80","14","6434","8","3963","6","2471","211.687711000","13.5769","2335.14","1456.00"
"141.231.176.176","52009","41.177.26.176","80","4","280","2","140","2","140","0.144332000","13.5435","82.70","82.70"
"68.157.168.110","45828","41.177.26.176","80","74","26364","37","3309","37","23055","56.481855000","13.5133","1958.96","13648.79"
"68.157.168.194","37096","41.177.26.91","80","145","110028","69","6154","76","103874","156.327569000","13.5122","3643.51","61499.21"
"68.157.168.111","48133","41.177.26.176","80","154","50940","76","6783","78","44157","185.759052000","13.4426","4036.73","26278.93"
"68.157.168.253","48763","41.177.26.176","80","123","39062","60","5216","63","33846","60.483357000","13.2709","3144.33","20403.21"
"41.177.93.93","4938","244.3.41.84","23","15","5501","8","634","7","4867","203.643356000","13.2534","382.69","2937.82"
"244.3.153.102","2847","244.3.160.128","443","21","6387","11","2725","10","3662","197.620474000","13.1641","1656.03","2225.45"
"244.3.153.156","3740","41.177.116.45","443","264","121476","98","13697","166","107779","221.133734000","13.0790","8377.98","65924.71"
"194.66.204.242","1142","244.3.41.84","23","6","2660","3","233","3","2427","95.240704000","13.0562","142.77","1487.11"
"68.157.168.156","50463","41.177.26.176","80","91","38817","46","4308","45","34509","127.147559000","12.9437","2662.62","21328.75"
"68.157.168.106","54991","41.177.26.176","80","83","37976","42","4011","41","33965","201.749941000","12.8924","2488.91","21076.01"
"249.18.39.225","1654","41.177.26.176","80","75","59123","30","3284","45","55839","220.301732000","12.7828","2055.26","34946.37"
"249.18.39.225","1655","41.177.26.176","80","30","15970","13","2635","17","13335","220.309545000","12.7525","1653.01","8365.40"
"249.18.39.225","1656","41.177.26.176","80","24","11535","10","1995","14","9540","220.312023000","12.7116","1255.55","6003.98"
"145.219.142.106","51671","41.177.26.176","80","128","101101","50","11719","78","89382","219.313227000","12.6616","7404.45","56474.51"
"145.219.142.106","51669","41.177.26.176","80","214","190287","74","12282","140","178005","219.308845000","12.5539","7826.72","113433.98"
"254.214.213.72","3425","41.177.98.127","210","336","278921","124","8663","212","270258","169.553098000","12.5351","5528.81","172481.41"
"253.127.160.213","1338","253.37.253.43","23","11","7305","0","0","11","7305","13.945211000","12.4896","N/A","4679.08"
"168.117.3.145","7590","244.3.160.239","80","5241","5278969","1768","114150","3473","5164819","189.781602000","12.1309","75278.77","3406055.44"
"41.177.98.220","7030","41.177.211.151","1628","30","5547","13","3423","17","2124","0.920511000","12.0739","2268.03","1407.33"
"244.3.160.248","46976","41.177.26.193","80","4","256","2","128","2","128","1.736252000","12.0183","85.20","85.20"
"244.3.160.239","62514","197.154.128.43","80","5206","5277209","1796","115996","3410","5161213","189.858031000","12.0075","77282.20","3438652.06"
"68.157.168.111","40818","41.177.26.176","80","37","13335","19","1686","18","11649","57.825350000","11.7116","1151.67","7957.21"
"68.157.168.139","56655","41.177.26.176","80","40","12923","20","1755","20","11168","59.153464000","11.6416","1206.02","7674.58"
"68.157.168.13","55470","41.177.26.176","80","89","40784","45","4273","44","36511","140.540352000","11.6353","2937.95","25103.55"
"253.142.108.12","3016","253.37.253.43","23","8","6286","0","0","8","6286","127.131245000","11.5810","N/A","4342.30"
"244.3.160.239","61835","128.71.90.164","80","123","107650","49","11154","74","96496","80.761783000","11.4436","7797.58","67458.79"
"68.157.168.106","63104","41.177.26.176","80","73","25552","37","3311","36","22241","173.802835000","11.3978","2323.96","15610.77"
"68.33.186.67","14306","244.3.160.239","80","135","110922","37","10435","98","100487","80.748590000","11.3931","7327.26","70560.08"
"41.177.98.220","7010","244.3.93.224","1103","4","525","1","174","3","351","0.163879000","11.3748","N/A","246.86"
"15.128.184.13","16143","41.177.26.176","80","27","15801","9","1316","18","14485","120.482210000","11.3019","931.53","10253.16"
"244.3.160.248","49034","41.177.26.55","80","24","12592","11","1054","13","11538","150.041739000","10.8915","774.18","8474.87"
"68.64.225.84","49356","244.3.210.197","80","415","393662","157","30720","258","362942","174.713983000","10.7673","22824.63","269662.03"
"254.194.155.203","39955","41.177.26.46","80","1101","1124119","332","24848","769","1099271","223.711716000","10.6921","18591.67","822492.12"
"244.3.160.248","47350","41.177.26.55","80","22","12095","10","976","12","11119","36.921181000","10.6608","732.40","8343.80"
"186.136.103.68","7646","244.3.160.239","80","682","713630","195","14391","487","699239","33.823156000","10.6429","10817.40","525602.43"
"15.71.149.241","51637","41.177.26.15","80","1051","1200031","227","16778","824","1183253","8.029973000","10.6407","12614.24","889607.72"
"244.3.153.40","2340","41.177.3.117","445","25","4479","14","2415","11","2064","172.697304000","10.6055","1821.70","1556.93"
"68.157.168.253","61655","41.177.26.176","80","100","39362","50","4541","50","34821","45.808315000","10.6001","3427.14","26279.76"
"68.157.168.192","55912","41.177.26.176","80","94","27439","46","3957","48","23482","113.809326000","10.5837","2991.02","17749.58"
"168.82.241.192","2301","41.177.26.176","80","57","43979","26","1881","31","42098","194.145605000","10.5288","1429.23","31987.03"
"68.33.186.67","12516","244.3.160.239","80","13","6797","4","1216","9","5581","101.926582000","10.5104","925.56","4248.00"
"41.18.225.254","13331","244.3.210.197","80","3","198","1","64","2","134","53.018539000","10.4314","N/A","102.77"
"41.177.92.61","2155","41.177.98.176","80","35","15924","18","12732","17","3192","212.117322000","10.3796","9813.05","2460.20"
"68.157.168.197","53504","41.177.26.176","80","106","39430","53","4798","53","34632","104.467317000","10.2884","3730.82","26929.05"
"244.3.153.209","4256","41.177.24.241","443","23","6639","11","2326","12","4313","69.339720000","10.1921","1825.72","3385.35"
"244.3.41.252","48339","41.177.26.205","5666","3","210","3","210","0","0","66.705742000","10.1534","165.46","N/A"
"253.213.253.214","1431","253.37.253.43","23","6","3362","0","0","6","3362","119.013808000","10.1451","N/A","2651.12"
"41.18.225.254","13342","244.3.210.197","80","3","198","1","64","2","134","48.338035000","10.1123","N/A","106.01"
"41.18.225.254","13338","244.3.210.197","80","3","198","1","64","2","134","48.337995000","10.1123","N/A","106.01"
"41.18.225.254","13347","244.3.210.197","80","3","198","1","64","2","134","48.338081000","10.1122","N/A","106.01"
"41.18.225.254","13343","244.3.210.197","80","3","198","1","64","2","134","48.338097000","10.1121","N/A","106.01"
"41.18.225.254","13354","244.3.210.197","80","3","198","1","64","2","134","48.338208000","10.1121","N/A","106.01"
"41.18.225.254","13351","244.3.210.197","80","3","198","1","64","2","134","48.338000000","10.1120","N/A","106.01"
"41.18.225.254","13330","244.3.210.197","80","3","198","1","64","2","134","48.338049000","10.1120","N/A","106.01"
"41.18.225.254","13349","244.3.210.197","80","3","198","1","64","2","134","48.338040000","10.1120","N/A","106.01"
"41.18.225.254","13348","244.3.210.197","80","3","198","1","64","2","134","48.338045000","10.1119","N/A","106.01"
"41.18.225.254","13333","244.3.210.197","80","3","198","1","64","2","134","48.338336000","10.1119","N/A","106.01"
"41.18.225.254","13337","244.3.210.197","80","3","198","1","64","2","134","48.338326000","10.1119","N/A","106.01"
"41.18.225.254","13352","244.3.210.197","80","3","198","1","64","2","134","48.338273000","10.1119","N/A","106.01"
"41.18.225.254","13269","244.3.210.197","80","3","198","1","64","2","134","48.338322000","10.1118","N/A","106.01"
"41.18.225.254","13350","244.3.210.197","80","3","198","1","64","2","134","48.338303000","10.1118","N/A","106.01"
"41.18.225.254","13332","244.3.210.197","80","3","198","1","64","2","134","48.338361000","10.1118","N/A","106.02"
"41.18.225.254","13353","244.3.210.197","80","3","198","1","64","2","134","48.338353000","10.1117","N/A","106.02"
"244.3.153.209","4257","41.177.24.241","443","22","5624","11","2193","11","3431","198.860846000","10.1046","1736.23","2716.38"
"215.43.45.145","1324","41.177.26.15","80","259","260587","75","5957","184","254630","89.796525000","10.0966","4720.02","201755.53"
"68.157.168.13","55885","41.177.26.176","80","76","26080","38","3377","38","22703","116.456285000","10.0522","2687.56","18068.04"
"117.255.177.145","37850","244.3.210.197","80","219","178176","89","25245","130","152931","173.112562000","10.0235","20148.58","122057.53"
"18.181.168.132","1102","244.3.210.197","80","33","10082","19","6069","14","4013","185.505122000","9.8779","4915.21","3250.08"
"68.157.168.194","63331","41.177.26.91","80","83","58904","41","3544","42","55360","108.376666000","9.8147","2888.74","45124.33"
"68.157.168.203","38239","41.177.26.176","80","67","25816","34","3102","33","22714","161.803098000","9.8114","2529.29","18520.42"
"68.64.225.84","49357","244.3.210.197","80","401","378343","151","29923","250","348420","175.304542000","9.7824","24470.82","284935.43"
"41.177.230.224","36978","41.177.26.176","80","11","1402","6","466","5","936","78.194413000","9.7347","382.96","769.21"
"41.177.230.224","36979","41.177.26.84","80","24","11755","11","785","13","10970","78.203906000","9.7311","645.35","9018.49"
"85.41.34.188","15565","244.3.210.197","80","166","137066","75","18301","91","118765","33.737701000","9.7191","15063.89","97757.66"
"68.157.168.224","50022","41.177.26.15","80","172","159045","58","4678","114","154367","86.475298000","9.7172","3851.31","127087.56"
"177.202.57.176","34896","244.3.210.197","80","53","45362","21","4367","32","40995","207.339821000","9.6791","3609.44","33883.46"
"151.77.217.75","3551","244.3.160.239","80","48","27578","19","2272","29","25306","93.527365000","9.6549","1882.58","20968.51"
"41.18.225.254","13344","244.3.210.197","80","3","198","1","64","2","134","48.838509000","9.6120","N/A","111.53"
"41.18.225.254","13339","244.3.210.197","80","3","198","1","64","2","134","48.838504000","9.6120","N/A","111.53"
"41.18.225.254","13346","244.3.210.197","80","3","198","1","64","2","134","48.838575000","9.6119","N/A","111.53"
"41.18.225.254","13334","244.3.210.197","80","3","198","1","64","2","134","48.838562000","9.6119","N/A","111.53"
"41.18.225.254","13335","244.3.210.197","80","3","198","1","64","2","134","48.838567000","9.6119","N/A","111.53"
"41.18.225.254","13345","244.3.210.197","80","3","198","1","64","2","134","48.838697000","9.6118","N/A","111.53"
"41.18.225.254","13329","244.3.210.197","80","3","198","1","64","2","134","48.838595000","9.6118","N/A","111.53"
"41.18.225.254","13355","244.3.210.197","80","3","198","1","64","2","134","48.838591000","9.6118","N/A","111.53"
"41.18.225.254","13336","244.3.210.197","80","3","198","1","64","2","134","48.838770000","9.6116","N/A","111.53"
"41.18.225.254","13340","244.3.210.197","80","3","198","1","64","2","134","48.838718000","9.6113","N/A","111.54"
"41.18.225.254","13327","244.3.210.197","80","3","198","1","64","2","134","48.839030000","9.6109","N/A","111.54"
"18.181.168.132","1104","244.3.210.197","80","38","14970","21","6208","17","8762","185.508599000","9.4647","5247.27","7406.02"
"90.108.47.67","16686","244.3.210.197","80","4","264","1","66","3","198","127.663953000","9.4465","N/A","167.68"
"41.18.225.254","13341","244.3.210.197","80","3","198","1","64","2","134","59.018661000","9.4313","N/A","113.66"
"252.77.177.67","3274","41.177.26.176","80","23","13312","10","1983","13","11329","221.275767000","9.4072","1686.37","9634.35"
"18.181.168.132","1103","244.3.210.197","80","33","10322","19","6064","14","4258","185.506603000","9.3780","5172.94","3632.32"
"85.41.34.188","15562","244.3.210.197","80","322","272093","143","21585","179","250508","33.182099000","9.3768","18415.73","213726.54"
"117.218.106.199","50283","244.3.210.197","80","4","264","1","66","3","198","132.401274000","9.3030","N/A","170.27"
"215.160.91.82","49191","244.3.210.197","80","84","67173","39","4642","45","62531","97.790012000","9.3020","3992.25","53778.46"
"244.3.160.248","48473","41.177.26.193","80","28","15045","13","4742","15","10303","119.474082000","9.3018","4078.34","8861.05"
"18.181.168.132","1083","244.3.210.197","80","55","29145","28","7454","27","21691","185.486155000","9.2918","6417.73","18675.46"
"244.3.210.230","3419","253.23.23.108","445","3","198","3","198","0","0","211.809273000","9.2530","171.19","N/A"
"68.157.168.224","38673","41.177.26.15","80","53","31920","27","2582","26","29338","67.835441000","9.2227","2239.70","25448.58"
"244.3.210.255","3277","68.83.39.67","110","3","198","3","198","0","0","28.443248000","9.2221","171.76","N/A"
"249.18.39.225","1658","41.177.26.176","80","20","9039","9","1931","11","7108","223.867043000","9.1767","1683.39","6196.53"
"117.218.106.199","50310","244.3.210.197","80","4","264","1","66","3","198","161.081529000","9.1697","N/A","172.74"
"253.244.77.47","3399","253.23.23.108","139","3","198","3","198","0","0","61.332230000","9.1558","173.01","N/A"
"244.3.210.230","3400","253.23.23.108","139","3","198","3","198","0","0","61.332328000","9.1557","173.01","N/A"
"244.3.153.102","2872","244.3.160.80","443","20","4143","9","1389","11","2754","223.869181000","9.0817","1223.56","2425.97"
"106.145.117.39","1568","244.3.61.142","445","3","198","3","198","0","0","162.669732000","9.0772","174.50","N/A"
"244.3.210.255","3278","68.83.39.67","110","3","198","3","198","0","0","33.432301000","9.0611","174.81","N/A"
"244.3.210.230","3393","253.23.23.108","1433","3","198","3","198","0","0","40.304724000","9.0545","174.94","N/A"
"244.3.210.230","3409","253.23.23.108","445","3","198","3","198","0","0","169.458220000","9.0525","174.98","N/A"
"244.3.210.230","3412","253.23.23.108","1433","3","198","3","198","0","0","190.783292000","9.0524","174.98","N/A"
"244.3.210.230","3411","253.23.23.108","139","3","198","3","198","0","0","169.458435000","9.0521","174.99","N/A"
"253.244.77.47","3420","253.23.23.108","139","3","198","3","198","0","0","211.809375000","9.0488","175.05","N/A"
"244.3.210.230","3421","253.23.23.108","139","3","198","3","198","0","0","211.809470000","9.0487","175.05","N/A"
"244.3.210.230","3398","253.23.23.108","445","3","198","3","198","0","0","61.332121000","9.0475","175.08","N/A"
"244.3.210.230","3407","253.23.23.108","1433","3","198","3","198","0","0","148.451536000","9.0365","175.29","N/A"
"117.255.177.145","37851","244.3.210.197","80","138","99105","62","24424","76","74681","173.707272000","9.0253","21649.42","66197.21"
"193.253.223.2","2264","244.3.210.197","25","3","198","3","198","0","0","73.390893000","9.0144","175.72","N/A"
"151.43.219.4","60506","41.177.26.91","80","23","10112","12","1407","11","8705","156.645679000","9.0081","1249.55","7730.86"
"48.244.145.177","2884","244.3.210.197","80","4","264","1","66","3","198","103.827253000","9.0021","N/A","175.96"
"117.218.106.199","50284","244.3.210.197","80","4","264","1","66","3","198","132.407912000","8.9838","N/A","176.32"
"41.225.241.128","58706","41.177.98.3","3942","3","198","3","198","0","0","130.352677000","8.9714","176.56","N/A"
"215.160.91.82","37853","244.3.210.197","80","37","21594","21","4757","16","16837","96.349436000","8.9649","4245.02","15024.90"
"253.244.77.47","3390","253.23.23.108","139","3","198","3","198","0","0","19.282438000","8.9555","176.87","N/A"
"244.3.210.255","3283","68.83.39.67","110","3","198","3","198","0","0","53.432034000","8.9518","176.95","N/A"
"244.3.210.230","3388","253.23.23.108","445","3","198","3","198","0","0","19.282330000","8.9517","176.95","N/A"
"253.244.77.47","3410","253.23.23.108","139","3","198","3","198","0","0","169.458335000","8.9516","176.95","N/A"
"244.3.210.230","3391","253.23.23.108","139","3","198","3","198","0","0","19.282537000","8.9515","176.95","N/A"
"91.123.197.210","4219","244.3.31.244","445","3","198","3","198","0","0","200.815689000","8.9362","177.26","N/A"
"41.13.93.230","52445","244.3.210.197","80","55","41733","23","5088","32","36645","160.455135000","8.8908","4578.24","32973.57"
"68.157.168.106","43380","41.177.26.176","80","112","38427","56","5030","56","33397","28.496768000","8.8856","4528.68","30068.44"
"117.218.106.199","50285","244.3.210.197","80","4","264","1","66","3","198","132.414417000","8.8523","N/A","178.94"
"68.157.168.13","61238","41.177.26.176","80","73","26031","36","2887","37","23144","0.743642000","8.8401","2612.65","20944.62"
"117.218.106.199","50311","244.3.210.197","80","4","264","1","66","3","198","161.243964000","8.7885","N/A","180.24"
"68.157.168.156","33579","41.177.26.176","80","72","25437","36","3263","36","22174","41.869233000","8.7883","2970.31","20185.02"
"253.180.108.127","1226","253.37.253.43","23","19","1612","0","0","19","1612","3.669205000","8.7809","N/A","1468.65"
"244.3.160.239","61565","85.224.40.142","80","372","373593","128","8690","244","364903","46.599800000","8.7798","7918.15","332492.24"
"168.223.67.89","2656","244.3.210.197","80","80","48169","43","13890","37","34279","8.120821000","8.6994","12773.24","31522.97"
"177.202.57.176","34898","244.3.210.197","80","125","115916","48","5621","77","110295","208.193927000","8.6435","5202.52","102083.69"
"253.37.253.43","54737","253.160.108.253","21","111","9876","111","9876","0","0","115.137427000","8.5626","9227.13","N/A"
"68.157.168.139","46988","41.177.26.176","80","78","26968","39","3503","39","23465","75.143405000","8.5463","3279.07","21965.00"
"151.77.192.83","16274","244.3.160.239","80","374","373717","128","8759","246","364958","46.595790000","8.5381","8207.02","341958.79"
"177.202.57.176","34901","244.3.210.197","80","170","173295","55","5945","115","167350","208.195854000","8.3348","5706.16","160626.79"
"244.3.160.248","49983","41.177.26.193","80","34","23828","14","2576","20","21252","222.611740000","8.3277","2474.64","20415.75"
"244.3.160.239","59447","176.41.89.121","80","126","107033","46","2944","80","104089","0.196116000","8.2583","2851.92","100833.49"
"244.3.210.98","2802","186.77.47.194","80","11","1145","6","476","5","669","202.122641000","8.1578","466.79","656.06"
"68.67.164.34","4373","244.3.210.197","80","3","606","0","0","3","606","2.141275000","8.1406","N/A","595.53"
"244.3.160.239","61972","40.248.176.156","80","211","199004","73","6133","138","192871","103.735800000","8.0949","6061.08","190609.11"
"41.177.199.139","6497","244.3.160.239","80","295","203477","102","7814","193","195663","103.732434000","8.0677","7748.41","194020.74"
"41.177.40.117","13891","244.3.160.239","80","114","106271","35","2240","79","104031","0.198820000","8.0003","2239.92","104027.33"
"90.150.181.71","4115","244.3.210.197","80","173","166992","62","11418","111","155574","209.000809000","7.9959","11423.86","155653.91"
"68.157.168.224","47000","41.177.26.15","80","49","28642","25","2440","24","26202","123.994757000","7.9819","2445.52","26261.27"
"241.151.91.231","55925","41.177.98.127","210","11","917","6","520","5","397","211.833964000","7.8662","528.84","403.75"
"68.157.168.224","57113","41.177.26.15","80","2367","2436743","700","49650","1667","2387093","156.960605000","7.8659","50496.18","2427776.16"
"177.202.57.176","34899","244.3.210.197","80","56","49226","23","3970","33","45256","208.194750000","7.8351","4053.55","46208.38"
"177.202.57.176","34897","244.3.210.197","80","150","142671","56","6528","94","136143","208.193329000","7.7266","6758.98","140960.17"
"244.3.160.239","61750","188.68.214.181","80","161","156923","57","4372","104","152551","68.492763000","7.7058","4538.94","158376.09"
"41.177.176.106","13155","244.3.160.239","80","232","161086","79","5924","153","155162","68.477279000","7.6574","6189.01","162103.18"
"253.142.253.210","3407","253.37.253.43","23","6","4904","0","0","6","4904","129.024854000","7.6306","N/A","5141.43"
"18.239.218.37","61463","244.3.210.197","80","208","180034","85","31902","123","148132","190.154494000","7.5451","33825.39","157062.95"
"177.202.57.176","34900","244.3.210.197","80","70","64110","26","4137","44","59973","208.195466000","7.5326","4393.69","63694.14"
"68.157.168.98","46026","41.177.26.176","80","73","25496","37","3315","36","22181","83.152318000","7.5183","3527.38","23602.04"
"68.157.168.43","49304","41.177.26.176","80","69","26951","34","3100","35","23851","215.098382000","7.4692","3320.31","25546.05"
"41.177.98.220","7030","41.177.202.141","1437","27","5035","14","3138","13","1897","83.377117000","7.4601","3365.12","2034.30"
"16.176.93.164","5432","244.3.160.239","80","467","458892","159","11392","308","447500","82.786169000","7.4432","12244.25","480977.99"
"68.157.168.156","36272","41.177.26.176","80","53","27360","27","2627","26","24733","223.082747000","7.4358","2826.31","26609.53"
"68.157.168.43","61990","41.177.26.176","80","57","26123","29","2750","28","23373","197.849169000","7.4353","2958.84","25147.99"
"90.150.181.71","4122","244.3.210.197","80","136","128974","51","9124","85","119850","209.750798000","7.3920","9874.46","129707.86"
"90.150.181.71","4127","244.3.210.197","80","111","99626","43","8624","68","91002","209.766886000","7.3680","9363.76","98808.06"
"68.157.168.197","47253","41.177.26.176","80","75","25569","38","3402","37","22167","88.460301000","7.2882","3734.28","24332.10"
"241.82.197.204","26557","244.3.210.197","80","86","93083","19","4204","67","88879","0.015296000","7.2689","4626.85","97818.66"
"41.13.93.230","52446","244.3.210.197","80","225","201733","74","6589","151","195144","160.452869000","7.2643","7256.36","214908.81"
"41.13.93.230","52444","244.3.210.197","80","143","124493","49","5765","94","118728","160.457270000","7.2557","6356.34","130906.44"
"68.157.168.224","43539","41.177.26.15","80","281","260973","99","7491","182","253482","141.746472000","7.2408","8276.43","280059.70"
"68.157.168.194","34018","41.177.26.91","80","35","18970","18","1789","17","17181","139.998110000","7.2162","1983.32","19047.23"
"244.3.160.239","61461","198.123.241.156","80","1248","1622637","176","11998","1072","1610639","33.234072000","7.1941","13342.14","1791078.77"
"244.3.77.218","13833","244.3.160.239","80","2445","1714133","1150","74634","1295","1639499","33.189965000","7.1851","83098.08","1825431.01"
"215.160.91.82","42502","244.3.210.197","80","10","1911","6","1190","4","721","98.213771000","7.1006","1340.74","812.33"
"68.157.168.224","40127","41.177.26.15","80","53","31059","27","2499","26","28560","115.100335000","7.0820","2822.94","32262.19"
"244.3.153.197","50537","41.177.3.145","443","7","558","4","317","3","241","8.581858000","7.0718","358.61","272.63"
"244.3.160.239","61845","188.68.214.108","80","463","458614","161","11431","302","447183","82.983414000","6.9482","13161.38","514875.93"
"68.157.168.209","57445","41.177.26.176","80","35","12605","18","1567","17","11038","19.182210000","6.9426","1805.67","12719.18"
"82.193.18.57","55856","244.3.210.197","80","242","212580","97","14921","145","197659","165.283172000","6.8767","17358.29","229945.87"
"68.157.168.194","52017","41.177.26.91","80","61","39521","31","2873","30","36648","51.293394000","6.8677","3346.69","42690.42"
"68.157.168.121","41740","41.177.26.176","80","34","13382","17","1546","17","11836","7.171581000","6.8459","1806.62","13831.26"
"77.194.20.202","37669","244.3.210.197","80","60","43256","29","12765","31","30491","182.912644000","6.7811","15059.45","35971.61"
"68.157.168.164","33695","41.177.26.176","80","40","12931","20","1755","20","11176","12.483983000","6.7713","2073.44","13203.88"
"90.150.181.71","4128","244.3.210.197","80","251","263269","76","10683","175","252586","209.770839000","6.7198","12718.24","300706.66"
"90.150.181.71","4126","244.3.210.197","80","80","65606","33","8579","47","57027","209.762764000","6.7121","10225.18","67969.63"
"77.194.20.202","37675","244.3.210.197","80","67","50087","31","12262","36","37825","182.987877000","6.7038","14632.93","45138.70"
"244.3.160.248","49943","41.177.26.55","80","17","10479","8","1837","9","8642","216.810006000","6.6697","2203.40","10365.70"
"68.157.145.13","57436","244.3.210.255","443","28","15955","13","1500","15","14455","78.245663000","6.6117","1814.95","17490.11"
"41.13.93.230","52447","244.3.210.197","80","63","49299","25","3863","38","45436","161.319656000","6.5868","4691.83","55184.52"
"68.157.168.23","60652","41.177.26.176","80","42","12537","20","1751","22","10786","11.160824000","6.5793","2129.11","13115.13"
"68.157.168.224","54364","41.177.26.15","80","17","3818","9","1295","8","2523","202.090166000","6.5642","1578.26","3074.86"
"68.157.168.204","53735","41.177.26.176","80","33","12958","17","1565","16","11393","61.814642000","6.5319","1916.76","13953.74"
"68.157.168.121","53447","41.177.26.176","80","61","25933","31","2904","30","23029","123.115481000","6.4704","3590.48","28472.88"
"68.157.168.43","57071","41.177.26.176","80","35","12434","18","1617","17","10817","129.780140000","6.4422","2008.02","13432.72"
"85.41.34.188","15567","244.3.210.197","80","117","94705","53","12223","64","82482","33.747271000","6.4390","15186.14","102477.58"
"68.157.168.41","41547","41.177.26.176","80","35","12320","18","1611","17","10709","196.456451000","6.3695","2023.41","13450.45"
"68.157.168.204","50644","41.177.26.176","80","33","12461","17","1542","16","10919","157.817789000","6.3268","1949.79","13806.61"
"242.77.209.197","1163","244.3.210.197","80","96","70576","42","11211","54","59365","0.037273000","6.3134","14205.93","75223.90"
"68.157.168.197","40378","41.177.26.176","80","37","13744","19","1706","18","12038","72.484004000","6.3117","2162.35","15258.11"
"194.66.204.41","4514","244.3.41.84","23","33","6561","18","2298","15","4263","38.770682000","6.2938","2920.98","5418.69"
"252.66.75.111","49233","244.3.210.197","80","235","241977","73","22869","162","219108","227.910517000","6.2882","29094.34","278753.03"
"68.157.168.39","53544","41.177.26.176","80","35","12137","18","1611","17","10526","167.143861000","6.2806","2052.02","13407.58"
"68.157.168.253","50489","41.177.26.176","80","45","13153","22","1891","23","11262","125.775378000","6.2752","2410.76","14357.45"
"68.157.168.51","33509","41.177.26.176","80","40","13346","19","1705","21","11641","47.183086000","6.2729","2174.44","14846.13"
"68.157.168.209","47978","41.177.26.176","80","35","12688","18","1567","17","11121","132.577434000","6.2699","1999.38","14189.63"
"68.157.168.43","59074","41.177.26.176","80","34","12668","17","1566","17","11102","55.162926000","6.2550","2002.89","14199.26"
"68.157.168.139","38487","41.177.26.176","80","34","12655","17","1566","17","11089","35.156210000","6.2324","2010.13","14233.95"
"68.157.168.164","58430","41.177.26.176","80","31","12317","16","1425","15","10892","151.102240000","6.2293","1830.07","13988.18"
"244.3.31.156","54005","244.3.41.84","1521","195","59764","94","29081","101","30683","200.400944000","6.2276","37357.61","39415.54"
"68.157.168.253","44130","41.177.26.176","80","43","13164","21","1825","22","11339","73.883728000","6.2263","2344.89","14569.17"
"68.157.15.122","34282","41.177.26.46","80","11","1262","6","734","5","528","27.659260000","6.2215","943.82","678.93"
"68.157.168.194","64110","41.177.26.91","80","102","76569","49","4102","53","72467","78.584575000","6.2201","5275.83","93204.11"
"68.157.168.194","48418","41.177.26.91","80","57","38396","29","2355","28","36041","37.668184000","6.1898","3043.70","46580.89"
"68.157.168.110","52361","41.177.26.176","80","33","12855","17","1548","16","11307","163.154629000","6.1895","2000.82","14614.53"
"68.157.168.51","61775","41.177.26.176","80","42","13061","21","1845","21","11216","40.505151000","6.1886","2385.02","14498.84"
"85.41.34.188","15566","244.3.210.197","80","257","228761","108","14680","149","214081","33.741106000","6.1842","18990.21","276937.60"
"68.157.168.253","61959","41.177.26.176","80","35","15237","18","1671","17","13566","20.510751000","6.1684","2167.17","17594.13"
"68.157.168.160","42042","41.177.26.176","80","34","12673","17","1566","17","11107","39.171643000","6.1626","2032.92","14418.69"
"68.157.168.224","64279","41.177.26.15","80","36","21462","18","1548","18","19914","1.011149000","6.1478","2014.38","25913.67"
"244.3.160.239","62726","198.123.241.156","80","75","66801","28","2558","47","64243","222.769931000","6.1308","3337.89","83829.46"
"18.239.218.37","61464","244.3.210.197","80","115","85959","53","30389","62","55570","190.720890000","6.1040","39828.01","72830.38"
"244.3.77.218","10435","244.3.160.239","80","128","69895","62","4762","66","65133","222.765361000","6.0798","6266.03","85704.59"
"68.157.168.121","35424","41.177.26.176","80","35","12617","18","1635","17","10982","24.520946000","6.0709","2154.55","14471.72"
"68.157.168.192","33598","41.177.26.176","80","68","38348","32","2628","36","35720","136.565047000","6.0640","3467.03","47124.12"
"68.157.168.13","45817","41.177.26.176","80","44","12776","21","1846","23","10930","52.473505000","6.0622","2436.07","14423.74"
"82.193.18.57","55583","244.3.210.197","80","429","409513","158","18028","271","391485","164.483910000","6.0546","23820.55","517272.48"
"242.77.209.197","1164","244.3.210.197","80","115","87815","49","12048","66","75767","0.202899000","6.0453","15943.67","100265.94"
"15.128.184.13","6020","41.177.26.46","80","17","7550","9","1235","8","6315","76.045306000","6.0227","1640.47","8388.31"
"77.197.128.180","62116","41.177.26.176","80","32","12079","12","1111","20","10968","58.702829000","6.0222","1475.88","14570.15"
"244.3.160.239","61466","197.154.128.197","80","666","651996","235","15652","431","636344","34.042133000","6.0209","20796.96","845516.41"
"68.157.168.224","47652","41.177.26.15","80","320","319780","97","7121","223","312659","17.416968000","6.0096","9479.54","416214.53"
"68.157.168.224","47283","41.177.26.15","80","296","293204","92","6770","204","286434","8.540930000","5.9964","9032.12","382142.56"
"145.219.142.106","51674","41.177.26.176","80","272","271532","79","7391","193","264141","228.193985000","5.9908","9869.73","352726.32"
"68.157.168.51","35537","41.177.26.176","80","34","12548","17","1565","17","10983","153.776593000","5.9839","2092.29","14683.49"
"68.157.168.82","40531","244.3.210.197","80","35","21374","18","1584","17","19790","40.320514000","5.9606","2125.97","26561.26"
"244.3.177.130","2418","41.177.98.176","80","72","55847","26","5092","46","50755","217.784260000","5.9599","6835.05","68128.99"
"68.157.168.209","47079","41.177.26.176","80","36","12827","18","1617","18","11210","224.432535000","5.9553","2172.17","15058.77"
"68.157.168.197","42667","41.177.26.176","80","35","12614","18","1635","17","10979","97.794900000","5.9551","2196.44","14749.04"
"244.3.210.230","3385","253.23.23.108","1433","2","132","2","132","0","0","1.277014000","5.9346","177.94","N/A"
"68.157.168.82","52910","244.3.210.197","80","23","11692","12","1190","11","10502","2.304785000","5.9196","1608.21","14192.80"
"68.157.168.41","49638","41.177.26.176","80","33","12616","17","1565","16","11051","152.484268000","5.9187","2115.31","14936.95"
"68.157.168.98","63125","41.177.26.176","80","43","13251","21","1846","22","11405","96.512332000","5.8747","2513.83","15531.00"
"68.157.168.253","39198","41.177.26.176","80","35","12812","18","1615","17","11197","228.500737000","5.8667","2202.26","15268.53"
"68.157.168.194","40410","41.177.26.91","80","55","37248","28","2315","27","34933","68.726506000","5.8588","3161.05","47699.78"
"68.157.168.194","64622","41.177.26.91","80","45","27457","23","2238","22","25219","58.419249000","5.8474","3061.89","34502.99"
"68.157.168.51","50551","41.177.26.176","80","34","12478","17","1565","17","10913","112.453290000","5.8313","2147.03","14971.58"
"68.157.168.41","50369","41.177.26.176","80","31","13531","16","1493","15","12038","33.837940000","5.8292","2048.98","16520.84"
"68.157.168.254","40691","244.3.210.197","443","29","17344","13","1573","16","15771","7.454968000","5.8264","2159.83","21654.62"
"68.157.168.98","37431","41.177.26.176","80","33","12321","17","1544","16","10777","212.490303000","5.8157","2123.91","14824.75"
"68.157.168.23","42970","41.177.26.176","80","34","12363","17","1541","17","10822","183.086540000","5.8125","2120.95","14894.85"
"68.157.168.82","52978","244.3.210.197","80","38","21389","20","1948","18","19441","204.779754000","5.8116","2681.52","26761.49"
"68.157.168.139","65187","41.177.26.176","80","45","17003","23","1999","22","15004","204.418691000","5.8088","2753.08","20663.97"
"244.3.160.248","48122","41.177.26.55","80","22","12112","10","988","12","11124","88.435594000","5.7964","1363.60","15352.90"
"68.157.168.164","52617","41.177.26.176","80","36","12907","18","1636","18","11271","164.465716000","5.7832","2263.13","15591.50"
"77.197.210.80","30056","41.177.26.176","80","26","17718","10","971","16","16747","43.951721000","5.7815","1343.61","23173.41"
"68.157.168.139","34601","41.177.26.176","80","35","13407","18","1638","17","11769","115.145626000","5.7696","2271.20","16318.53"
"77.194.20.202","37278","244.3.210.197","80","62","44760","29","11843","33","32917","177.115944000","5.7694","16421.87","45643.73"
"68.157.168.41","41869","41.177.26.176","80","31","14090","16","1493","15","12597","43.152224000","5.7687","2070.47","17469.33"
"68.157.168.23","40835","41.177.26.176","80","35","12622","18","1635","17","10987","80.491553000","5.7668","2268.14","15241.60"
"68.157.168.110","37441","41.177.26.176","80","34","12674","17","1565","17","11109","176.429009000","5.7466","2178.70","15465.27"
"68.157.168.253","35417","41.177.26.176","80","43","13109","21","1824","22","11285","191.081347000","5.7230","2549.73","15775.04"
"68.157.168.192","50872","41.177.26.176","80","41","17451","21","1800","20","15651","196.774263000","5.7094","2522.14","21930.04"
"68.157.168.194","41715","41.177.26.91","80","1781","1852590","580","41288","1201","1811302","85.330642000","5.7067","57879.87","2539186.46"
"77.197.210.123","55739","41.177.26.176","80","20","13207","8","862","12","12345","59.276854000","5.6987","1210.10","17330.24"
"68.157.168.43","50924","41.177.26.176","80","33","12107","17","1559","16","10548","119.123268000","5.6930","2190.77","14822.46"
"68.157.168.209","54831","41.177.26.176","80","43","13263","21","1845","22","11418","211.090113000","5.6880","2594.94","16059.06"
"68.157.168.39","56097","41.177.26.176","80","23","8759","12","1217","11","7542","53.896731000","5.6810","1713.78","10620.67"
"68.157.168.38","56559","41.177.26.91","80","29","16231","15","1322","14","14909","13.527197000","5.6725","1864.44","21026.46"
"145.202.231.208","4433","244.3.210.197","80","103","42571","34","3670","69","38901","186.230081000","5.6594","5187.81","54989.32"
"100.176.176.204","52817","41.177.26.91","80","1245","1435127","310","22022","935","1413105","37.742295000","5.6511","31175.32","2000454.07"
"77.197.210.181","57204","41.177.26.176","80","19","13206","7","761","12","12445","59.176705000","5.6271","1081.91","17693.04"
"68.157.15.122","64368","41.177.26.46","80","11","1212","6","684","5","528","147.055005000","5.6238","973.01","751.09"
"68.157.168.156","50075","41.177.26.176","80","43","13179","21","1845","22","11334","128.460231000","5.6225","2625.14","16126.50"
"15.128.184.13","32669","41.177.26.46","80","16","8828","7","1093","9","7735","198.194309000","5.6224","1555.22","11006.04"
"68.157.168.82","47563","244.3.210.197","80","33","19031","17","2018","16","17013","73.193460000","5.6184","2873.43","24224.82"
"100.176.176.67","34006","41.177.26.91","80","893","1161782","130","9686","763","1152096","160.707388000","5.6144","13801.67","1641631.85"
"68.157.168.82","56237","244.3.210.197","80","90","76577","38","2924","52","73653","47.367234000","5.6057","4172.88","105111.26"
"253.37.253.139","63312","41.177.230.224","25","39","19464","22","17819","17","1645","61.951976000","5.5401","25730.76","2375.39"
"68.157.15.122","41207","41.177.26.46","80","11","1262","6","734","5","528","102.357788000","5.5300","1061.84","763.83"
"244.3.22.180","1186","244.3.41.84","23","13","3613","7","530","6","3083","62.637872000","5.5068","769.96","4478.82"
"68.157.168.224","60425","41.177.26.15","80","271","263794","87","6421","184","257373","97.330590000","5.4759","9380.71","376006.95"
"68.157.168.82","46488","244.3.210.197","80","35","21204","18","1593","17","19611","158.108552000","5.4756","2327.41","28652.17"
"68.157.168.43","55702","41.177.26.176","80","31","13436","16","1492","15","11944","36.497610000","5.4738","2180.57","17456.29"
"68.157.168.38","51987","41.177.26.91","80","27","14377","14","1252","13","13125","36.301337000","5.4609","1834.14","19227.70"
"68.157.168.38","58139","41.177.26.91","80","58","39633","29","2377","29","37256","180.350042000","5.4609","3482.24","54578.97"
"68.157.168.23","37214","41.177.26.176","80","35","12558","18","1628","17","10930","159.179005000","5.4481","2390.56","16049.61"
"186.136.103.68","8996","244.3.160.239","80","16","7819","7","1412","9","6407","39.359650000","5.4275","2081.25","9443.75"
"244.3.160.248","49097","41.177.26.55","80","24","12679","11","1051","13","11628","155.560867000","5.4274","1549.17","17139.58"
"68.157.168.98","47623","41.177.26.176","80","31","14082","16","1492","15","12590","51.134430000","5.4264","2199.62","18561.10"
"244.3.160.239","62167","85.224.40.142","80","520","528701","176","11688","344","517013","118.556207000","5.4240","17238.97","762557.45"
"252.66.75.111","49234","244.3.210.197","80","344","399752","80","21983","264","377769","228.599015000","5.4156","32473.60","558045.75"
"68.157.168.254","44301","244.3.210.197","443","32","20990","14","1562","18","19428","106.114278000","5.4052","2311.87","28754.78"
"68.157.168.51","55429","41.177.26.176","80","33","14252","17","1563","16","12689","85.799871000","5.3958","2317.37","18813.23"
"68.157.168.41","40027","41.177.26.176","80","31","13633","16","1493","15","12140","109.854913000","5.3935","2214.54","18007.02"
"151.77.192.83","8290","244.3.160.239","80","522","528826","176","11757","346","517069","118.552304000","5.3758","17496.30","769481.55"
"68.157.168.38","60452","41.177.26.91","80","53","34536","27","2226","26","32310","112.120726000","5.3664","3318.43","48166.38"
"68.157.168.224","63493","41.177.26.15","80","151","141605","51","3899","100","137706","44.031712000","5.3535","5826.46","205780.70"
"41.177.4.139","57585","244.3.41.84","1522","193","66052","95","29181","98","36871","76.702810000","5.3460","43667.76","55175.43"
"68.157.168.38","52680","41.177.26.91","80","29","15711","15","1322","14","14389","104.553557000","5.3303","1984.13","21595.82"
"68.157.168.38","43170","41.177.26.91","80","57","39306","28","2299","29","37007","157.590992000","5.3165","3459.39","55685.86"
"68.157.168.203","51787","41.177.26.176","80","44","14570","22","1955","22","12615","220.418355000","5.3163","2941.90","18983.15"
"68.157.168.254","50909","244.3.210.197","443","40","28273","17","1746","23","26527","171.829158000","5.3161","2627.51","39919.82"
"168.223.67.89","2660","244.3.210.197","80","27","11714","17","7665","10","4049","13.258971000","5.2990","11572.06","6112.88"
"68.157.168.194","58148","41.177.26.91","80","33","18832","17","1517","16","17315","23.990060000","5.2928","2292.91","26171.24"
"41.177.3.224","52720","41.177.117.184","1606","648","283808","332","157765","316","126043","185.074737000","5.2795","239062.46","190993.88"
"68.157.168.38","50220","41.177.26.91","80","27","14702","14","1252","13","13450","51.605230000","5.2777","1897.80","20387.68"
"68.157.168.38","40632","41.177.26.91","80","27","14315","14","1252","13","13063","66.868357000","5.2688","1900.99","19834.34"
"68.157.168.160","49009","41.177.26.176","80","31","14325","16","1493","15","12832","87.124866000","5.2657","2268.27","19495.26"
"85.186.156.144","57449","244.3.210.197","80","165","143846","68","12277","97","131569","179.384691000","5.2633","18660.57","199979.86"
"244.3.160.248","47680","41.177.26.55","80","11","2244","6","793","5","1451","49.860474000","5.2588","1206.35","2207.34"
"244.3.77.218","13305","244.3.160.239","80","38","17967","18","1902","20","16065","3.012422000","5.2511","2897.65","24474.64"
"18.132.77.186","5954","244.3.160.239","80","155","113740","53","4141","102","109599","65.296035000","5.2450","6316.16","167168.45"
"244.3.160.248","49813","41.177.26.55","80","56","44818","22","3670","34","41148","208.611471000","5.2279","5615.99","62966.38"
"244.3.160.248","49814","41.177.26.55","80","24","12105","12","4141","12","7964","208.613060000","5.2263","6338.65","12190.54"
"244.3.160.248","49815","41.177.26.55","80","51","41641","20","3538","31","38103","208.614414000","5.2250","5416.98","58338.96"
"244.3.160.248","49816","41.177.26.55","80","16","5772","8","2761","8","3011","208.615393000","5.2244","4227.82","4610.63"
"244.3.160.239","61273","128.71.90.164","80","337","323808","125","9077","212","314731","2.294011000","5.2216","13906.72","482194.03"
"77.194.20.202","37300","244.3.210.197","80","84","60207","41","15887","43","44320","177.745871000","5.1855","24509.94","68375.45"
"68.157.168.224","60594","41.177.26.15","80","214","209933","68","5091","146","204842","212.810129000","5.1827","7858.44","316192.94"
"77.197.128.55","1082","41.177.26.176","80","22","12954","9","931","13","12023","115.417716000","5.1783","1438.31","18574.45"
"68.157.168.51","52190","41.177.26.176","80","43","25829","22","2205","21","23624","176.595175000","5.1503","3425.07","36695.64"
"165.33.138.84","1390","244.3.210.197","443","24","16812","12","3562","12","13250","147.955696000","5.1500","5533.24","20582.64"
"41.177.223.45","9351","244.3.160.239","80","464","331423","153","10353","311","321070","2.291603000","5.1477","16089.41","498968.96"
"68.157.168.156","39370","41.177.26.176","80","33","13966","17","1563","16","12403","121.786085000","5.1308","2437.07","19339.06"
"68.157.168.254","38475","244.3.210.197","443","41","29315","17","1758","24","27557","180.247740000","5.1287","2742.20","42984.59"
"68.157.168.224","59798","41.177.26.15","80","263","261607","81","6001","182","255606","195.048478000","5.1259","9365.76","398924.37"
"68.157.168.224","51159","41.177.26.15","80","41","24395","21","1800","20","22595","106.437712000","5.1258","2809.30","35264.46"
"68.157.168.254","39416","244.3.210.197","443","25","13449","12","1448","13","12001","139.130965000","5.1207","2262.18","18748.94"
"68.157.168.82","59741","244.3.210.197","80","23","11412","12","1211","11","10201","178.134734000","5.1101","1895.86","15970.02"
"68.157.168.38","39444","41.177.26.91","80","29","15655","15","1322","14","14333","89.377133000","5.0904","2077.63","22525.47"
"244.3.160.239","61735","177.124.75.164","80","126","111582","46","4894","80","106688","65.362484000","5.0792","7708.32","168039.59"
"68.224.16.165","1782","41.177.26.15","80","259","195520","103","7174","156","188346","29.477673000","5.0774","11303.40","296759.06"
"68.157.168.39","39032","41.177.26.176","80","31","13984","16","1492","15","12492","160.495261000","5.0743","2352.22","19694.35"
"68.157.168.224","54538","41.177.26.15","80","49","30778","25","2080","24","28698","79.562262000","5.0641","3285.86","45335.43"
"77.197.128.127","47832","41.177.26.176","80","25","12771","10","948","15","11823","27.633186000","5.0598","1498.89","18693.40"
"244.3.160.248","49805","41.177.26.55","80","20","13585","9","1887","11","11698","208.452258000","5.0571","2985.11","18505.49"
"85.186.156.144","57459","244.3.210.197","80","152","138465","60","9136","92","129329","180.002843000","5.0368","14510.77","205414.18"
"244.3.160.248","49958","41.177.26.55","80","9","2135","5","1457","4","678","218.603020000","5.0265","2318.89","1079.07"
"244.3.160.239","61958","81.67.210.26","80","66","69097","18","2307","48","66790","102.636402000","5.0211","3675.68","106414.74"
"68.157.168.38","64617","41.177.26.91","80","27","14405","14","1252","13","13153","74.160554000","5.0203","1995.10","20959.68"
"18.132.77.186","12273","244.3.160.239","80","115","103619","40","3331","75","100288","106.476374000","5.0159","5312.68","159951.45"
"244.3.160.248","49812","41.177.26.55","80","155","150934","54","4582","101","146352","208.610123000","5.0095","7317.36","233721.23"
"18.22.43.17","53555","41.177.26.15","80","58","49046","22","1890","36","47156","228.229173000","5.0042","3021.44","75385.70"
"41.177.135.193","12257","244.3.160.239","80","110","73616","39","3687","71","69929","102.632794000","4.9882","5913.13","112150.56"
"244.3.160.248","49005","41.177.26.193","80","27","16976","13","2165","14","14811","141.718340000","4.9859","3473.80","23764.65"
"68.157.168.224","60064","41.177.26.15","80","150","139772","52","3969","98","135803","150.652435000","4.9678","6391.62","218695.30"
"254.214.213.72","3447","41.177.98.127","210","330","278537","134","9303","196","269234","187.865325000","4.9595","15006.24","434289.01"
"68.157.168.38","52064","41.177.26.91","80","33","20207","15","1576","18","18631","134.849018000","4.9352","2554.73","30201.26"
"68.157.168.46","41360","41.177.98.79","80","16","6240","9","911","7","5329","111.330413000","4.9308","1478.07","8646.12"
"244.3.160.239","62010","177.124.75.164","80","120","105149","44","4700","76","100449","106.542903000","4.9185","7644.56","163380.56"
"68.157.168.194","37264","41.177.26.91","80","33","19979","17","1547","16","18432","99.987986000","4.9159","2517.52","29995.47"
"244.3.218.224","1926","244.3.41.84","23","6","596","4","260","2","336","68.551911000","4.9011","424.39","548.45"
"68.157.168.38","56844","41.177.26.91","80","27","14282","14","1252","13","13030","81.738120000","4.8950","2046.18","21295.28"
"244.3.160.239","62536","40.248.176.156","80","213","200317","74","6375","139","193942","196.406634000","4.8827","10445.10","317763.72"
"244.3.160.239","62448","40.248.176.156","80","209","198592","72","5785","137","192807","170.710644000","4.8800","9483.51","316073.88"
"41.177.192.117","5015","244.3.160.239","80","970","706289","332","22751","638","683538","173.190571000","4.8692","37379.58","1123043.67"
"77.197.217.218","61746","41.177.26.176","80","430","454972","120","8041","310","446931","87.366246000","4.8678","13215.10","734515.48"
"68.157.168.224","48369","41.177.26.15","80","49","30237","25","2079","24","28158","132.867819000","4.8611","3421.44","46340.03"
"41.177.199.139","13349","244.3.160.239","80","296","204698","101","7908","195","196790","196.404008000","4.8593","13019.17","323981.02"
"165.33.138.84","1387","244.3.210.197","443","25","19733","11","2733","14","17000","147.955692000","4.8510","4507.07","28035.18"
"165.33.138.84","1388","244.3.210.197","443","28","21902","12","2748","16","19154","147.955700000","4.8471","4535.50","31613.13"
"41.177.199.139","3646","244.3.160.239","80","284","202491","96","7120","188","195371","170.708147000","4.8451","11756.25","322588.55"
"68.157.168.38","51131","41.177.26.91","80","25","13374","13","1172","12","12202","119.890566000","4.8321","1940.36","20201.65"
"18.22.43.17","53556","41.177.26.15","80","41","32920","16","1507","25","31413","228.230648000","4.8305","2495.79","52024.14"
"18.22.43.17","53563","41.177.26.15","80","40","31822","16","1509","24","30313","228.264680000","4.8273","2500.80","50236.42"
"41.177.176.156","5988","244.3.160.239","80","10","2102","5","1508","5","594","124.182113000","4.8244","2500.60","984.98"
"68.157.168.38","58906","41.177.26.91","80","29","15971","15","1322","14","14649","172.787638000","4.8111","2198.23","24358.43"
"18.132.77.186","16150","244.3.160.239","80","49","39347","18","1923","31","37424","101.335726000","4.8093","3198.78","62252.37"
"68.157.168.224","54585","41.177.26.15","80","156","146267","53","4040","103","142227","221.690258000","4.8079","6722.22","236653.93"
"40.193.210.13","62906","244.3.210.197","80","159","135892","64","7797","95","128095","33.486120000","4.8066","12977.12","213197.85"
"68.157.168.192","40520","41.177.26.176","80","11","1262","6","718","5","544","100.375844000","4.7793","1201.84","910.59"
"15.71.149.111","34410","41.177.26.46","80","597","625741","166","12645","431","613096","112.885721000","4.7789","21168.03","1026337.20"
"244.3.160.239","61462","177.124.75.164","80","152","140042","54","5798","98","134244","33.407564000","4.7680","9728.18","225241.47"
"68.157.168.194","40268","41.177.26.91","80","19","7987","10","976","9","7011","127.410256000","4.7599","1640.36","11783.35"
"41.177.176.156","12704","244.3.160.239","80","10","2637","5","1520","5","1117","191.128583000","4.7434","2563.54","1883.86"
"41.177.98.252","14229","244.3.160.239","80","151","138517","52","4312","99","134205","33.404438000","4.7406","7276.68","226476.51"
"41.177.176.156","13591","244.3.160.239","80","150","102155","53","4643","97","97512","157.366347000","4.7384","7838.96","164633.45"
"254.214.213.72","3405","41.177.98.127","210","87","62092","34","2486","53","59606","145.337418000","4.7361","4199.26","100684.32"
"18.132.77.186","4029","244.3.160.239","80","46","35532","17","1831","29","33701","106.476458000","4.7240","3100.74","57071.59"
"68.157.168.38","44485","41.177.26.91","80","29","15539","15","1322","14","14217","195.489701000","4.7203","2240.56","24095.31"
"68.157.168.110","60855","41.177.26.176","80","31","13726","16","1493","15","12233","219.126547000","4.7158","2532.76","20752.32"
"18.132.77.186","14584","244.3.160.239","80","35","27238","13","1599","22","25639","101.333812000","4.7102","2715.81","43546.38"
"94.224.184.106","4412","41.177.26.13","80","33","15906","15","3251","18","12655","186.759427000","4.6971","5537.08","21553.89"
"244.3.160.239","61943","177.124.75.164","80","52","40749","21","3228","31","37521","101.420408000","4.6928","5502.94","63963.97"
"77.197.210.110","10531","41.177.26.15","80","74","72025","23","1775","51","70250","49.443956000","4.6905","3027.42","119817.60"
"85.186.156.144","57461","244.3.210.197","80","110","91134","48","9198","62","81936","180.003966000","4.6459","15838.44","141089.20"
"85.186.156.144","57463","244.3.210.197","80","104","84890","47","8600","57","76290","180.006113000","4.6273","14868.22","131894.92"
"244.3.160.239","62011","177.124.75.164","80","47","36784","19","3044","28","33740","106.545944000","4.6217","5269.06","58402.80"
"68.157.168.39","46889","41.177.26.176","80","33","14004","17","1562","16","12442","187.094327000","4.6179","2706.02","21554.58"
"18.132.77.186","12135","244.3.160.239","80","15","7011","7","1178","8","5833","214.582625000","4.6165","2041.36","10108.02"
"18.132.77.186","9192","244.3.160.239","80","11","2553","5","1173","6","1380","49.493209000","4.5947","2042.35","2402.76"
"85.186.156.144","57465","244.3.210.197","80","187","172996","74","9530","113","163466","180.009359000","4.5879","16617.66","285039.15"
"18.132.77.186","10911","244.3.160.239","80","12","4211","5","1172","7","3039","49.415185000","4.5872","2043.94","5299.93"
"85.186.156.144","57457","244.3.210.197","80","159","143575","64","10201","95","133374","180.001879000","4.5859","17795.39","232667.61"
"194.168.61.239","58437","41.177.98.127","210","15","1169","8","632","7","537","138.547187000","4.5752","1105.10","938.98"
"68.157.168.38","47183","41.177.26.91","80","25","13140","13","1169","12","11971","225.822612000","4.5561","2052.65","21019.89"
"244.3.160.248","47830","41.177.26.193","80","107","91262","45","6872","62","84390","68.295371000","4.5553","12068.57","148205.29"
"68.157.168.224","40987","41.177.26.15","80","188","175742","65","4879","123","170863","186.160347000","4.5336","8609.41","301502.21"
"244.3.160.248","49777","41.177.26.55","80","11","1614","6","842","5","772","207.344083000","4.5179","1490.96","1367.01"
"77.197.210.108","39372","41.177.26.15","80","18","9617","8","875","10","8742","18.148846000","4.5114","1551.62","15502.06"
"18.132.77.186","4346","244.3.160.239","80","11","1990","5","1173","6","817","50.148812000","4.4886","2090.64","1456.14"
"244.3.160.239","61938","177.124.75.164","80","38","28642","16","2900","22","25742","101.400345000","4.4878","5169.52","45887.49"
"244.3.160.239","61368","177.124.75.164","80","17","9159","9","3138","8","6021","17.280473000","4.4755","5609.22","10762.62"
"18.22.43.17","53561","41.177.26.15","80","51","43006","18","1611","33","41395","228.261470000","4.4711","2882.53","74067.12"
"77.197.210.122","47605","41.177.26.176","80","19","13026","7","796","12","12230","66.132498000","4.4634","1426.70","21920.30"
"18.132.77.186","4208","244.3.160.239","80","10","1867","5","1173","5","694","51.538809000","4.4592","2104.43","1245.07"
"244.3.160.239","62679","177.124.75.164","80","17","8314","9","2378","8","5936","214.648848000","4.4543","4270.95","10661.22"
"244.3.56.90","6681","244.3.160.239","80","15","7404","7","1490","8","5914","17.278199000","4.4485","2679.53","10635.39"
"244.3.160.239","62450","41.177.254.197","80","764","692089","259","18195","505","673894","173.221876000","4.4437","32756.74","1213221.97"
"244.3.160.239","62151","85.224.40.142","80","354","356745","121","8243","233","348502","115.887430000","4.4427","14843.20","627548.64"
"68.157.168.194","44044","41.177.26.91","80","43","25107","22","2135","21","22972","187.900878000","4.4250","3859.93","41531.75"
"244.3.160.239","61598","177.124.75.164","80","14","3635","8","2894","6","741","51.610169000","4.4249","5232.25","1339.70"
"244.3.160.239","61499","197.154.128.197","80","76","66037","29","2668","47","63369","40.409058000","4.4184","4830.75","114737.49"
"68.157.168.38","41397","41.177.26.91","80","25","12874","13","1172","12","11702","218.228824000","4.4173","2122.58","21193.16"
"244.3.160.239","61574","177.124.75.164","80","14","4257","8","2894","6","1363","49.688898000","4.4075","5252.83","2473.95"
"244.3.160.239","61580","177.124.75.164","80","14","3694","8","2894","6","800","50.251883000","4.3925","5270.77","1457.02"
"151.77.192.83","9722","244.3.160.239","80","356","356870","121","8312","235","348558","115.879379000","4.3923","15139.35","634858.16"
"244.3.160.239","61570","177.124.75.164","80","16","5978","9","2956","7","3022","49.609271000","4.3749","5405.43","5526.12"
"254.204.205.197","41031","41.177.98.176","80","4","280","2","140","2","140","10.713671000","4.3670","256.47","256.47"
"254.204.205.197","49136","41.177.98.176","80","4","280","2","140","2","140","10.723682000","4.3573","257.04","257.04"
"254.204.205.197","38291","41.177.98.176","80","4","280","2","140","2","140","10.723700000","4.3573","257.04","257.04"
"254.204.205.197","37114","41.177.98.176","80","4","280","2","140","2","140","10.723769000","4.3573","257.04","257.04"
"151.77.217.75","10198","244.3.160.239","80","151","93684","62","5282","89","88402","99.401080000","4.3543","9704.38","162417.02"
"77.197.210.181","49095","41.177.26.15","80","18","13951","7","805","11","13146","198.104659000","4.3116","1493.63","24391.70"
"244.3.160.248","49760","41.177.26.55","80","22","12097","10","977","12","11120","204.781442000","4.2956","1819.54","20709.65"
"244.3.185.176","2345","41.177.98.176","80","53","47012","15","3905","38","43107","221.563963000","4.2920","7278.64","80348.41"
"168.223.67.89","2659","244.3.210.197","80","42","22535","24","7154","18","15381","9.280180000","4.2305","13528.31","29085.67"
"253.37.253.43","54774","253.160.108.241","23432","10","1780","10","1780","0","0","159.618736000","4.2199","3374.53","N/A"
"168.223.67.89","2661","244.3.210.197","80","56","33495","30","6851","26","26644","13.300354000","4.1857","13094.06","50923.69"
"68.157.168.135","44704","244.3.210.197","80","12","3125","7","755","5","2370","228.048994000","4.1775","1445.85","4538.63"
"41.177.176.106","11181","244.3.160.239","80","979","688116","328","21904","651","666212","67.414720000","4.1766","41955.58","1276082.41"
"68.157.168.121","57045","41.177.26.176","80","65","25850","33","2958","32","22892","229.790666000","4.1727","5671.18","43889.37"
"41.177.176.156","12517","244.3.160.239","80","18","7872","8","1727","10","6145","191.670768000","4.1690","3313.95","11791.67"
"15.128.184.13","19778","41.177.26.46","80","15","8832","6","1025","9","7807","181.849838000","4.1675","1967.62","14986.53"
"94.224.184.106","4413","41.177.26.13","80","14","2991","7","1024","7","1967","186.760161000","4.1261","1985.43","3813.82"
"77.197.210.82","18250","41.177.26.15","80","455","414280","171","11614","284","402666","76.378532000","4.1026","22647.30","785198.72"
"168.223.67.89","2657","244.3.210.197","80","45","23089","26","7258","19","15831","9.277658000","4.0922","14188.94","30948.62"
"168.223.67.89","2658","244.3.210.197","80","74","50003","37","7943","37","42060","9.279034000","4.0889","15540.56","82290.82"
"244.3.160.239","61507","85.224.40.142","80","132","126345","48","3511","84","122834","42.972092000","4.0661","6907.87","241675.04"
"186.136.103.68","23841","244.3.160.239","20480","257","25186","257","25186","0","0","106.815017000","4.0475","49780.96","N/A"
"18.22.43.17","53562","41.177.26.15","80","65","57305","22","1866","43","55439","228.263175000","4.0394","3695.57","109795.55"
"77.197.210.82","10809","244.3.210.197","80","27","22052","11","1023","16","21029","44.806082000","4.0319","2029.81","41725.10"
"41.177.176.106","9572","244.3.160.239","80","258","179829","88","6514","170","173315","63.465051000","4.0312","12927.32","343951.14"
"253.37.253.43","54767","253.160.108.241","23432","12","4902","12","4902","0","0","137.199380000","4.0274","9737.31","N/A"
"253.37.253.43","54766","253.160.108.241","23432","17","11143","17","11143","0","0","133.163069000","4.0061","22252.09","N/A"
"165.33.138.84","1389","244.3.210.197","443","17","10357","8","2543","9","7814","147.955688000","3.9221","5187.02","15938.41"
"41.177.98.220","7030","244.3.185.254","1151","27","4821","14","2929","13","1892","195.247342000","3.8701","6054.70","3911.06"
"244.3.160.248","48203","41.177.26.193","80","125","118054","44","4650","81","113404","103.011832000","3.8553","9649.17","235323.60"
"253.37.253.43","54775","253.160.108.241","23432","10","2381","10","2381","0","0","163.861455000","3.8494","4948.27","N/A"
"244.3.160.239","61726","188.68.214.181","80","178","175076","62","4740","116","170336","63.471300000","3.8466","9858.07","354258.43"
"41.177.176.156","12683","244.3.160.239","80","157","106202","57","8639","100","97563","187.705421000","3.8394","18000.83","203289.13"
"244.3.160.239","61743","188.68.214.181","80","659","668932","225","15244","434","653688","67.424052000","3.7999","32093.86","1376238.14"
"15.186.110.142","45970","41.177.26.176","80","31","18343","15","1513","16","16830","132.830506000","3.7887","3194.80","35537.66"
"77.197.128.13","62768","41.177.26.176","80","20","12604","8","866","12","11738","212.820330000","3.7699","1837.72","24908.97"
"253.37.253.43","54779","253.160.108.241","23432","29","29310","29","29310","0","0","178.781780000","3.7686","62218.70","N/A"
"253.37.253.43","54769","253.160.108.241","23432","10","2527","10","2527","0","0","141.249952000","3.7532","5386.29","N/A"
"253.37.253.43","54776","253.160.108.241","23432","10","1373","10","1373","0","0","167.732760000","3.7382","2938.29","N/A"
"41.151.113.41","65375","244.3.210.197","80","884","765323","321","26936","563","738387","105.766941000","3.7295","57778.71","1583867.18"
"244.3.160.248","47823","41.177.26.193","80","124","117805","44","4650","80","113155","68.072444000","3.7281","9978.14","242812.25"
"244.3.160.239","61329","128.71.90.164","80","24","14630","11","1563","13","13067","7.647472000","3.7242","3357.47","28069.15"
"40.138.160.255","11163","244.3.160.239","80","33","21804","12","2078","21","19726","17.204621000","3.7090","4482.02","42546.88"
"151.77.192.83","11621","244.3.160.239","80","133","126405","47","3516","86","122889","42.967631000","3.7077","7586.44","265156.57"
"241.122.106.43","20951","244.3.210.197","80","949","711748","497","48262","452","663486","129.535610000","3.6865","104732.74","1439822.40"
"16.176.93.164","10724","244.3.160.239","80","13","2421","6","1412","7","1009","82.491416000","3.6773","3071.82","2195.09"
"244.3.160.248","49214","41.177.26.193","80","127","119317","45","4714","82","114603","166.315589000","3.6709","10273.34","249757.21"
"253.37.253.43","54771","253.160.108.241","23432","10","2218","10","2218","0","0","148.637511000","3.6639","4842.99","N/A"
"41.177.223.45","3189","244.3.160.239","80","24","13969","10","1227","14","12742","7.645513000","3.6492","2689.89","27933.61"
"253.37.253.43","54773","253.160.108.241","23432","10","1779","10","1779","0","0","155.948503000","3.6471","3902.24","N/A"
"16.176.93.164","8223","244.3.160.239","80","13","2344","6","1409","7","935","82.029371000","3.6411","3095.73","2054.30"
"16.176.93.164","13215","244.3.160.239","80","14","4006","6","1414","8","2592","79.706469000","3.6363","3110.81","5702.43"
"244.3.160.239","62755","40.248.176.156","80","15","4873","8","2048","7","2825","226.745305000","3.6268","4517.43","6231.32"
"253.37.253.43","54778","253.160.108.241","23432","10","2377","10","2377","0","0","175.134674000","3.6241","5247.11","N/A"
"253.37.253.43","54777","253.160.108.241","23432","10","1375","10","1375","0","0","171.491903000","3.6229","3036.28","N/A"
"16.176.93.164","12818","244.3.160.239","80","13","2354","6","1409","7","945","81.038575000","3.6148","3118.27","2091.39"
"16.176.93.164","14763","244.3.160.239","80","16","5645","7","1471","9","4174","80.395769000","3.6109","3259.02","9247.55"
"244.3.160.239","61885","198.123.241.156","80","34","25930","14","1500","20","24430","93.530796000","3.6078","3326.16","54172.07"
"253.37.253.43","54772","253.160.108.241","23432","10","2370","10","2370","0","0","152.324729000","3.6000","5266.61","N/A"
"253.37.253.43","54770","253.160.108.241","23432","40","44656","40","44656","0","0","145.026342000","3.5871","99593.82","N/A"
"41.177.199.139","5643","244.3.160.239","80","12","4092","6","1725","6","2367","226.742652000","3.5673","3868.48","5308.22"
"95.34.105.67","1519","41.177.26.176","80","107","65280","34","4174","73","61106","138.090672000","3.5661","9363.82","137083.31"
"244.3.160.248","49968","41.177.26.193","80","127","119502","45","4714","82","114788","219.947261000","3.5589","10596.68","258033.84"
"15.186.110.142","38033","41.177.26.176","80","26","14436","13","1362","13","13074","24.874399000","3.5568","3063.46","29406.50"
"15.186.110.132","43043","41.177.26.91","80","16","7598","8","1018","8","6580","34.004105000","3.5506","2293.68","14825.56"
"40.138.160.255","5055","244.3.160.239","80","130","93690","46","4395","84","89295","180.912955000","3.5478","9910.42","201354.09"
"77.197.128.167","62046","41.177.26.176","80","27","13529","11","1053","16","12476","23.097646000","3.5389","2380.39","28203.02"
"244.3.160.239","61290","128.71.90.164","80","24","14637","11","1565","13","13072","4.645571000","3.5262","3550.56","29656.80"
"40.138.160.255","11549","244.3.160.239","80","147","100108","58","5267","89","94841","193.748931000","3.5198","11971.00","215557.46"
"151.77.12.31","57694","41.177.98.176","80","14","6223","8","1447","6","4776","176.439296000","3.5120","3296.11","10879.23"
"48.90.252.46","61276","244.3.210.197","80","59","40985","30","4799","29","36186","177.014816000","3.5073","10946.25","82538.26"
"253.213.108.40","1728","253.37.253.43","23","3","1110","0","0","3","1110","139.833264000","3.4997","N/A","2537.33"
"244.3.160.239","61375","85.224.40.142","80","131","127515","47","3624","84","123891","19.641082000","3.4971","8290.22","283411.58"
"249.18.39.225","1653","41.177.26.176","80","20","8798","7","851","13","7947","220.272988000","3.4791","1956.84","18273.77"
"41.177.223.45","7755","244.3.160.239","80","24","13979","10","1232","14","12747","4.643077000","3.4518","2855.29","29542.51"
"168.223.67.89","2662","244.3.210.197","80","48","34007","24","5627","24","28380","13.401633000","3.4414","13080.83","65973.71"
"41.177.3.224","9809","244.3.176.149","2381","44","37947","15","8536","29","29411","31.982870000","3.4088","20032.57","69022.73"
"168.117.3.145","16013","244.3.160.239","80","695","687875","237","16148","458","671727","149.947190000","3.4058","37930.80","1577851.31"
"68.33.110.176","14206","244.3.160.239","80","335","294516","69","5183","266","289333","41.163711000","3.3661","12318.16","687642.15"
"244.3.160.239","61500","244.3.31.75","80","275","275827","94","6694","181","269133","41.179458000","3.3364","16050.82","645325.11"
"244.3.160.239","61291","128.71.90.164","80","15","5674","8","1372","7","4302","4.661315000","3.3315","3294.65","10330.59"
"18.132.77.186","8064","244.3.160.239","80","411","309990","138","9837","273","300153","46.916679000","3.3256","23663.61","722039.73"
"40.193.23.224","49866","41.177.98.176","80","69","51086","26","3576","43","47510","200.765580000","3.3128","8635.62","114731.02"
"186.136.103.68","14587","244.3.160.239","80","91","68680","29","2952","62","65728","72.239195000","3.3084","7138.19","158935.85"
"244.3.160.239","62313","197.154.128.43","80","563","679564","109","8028","454","671536","150.032146000","3.2713","19632.52","1642245.13"
"244.3.153.77","1440","41.177.24.241","993","23","2746","11","979","12","1767","150.121086000","3.2697","2395.32","4323.32"
"244.3.3.72","1493","244.3.41.84","23","10","4028","4","264","6","3764","10.020280000","3.2683","646.20","9213.24"
"77.197.128.55","25329","41.177.26.176","80","22","13090","9","904","13","12186","179.478775000","3.2664","2214.05","29845.66"
"77.197.128.46","28087","41.177.26.176","80","21","12702","9","895","12","11807","146.669836000","3.2658","2192.40","28922.47"
"41.177.223.45","6803","244.3.160.239","80","15","5023","7","1046","8","3977","4.659347000","3.2555","2570.38","9772.85"
"244.3.41.84","2644","244.3.31.67","1592","18","7855","10","3858","8","3997","30.737148000","3.2147","9601.00","9946.92"
"244.3.160.239","61566","177.124.75.164","80","318","299494","110","8935","208","290559","46.985759000","3.1921","22392.94","728200.25"
"244.3.160.239","62509","128.71.90.164","80","117","102765","48","6713","69","96052","187.951347000","3.1910","16829.69","240805.16"
"151.77.192.83","3150","244.3.160.239","80","202","137023","70","5190","132","131833","19.637188000","3.1737","13082.68","332317.68"
"253.160.251.79","2836","253.37.253.43","446","18","13800","0","0","18","13800","206.785184000","3.1581","N/A","34957.81"
"15.186.110.142","52724","41.177.26.176","80","18","9853","9","1097","9","8756","225.383909000","3.1308","2803.12","22373.84"
"244.3.160.239","61501","85.224.40.142","80","112","100849","46","3569","66","97280","41.358805000","3.0995","9211.86","251087.12"
"244.3.160.239","61349","85.224.40.142","80","10","1310","6","876","4","434","13.637286000","3.0867","2270.38","1124.82"
"26.47.18.84","3946","244.3.31.124","445","2","132","2","132","0","0","87.669892000","3.0597","345.13","N/A"
"168.117.3.145","2694","244.3.160.239","80","1347","1346321","451","29844","896","1316477","60.097520000","3.0307","78777.50","3475029.14"
"67.202.142.239","3050","244.3.31.41","445","2","132","2","132","0","0","200.278999000","3.0304","348.47","N/A"
"215.67.202.111","1700","244.3.61.68","445","2","132","2","132","0","0","23.975437000","3.0196","349.71","N/A"
"66.218.67.128","4987","244.3.31.40","445","2","132","2","132","0","0","191.129392000","3.0157","350.17","N/A"
"244.3.40.83","4899","67.91.20.26","4007","2","132","0","0","2","132","188.283837000","3.0119","N/A","350.61"
"244.3.210.255","4899","67.91.20.26","2278","2","132","0","0","2","132","181.553897000","3.0101","N/A","350.82"
"67.122.211.41","30404","244.3.153.255","4899","2","132","2","132","0","0","2.888554000","3.0068","351.20","N/A"
"210.94.68.176","2086","244.3.61.225","445","2","132","2","132","0","0","62.891517000","2.9969","352.36","N/A"
"244.3.210.197","4899","67.91.20.26","2301","2","132","0","0","2","132","181.563536000","2.9953","N/A","352.55"
"193.90.39.90","1850","244.3.61.142","445","2","132","2","132","0","0","128.216757000","2.9905","353.12","N/A"
"67.81.116.154","2178","244.3.31.46","445","2","132","2","132","0","0","40.980235000","2.9880","353.41","N/A"
"244.3.210.230","4899","67.91.20.26","2328","2","132","0","0","2","132","181.579595000","2.9813","N/A","354.21"
"18.197.161.77","1320","244.3.61.177","445","2","132","2","132","0","0","52.607208000","2.9744","355.03","N/A"
"244.145.124.223","4366","244.3.31.124","445","2","132","2","132","0","0","16.186695000","2.9591","356.87","N/A"
"18.185.55.142","2861","244.3.31.168","445","2","132","2","132","0","0","2.725240000","2.9589","356.89","N/A"
"193.211.164.18","3784","244.3.61.225","445","2","132","2","132","0","0","209.109709000","2.9555","357.30","N/A"
"18.40.188.181","2318","244.3.61.106","445","2","132","2","132","0","0","125.371721000","2.9514","357.79","N/A"
"67.122.211.41","31019","244.3.47.242","4899","2","132","2","132","0","0","9.686658000","2.9506","357.89","N/A"
"244.3.210.98","4899","67.91.20.26","2408","2","132","0","0","2","132","181.610355000","2.9494","N/A","358.04"
"71.241.210.40","3389","244.3.31.68","445","2","132","2","132","0","0","72.160420000","2.9399","359.20","N/A"
"30.251.75.92","4112","244.3.61.225","445","2","132","2","132","0","0","202.278822000","2.9396","359.24","N/A"
"72.208.154.177","4131","244.3.61.244","445","2","132","2","132","0","0","59.127371000","2.9362","359.64","N/A"
"16.176.93.164","13758","244.3.160.239","80","175","126245","62","9134","113","117111","13.756295000","2.9295","24943.91","319816.81"
"150.160.203.244","3854","244.3.61.39","445","2","132","2","132","0","0","36.898504000","2.9287","360.57","N/A"
"244.3.160.239","62026","81.67.210.26","80","19","8777","10","1829","9","6948","107.799085000","2.9222","5007.12","19021.03"
"197.33.223.168","46922","244.3.210.197","80","69","53540","31","2805","38","50735","89.584794000","2.9222","7679.23","138896.92"
"16.181.176.168","4701","244.3.31.26","445","2","132","2","132","0","0","210.324257000","2.9185","361.83","N/A"
"244.3.210.26","4899","67.91.20.26","1667","2","132","0","0","2","132","183.966416000","2.9128","N/A","362.54"
"244.3.210.39","4899","67.91.20.26","1475","2","132","0","0","2","132","183.858059000","2.9097","N/A","362.93"
"242.22.218.106","4350","244.3.61.118","445","2","132","2","132","0","0","31.110444000","2.9070","363.26","N/A"
"244.3.210.117","4899","67.91.20.26","1507","2","132","0","0","2","132","183.872060000","2.8984","N/A","364.34"
"244.3.210.231","4899","67.91.20.26","1678","2","132","0","0","2","132","183.977908000","2.8927","N/A","365.06"
"41.177.135.193","12951","244.3.160.239","80","18","8783","8","1756","10","7027","107.794963000","2.8891","4862.45","19458.11"
"244.3.210.77","4899","67.91.20.26","1537","2","132","0","0","2","132","183.891639000","2.8836","N/A","366.21"
"68.33.110.176","4316","244.3.160.239","80","283","254768","52","4095","231","250673","16.753638000","2.8832","11362.20","695530.45"
"244.3.160.239","61838","85.224.40.142","80","108","103852","39","3112","69","100740","81.136437000","2.8825","8636.83","279586.85"
"244.3.160.239","61719","197.154.128.43","80","1338","1345971","463","30684","875","1315287","60.177048000","2.8821","85171.26","3650914.14"
"40.138.160.255","11548","244.3.160.239","80","43","28838","15","2270","28","26568","216.068757000","2.8816","6302.06","73759.13"
"244.3.160.239","62529","198.123.241.156","80","109","94789","42","3634","67","91155","194.120614000","2.8786","10099.41","253332.98"
"244.3.210.111","4899","67.91.20.26","1687","2","132","0","0","2","132","183.993932000","2.8780","N/A","366.93"
"41.151.113.41","65376","244.3.210.197","80","60","49279","24","5405","36","43874","105.768953000","2.8773","15028.18","121988.20"
"244.3.210.181","4899","67.91.20.26","1587","2","132","0","0","2","132","183.907605000","2.8729","N/A","367.57"
"244.3.210.241","4899","67.91.20.26","1748","2","132","0","0","2","132","184.017194000","2.8627","N/A","368.88"
"244.3.210.71","4899","67.91.20.26","1595","2","132","0","0","2","132","183.922438000","2.8562","N/A","369.72"
"120.111.16.47","1831","244.3.61.225","445","2","132","2","132","0","0","4.525565000","2.8556","369.80","N/A"
"244.3.210.40","4899","67.91.20.26","1765","2","132","0","0","2","132","184.032029000","2.8540","N/A","370.01"
"91.108.108.122","4555","244.3.61.118","445","2","132","2","132","0","0","51.027280000","2.8533","370.09","N/A"
"244.3.160.239","61366","244.3.31.75","80","240","239389","83","5990","157","233399","16.769409000","2.8516","16804.52","654784.50"
"41.151.113.41","65374","244.3.210.197","80","75","62640","29","4764","46","57876","105.765701000","2.8458","13392.51","162700.49"
"244.3.210.103","4899","67.91.20.26","1615","2","132","0","0","2","132","183.931140000","2.8354","N/A","372.44"
"41.151.113.41","65373","244.3.210.197","80","65","53550","26","8434","39","45116","105.765199000","2.8248","23885.63","127771.40"
"244.3.210.81","4899","67.91.20.26","1649","2","132","0","0","2","132","183.947093000","2.8233","N/A","374.03"
"41.177.176.156","15453","244.3.160.239","80","18","7874","8","1727","10","6147","159.381910000","2.8102","4916.34","17498.99"
"40.138.160.255","4796","244.3.160.239","80","147","100717","59","5443","88","95274","144.818472000","2.8007","15547.30","272139.21"
"77.197.210.82","59509","41.177.26.176","80","24","13506","10","941","14","12565","187.680116000","2.7676","2720.08","36320.78"
"41.177.4.167","1877","244.3.153.33","1819","37","10284","16","4637","21","5647","173.159544000","2.7637","13422.62","16346.24"
"244.3.153.77","1444","41.177.24.241","993","97","36019","41","3458","56","32561","150.628961000","2.7608","10020.40","94353.42"
"40.138.160.255","8968","244.3.160.239","80","127","98100","39","3777","88","94323","0.432910000","2.7500","10987.48","274390.29"
"33.157.202.242","4119","244.3.61.39","445","2","132","2","132","0","0","62.526373000","2.7296","386.88","N/A"
"90.150.181.71","4138","244.3.210.197","80","27","19911","13","3754","14","16157","213.904784000","2.7223","11031.85","47480.46"
"186.136.103.68","4826","244.3.160.239","80","74","53636","25","2586","49","51050","73.984328000","2.6661","7759.73","153184.10"
"77.197.128.46","21179","41.177.26.176","80","26","12019","11","987","15","11032","123.144710000","2.6653","2962.56","33113.49"
"244.3.160.239","61348","85.224.40.142","80","45","39637","18","2152","27","37485","12.919907000","2.6450","6508.85","113375.62"
"151.77.192.83","10584","244.3.160.239","80","165","111818","57","4358","108","107460","81.125182000","2.6376","13218.31","325938.47"
"41.177.176.156","13894","244.3.160.239","80","60","40901","22","2428","38","38473","80.449736000","2.6372","7365.31","116707.44"
"244.3.160.239","61763","197.154.128.197","80","76","66066","29","2668","47","63398","72.328024000","2.5858","8254.47","196145.80"
"244.3.160.239","62526","30.222.71.108","80","10","2339","6","1438","4","901","192.574330000","2.5685","4478.88","2806.31"
"186.136.103.68","56861","244.3.160.239","20480","90","8820","90","8820","0","0","40.989256000","2.5612","27549.80","N/A"
"15.71.149.241","54837","41.177.26.15","80","903","1160949","98","6995","805","1153954","12.931175000","2.5599","21860.36","3606268.25"
"41.151.113.41","65372","244.3.210.197","80","37","25473","15","3642","22","21831","104.949207000","2.5534","11410.85","68399.29"
"16.176.93.164","9662","244.3.160.239","80","156","117075","56","10614","100","106461","39.645756000","2.5392","33439.94","335410.73"
"168.117.3.145","3343","244.3.160.239","80","906","883657","309","20762","597","862895","90.411910000","2.5226","65843.52","2736539.91"
"77.197.210.241","19776","41.177.26.15","80","451","472925","123","8176","328","464749","196.184061000","2.5165","25991.20","1477419.83"
"244.3.160.239","62028","81.67.210.26","80","18","8412","9","1765","9","6647","107.800824000","2.5125","5619.85","21164.38"
"244.3.160.239","61371","94.2.202.203","80","284","270359","97","7476","187","262883","18.516821000","2.4987","23935.70","841665.29"
"41.177.135.193","6911","244.3.160.239","80","19","8540","8","1756","11","6784","107.796039000","2.4802","5664.10","21882.25"
"244.3.213.252","3873","244.3.160.239","80","401","279491","135","9656","266","269835","18.514295000","2.4636","31355.84","876232.75"
"241.82.68.241","56506","41.177.98.176","80","6","1275","4","1145","2","130","161.730117000","2.4569","3728.27","423.30"
"15.71.149.241","55880","41.177.26.15","80","942","1162233","139","9828","803","1152405","17.939414000","2.4561","32012.03","3753644.53"
"40.193.210.13","61731","244.3.210.197","80","43","32437","19","2543","24","29894","38.775727000","2.4466","8315.14","97747.87"
"41.177.211.185","8779","244.3.160.239","80","10","2395","5","1456","5","939","192.571360000","2.4435","4766.90","3074.25"
"41.177.176.156","4261","244.3.160.239","80","84","57220","31","3364","53","53856","93.559126000","2.4301","11074.65","177299.76"
"68.157.168.224","48155","41.177.26.15","80","360","360642","112","8489","248","352153","230.577900000","2.4267","27985.15","1160920.35"
"244.3.160.239","61475","94.2.202.203","80","283","269118","97","7486","186","261632","37.088575000","2.4223","24723.26","864065.81"
"77.197.210.123","48317","41.177.26.176","80","20","13205","8","804","12","12401","40.438913000","2.4203","2657.50","40989.67"
"41.177.98.220","7020","244.3.90.142","1782","295","62952","155","45542","140","17410","147.638872000","2.4135","150956.65","57708.39"
"151.77.192.83","5754","244.3.160.239","80","77","43835","28","2886","49","40949","12.899342000","2.4022","9611.13","136370.75"
"15.186.110.142","51586","41.177.26.176","80","26","13182","13","1421","13","11761","209.640095000","2.3949","4746.71","39286.46"
"77.197.217.218","60749","41.177.26.176","80","25","20346","10","1001","15","19345","81.630505000","2.3917","3348.30","64708.22"
"16.176.93.164","11622","244.3.160.239","80","121","85422","43","3953","78","81469","60.123153000","2.3907","13227.89","272619.05"
"244.3.213.252","7898","244.3.160.239","80","398","278116","133","9532","265","268584","37.085742000","2.3873","31942.03","900033.30"
"244.3.160.239","61875","197.154.128.43","80","883","882406","307","20700","576","861706","90.502855000","2.3814","69539.72","2894820.76"
"244.3.181.123","15293","244.3.160.239","80","813","785936","273","18328","540","767608","139.118213000","2.3793","61625.37","2580975.76"
"41.177.92.61","2153","41.177.98.176","80","6","1352","4","1222","2","130","207.355687000","2.3585","4144.95","440.95"
"244.3.160.239","62274","40.248.176.156","80","811","786047","273","18531","538","767516","139.121241000","2.3453","63211.16","2618076.63"
"77.197.210.181","41043","41.177.26.176","80","26","12317","11","1005","15","11312","7.438840000","2.3304","3450.09","38833.28"
"244.3.160.248","47932","41.177.26.193","80","389","389730","133","10236","256","379494","74.457909000","2.3256","35211.16","1305434.32"
"244.3.160.239","61991","188.68.72.71","80","45","41629","13","1855","32","39774","104.829411000","2.3069","6432.83","137929.48"
"244.3.160.239","61283","198.123.241.156","80","23","15273","10","1362","13","13911","3.016562000","2.3013","4734.79","48359.51"
"77.197.210.128","53457","41.177.26.15","80","461","450517","150","9904","311","440613","72.776881000","2.2993","34459.33","1533040.20"
"197.33.223.253","60083","244.3.210.197","80","50","33091","26","2429","24","30662","92.342235000","2.2967","8460.83","106803.58"
"16.176.93.164","7677","244.3.160.239","80","200","144781","69","5494","131","139287","226.688731000","2.2962","19141.21","485278.92"
"41.177.176.156","16248","244.3.160.239","80","27","16126","11","1893","16","14233","121.395759000","2.2958","6596.37","49596.46"
"244.3.160.239","61308","198.123.241.156","80","25","15912","11","1411","14","14501","6.062235000","2.2932","4922.31","50587.12"
"41.177.176.156","6646","244.3.160.239","80","10","2210","5","1559","5","651","119.880774000","2.2887","5449.38","2275.53"
"90.38.138.255","5779","244.3.160.239","80","27","15726","9","1259","18","14467","6.023386000","2.2818","4414.14","50722.27"
"77.197.128.176","27660","41.177.26.176","80","16","10979","7","758","9","10221","27.676969000","2.2781","2661.83","35892.53"
"244.3.160.239","61301","128.71.90.164","80","12","5023","7","1327","5","3696","5.276372000","2.2663","4684.35","13046.98"
"15.186.110.142","52239","41.177.26.176","80","30","12590","15","1514","15","11076","218.782325000","2.2630","5352.18","39155.03"
"41.177.176.156","8286","244.3.160.239","80","10","2215","5","1564","5","651","121.093351000","2.2579","5541.42","2306.56"
"77.197.210.122","20127","41.177.26.176","80","24","12161","10","943","14","11218","4.952549000","2.2547","3345.86","39802.55"
"241.203.149.40","49710","41.177.26.15","80","11","1328","6","748","5","580","216.600772000","2.2480","2661.98","2064.10"
"244.3.160.239","62166","40.248.176.156","80","13","4485","7","1631","6","2854","118.413809000","2.2474","5805.84","10159.34"
"151.77.192.83","12039","244.3.160.239","80","10","1339","5","906","5","433","13.633635000","2.2464","3226.55","1542.05"
"244.3.181.123","9115","244.3.160.239","80","71","43893","26","2817","45","41076","104.824812000","2.2439","10043.32","146446.33"
"197.33.149.117","44653","244.3.210.197","80","24","12919","13","1589","11","11330","92.418907000","2.2428","5667.95","40414.04"
"194.224.157.64","38848","41.177.98.127","210","43","25907","16","1306","27","24601","36.933467000","2.2348","4675.08","88064.01"
"77.197.128.118","27954","41.177.26.176","80","24","12518","10","982","14","11536","126.778841000","2.2225","3534.70","41523.72"
"77.197.210.48","42895","41.177.26.176","80","15","9085","7","804","8","8281","2.002586000","2.2187","2899.00","29858.97"
"244.3.210.98","2801","85.210.77.218","80","15","7782","7","525","8","7257","201.920998000","2.2184","1893.26","26170.26"
"48.90.252.46","61289","244.3.210.197","80","50","36113","25","3425","25","32688","178.326947000","2.1958","12478.47","119093.79"
"244.3.181.123","11188","244.3.160.239","80","12","4025","6","1691","6","2334","118.410038000","2.1878","6183.32","8534.52"
"244.3.160.239","61470","244.3.31.75","80","83","77232","30","2598","53","74634","35.067466000","2.1836","9518.14","273432.07"
"244.3.160.239","62308","198.123.241.156","80","111","95902","43","3744","68","92158","145.191694000","2.1645","13837.77","340614.73"
"244.3.160.239","61350","41.43.180.128","80","134","123856","50","8420","84","115436","13.954100000","2.1565","31235.39","428229.08"
"197.33.149.122","54163","244.3.210.197","80","10","1710","6","1242","4","468","93.940762000","2.1529","4615.08","1739.01"
"197.33.149.144","62491","244.3.210.197","80","10","1709","6","1241","4","468","93.544706000","2.1466","4624.96","1744.14"
"77.197.128.224","58642","41.177.26.176","80","24","12256","9","887","15","11369","159.088263000","2.1440","3309.63","42420.69"
"85.41.34.188","15581","244.3.210.197","80","19","9982","10","3082","9","6900","42.496178000","2.1402","11520.23","25791.56"
"77.197.128.18","25970","41.177.26.176","80","26","12820","11","1005","15","11815","186.386192000","2.1366","3762.93","44237.87"
"77.197.128.13","40192","41.177.26.176","80","24","11612","9","858","15","10754","127.386006000","2.1351","3214.80","40293.66"
"244.3.160.239","61836","48.151.224.205","80","48","39007","19","2310","29","36697","80.776890000","2.1343","8658.67","137552.90"
"244.3.160.239","62027","81.67.210.26","80","17","7077","9","1765","8","5312","107.800036000","2.1330","6619.93","19923.55"
"186.136.103.68","13983","244.3.160.239","80","39","26224","14","1816","25","24408","76.757135000","2.1241","6839.47","91926.14"
"15.186.110.142","42028","41.177.26.176","80","24","11188","12","1285","12","9903","78.676462000","2.1153","4859.75","37452.19"
"46.142.20.230","45432","41.177.98.127","210","22","6116","10","826","12","5290","29.786369000","2.1148","3124.68","20011.58"
"79.46.215.185","57735","244.3.210.90","22","31","4539","13","1506","18","3033","160.890938000","2.1038","5726.91","11533.68"
"244.3.160.239","62022","81.67.210.26","80","13","3512","7","1637","6","1875","107.527700000","2.0993","6238.30","7145.28"
"41.177.135.193","16224","244.3.160.239","80","18","7205","8","1756","10","5449","107.795751000","2.0989","6693.10","20769.19"
"77.197.128.139","26323","41.177.26.176","80","22","11842","9","879","13","10963","85.805411000","2.0740","3390.63","42288.35"
"244.3.153.102","2870","244.3.160.80","443","74","51907","28","3119","46","48788","221.434613000","2.0698","12055.42","188573.25"
"244.3.160.239","61887","188.68.193.91","80","59","54311","22","2682","37","51629","93.777853000","2.0667","10381.65","199848.75"
"41.177.135.193","7754","244.3.160.239","80","12","3524","6","1628","6","1896","107.523450000","2.0663","6303.01","7340.61"
"253.37.253.43","2000","253.176.160.57","515","19","8145","19","8145","0","0","137.206857000","2.0410","31925.56","N/A"
"41.177.34.163","45637","41.177.98.176","80","45","27989","23","3571","22","24418","231.129174000","2.0408","13998.27","95718.25"
"77.197.128.18","36187","41.177.26.176","80","32","17720","13","1128","19","16592","208.482286000","2.0405","4422.51","65051.71"
"149.214.203.116","54670","41.177.26.176","80","22","11467","11","1348","11","10119","39.598194000","2.0381","5291.26","39719.81"
"77.197.210.186","4828","41.177.26.176","80","22","11440","8","825","14","10615","6.687743000","2.0370","3240.02","41688.21"
"77.197.128.139","58426","41.177.26.176","80","24","12162","9","877","15","11285","21.579909000","2.0324","3452.04","44419.89"
"40.138.160.255","13325","244.3.160.239","80","80","62177","29","3179","51","58998","218.699677000","2.0294","12531.94","232576.15"
"77.197.128.47","16748","41.177.26.176","80","14","9027","6","690","8","8337","117.093730000","2.0279","2721.98","32888.56"
"177.149.224.75","41316","41.177.26.176","80","25","6535","13","1380","12","5155","74.076527000","2.0251","5451.58","20364.42"
"77.197.128.18","61435","41.177.26.176","80","23","11842","9","856","14","10986","141.859844000","2.0212","3388.17","43484.11"
"15.186.110.142","36206","41.177.26.176","80","30","12450","15","1568","15","10882","0.324346000","2.0163","6221.23","43175.69"
"165.188.210.111","34997","41.177.98.127","210","17","2285","8","727","9","1558","50.166885000","2.0125","2889.90","6193.21"
"244.3.160.239","62516","30.222.71.108","80","10","2169","6","1306","4","863","190.418291000","2.0093","5199.78","3436.00"
"77.197.210.82","35296","41.177.26.176","80","24","12627","10","980","14","11647","129.307807000","2.0059","3908.45","46450.76"
"244.3.160.239","62197","40.248.176.156","80","670","648112","226","15524","444","632588","122.274150000","2.0044","61958.36","2524743.28"
"77.197.210.67","58225","41.177.26.176","80","21","15321","8","770","13","14551","2.227869000","2.0017","3077.39","58154.68"
"46.142.20.230","45548","41.177.98.127","210","19","4278","9","760","10","3518","224.362318000","1.9991","3041.34","14078.19"
"244.3.160.239","62255","40.248.176.156","80","15","4740","8","1948","7","2792","136.394258000","1.9949","7812.05","11196.74"
"244.3.181.123","15665","244.3.160.239","80","98","67847","35","3547","63","64300","112.992748000","1.9941","14230.21","257965.25"
"244.3.181.123","3076","244.3.160.239","80","673","648059","227","15379","446","632680","122.270882000","1.9938","61706.15","2538542.52"
"244.3.31.156","1944","244.3.153.33","1820","35","10134","16","4627","19","5507","206.254596000","1.9856","18642.40","22187.96"
"77.197.128.12","35866","41.177.26.176","80","25","12124","10","949","15","11175","30.634520000","1.9841","3826.37","45057.62"
"244.3.160.239","62104","244.3.31.108","80","73","65602","27","2911","46","62691","112.996510000","1.9835","11740.90","252850.90"
"244.3.160.239","61234","198.123.241.156","80","109","95787","41","3614","68","92173","0.827456000","1.9816","14589.94","372108.14"
"77.197.210.249","16108","41.177.26.176","80","25","12391","10","943","15","11448","62.520446000","1.9807","3808.82","46238.95"
"253.37.253.43","54727","253.160.108.253","21","30","2590","30","2590","0","0","87.192568000","1.9766","10482.83","N/A"
"15.186.110.142","46170","41.177.26.176","80","29","12318","14","1494","15","10824","135.520310000","1.9750","6051.67","43844.21"
"18.91.139.163","9321","244.3.160.239","80","172","167533","54","4445","118","163088","183.766244000","1.9711","18040.81","661921.06"
"77.197.128.84","37344","41.177.26.176","80","15","9123","7","764","8","8359","174.009578000","1.9640","3112.08","34049.54"
"41.177.98.143","8001","186.198.89.242","1257","31","3942","16","2828","15","1114","20.407163000","1.9612","11535.91","4544.20"
"244.3.160.239","62686","198.123.241.156","80","36","27841","15","2123","21","25718","216.471426000","1.9597","8666.71","104988.41"
"77.197.210.249","16766","41.177.26.176","80","21","12947","9","970","12","11977","66.586228000","1.9583","3962.72","48929.33"
"77.197.210.81","47248","41.177.26.15","80","285","313309","65","4464","220","308845","17.815629000","1.9565","18253.08","1262852.08"
"253.160.251.90","1502","253.37.253.43","446","683","959070","0","0","683","959070","112.233488000","1.9481","N/A","3938532.17"
"77.197.128.55","3750","41.177.26.176","80","25","12148","10","924","15","11224","121.266917000","1.9467","3797.22","46125.50"
"244.3.181.123","14986","244.3.160.239","80","79","50958","28","2922","51","48036","27.468571000","1.9463","12010.40","197444.09"
"244.3.160.239","61495","41.43.180.128","80","106","114074","28","8876","78","105198","39.840128000","1.9420","36564.61","433362.32"
"66.163.119.41","2545","41.177.26.91","80","598","613314","196","12849","402","600465","113.428616000","1.9372","53061.52","2479693.87"
"244.3.181.123","9582","244.3.160.239","80","12","3976","6","1642","6","2334","136.390702000","1.9338","6792.93","9655.72"
"244.3.160.239","61415","188.68.72.71","80","50","47802","14","1902","36","45900","27.549425000","1.9332","7870.74","189940.50"
"77.197.128.139","61418","41.177.26.176","80","23","11801","9","875","14","10926","35.413563000","1.9324","3622.47","45233.27"
"145.67.149.81","49504","41.177.98.176","80","35","24499","15","1911","20","22588","178.719082000","1.9316","7914.71","93551.85"
"177.149.224.75","40979","41.177.26.176","80","3","192","2","128","1","64","5.664357000","1.9272","531.35","N/A"
"244.3.160.248","47726","41.177.26.55","80","11","2240","6","1332","5","908","56.940089000","1.9268","5530.33","3769.92"
"71.193.83.117","2767","41.177.26.176","80","79","45600","22","2244","57","43356","86.860267000","1.9258","9321.80","180105.09"
"244.3.160.239","62093","85.224.40.142","80","109","118106","32","2674","77","115432","112.305304000","1.9196","11143.84","481060.62"
"244.3.160.248","47188","41.177.26.55","80","11","2278","6","1352","5","926","22.363610000","1.9173","5641.16","3863.70"
"244.3.153.239","2354","41.177.24.241","993","25","5653","12","1190","13","4463","232.502374000","1.9121","4978.76","18672.46"
"77.197.210.48","4743","41.177.26.176","80","23","13063","9","860","14","12203","60.117625000","1.9098","3602.47","51117.42"
"77.197.128.167","59596","41.177.26.176","80","25","12080","10","949","15","11131","17.835488000","1.9078","3979.44","46675.58"
"15.186.110.142","40141","41.177.26.176","80","26","12157","13","1430","13","10727","53.570842000","1.9025","6013.03","45106.13"
"41.177.199.139","3357","244.3.160.239","80","31","17034","13","2143","18","14891","136.242143000","1.8986","9029.63","62743.89"
"77.197.128.180","7266","41.177.26.176","80","28","14338","11","1002","17","13336","86.563323000","1.8957","4228.62","56280.25"
"244.3.160.239","62347","128.71.90.164","80","106","99722","38","3581","68","96141","157.528467000","1.8953","15115.30","405808.48"
"77.197.210.2","55923","41.177.26.176","80","23","12479","9","896","14","11583","94.795094000","1.8894","3793.74","49043.36"
"15.186.110.142","44542","41.177.26.176","80","24","11880","12","1299","12","10581","112.478871000","1.8856","5511.24","44891.81"
"77.197.210.48","21956","41.177.26.15","80","354","378977","90","6064","264","372913","102.243015000","1.8829","25764.81","1584438.29"
"77.197.128.204","3013","41.177.26.176","80","25","12538","10","944","15","11594","21.062447000","1.8825","4011.64","49270.07"
"41.177.211.185","3929","244.3.160.239","80","10","2225","5","1324","5","901","190.414214000","1.8822","5627.37","3829.50"
"77.197.210.123","53177","41.177.26.176","80","25","12392","10","950","15","11442","47.607355000","1.8792","4044.22","48709.39"
"46.142.20.230","45479","41.177.98.127","210","13","1069","6","544","7","525","103.819983000","1.8720","2324.81","2243.61"
"77.197.128.13","56654","41.177.26.176","80","22","11891","9","880","13","11011","190.057921000","1.8712","3762.20","47074.52"
"68.33.110.176","5208","244.3.160.239","80","60","47155","15","4163","45","42992","170.467592000","1.8659","17848.31","184322.49"
"77.197.210.198","42327","41.177.26.176","80","30","17108","11","1018","19","16090","47.834898000","1.8638","4369.46","69061.50"
"77.197.128.225","6043","41.177.26.176","80","25","12112","10","963","15","11149","206.448024000","1.8602","4141.39","47946.42"
"77.197.210.122","19527","41.177.26.176","80","25","12063","10","925","15","11138","0.904152000","1.8582","3982.32","47951.39"
"151.41.242.13","45156","41.177.98.127","210","15","1169","8","632","7","537","162.159658000","1.8577","2721.60","2312.49"
"77.197.128.180","6101","41.177.26.176","80","25","12782","10","962","15","11820","83.980639000","1.8543","4150.40","50995.53"
"77.197.128.84","44974","41.177.26.176","80","26","12080","11","1005","15","11075","204.697449000","1.8487","4348.92","47924.64"
"244.3.153.34","58092","244.3.31.117","443","55","24344","27","3014","28","21330","122.058992000","1.8474","13051.74","92366.85"
"41.177.199.139","11111","244.3.160.239","80","80","68673","29","3071","51","65602","136.251870000","1.8470","13301.30","284139.25"
"77.197.217.20","62099","41.177.26.176","80","23","11604","9","853","14","10751","95.112044000","1.8439","3700.84","46644.49"
"151.41.242.13","45022","41.177.98.127","210","17","2446","9","729","8","1717","27.515690000","1.8388","3171.69","7470.22"
"15.186.110.142","36428","41.177.26.176","80","29","11917","14","1469","15","10448","3.733009000","1.8378","6394.77","45481.63"
"244.3.160.239","62447","244.3.31.108","80","57","46259","23","4555","34","41704","170.484747000","1.8361","19846.15","181704.50"
"145.95.48.20","49175","244.3.31.46","993","1551","189068","1034","109781","517","79287","28.587798000","1.8361","478330.61","345464.14"
"77.197.128.12","28309","41.177.26.176","80","28","15941","12","1055","16","14886","14.806850000","1.8361","4596.78","64860.38"
"15.186.110.142","50681","41.177.26.176","80","28","12113","13","1393","15","10720","196.380368000","1.8337","6077.44","46769.67"
"77.197.217.224","64729","41.177.26.176","80","20","12100","6","697","14","11403","87.716172000","1.8320","3043.74","49795.87"
"15.186.110.142","37138","41.177.26.176","80","26","13508","13","1369","13","12139","13.613916000","1.8316","5979.47","53020.31"
"77.197.210.128","17863","41.177.26.176","80","18","11487","7","757","11","10730","5.297306000","1.8302","3308.92","46901.90"
"77.197.128.18","63470","41.177.26.176","80","25","12294","10","949","15","11345","146.388306000","1.8290","4150.91","49622.80"
"77.197.217.218","60215","41.177.26.176","80","25","12329","10","949","15","11380","78.990161000","1.8260","4157.63","49856.52"
"68.122.210.16","1169","41.177.98.127","210","14","1158","7","629","7","529","117.841132000","1.8256","2756.28","2318.08"
"77.197.128.46","20751","41.177.26.176","80","26","11625","11","989","15","10636","121.088139000","1.8246","4336.40","46634.93"
"145.95.48.20","49183","244.3.31.46","993","1524","185824","1016","107916","508","77908","28.596948000","1.8236","473410.78","341770.33"
"15.186.110.142","43847","41.177.26.176","80","32","12587","16","1638","16","10949","103.251311000","1.8215","7193.96","48087.07"
"77.197.210.82","45244","41.177.26.176","80","9","1931","5","652","4","1279","152.679621000","1.8152","2873.53","5636.88"
"77.197.217.152","19308","41.177.26.176","80","42","32495","15","1279","27","31216","79.531262000","1.8094","5655.04","138020.07"
"77.197.128.180","61269","41.177.26.176","80","24","12039","9","863","15","11176","55.744284000","1.8077","3819.18","49459.01"
"77.197.210.103","55956","41.177.26.15","80","163","146495","61","4261","102","142234","105.819758000","1.8073","18861.20","629594.96"
"194.252.160.64","34645","41.177.98.127","210","15","1221","8","696","7","525","167.517475000","1.8027","3088.77","2329.89"
"77.197.128.31","1916","41.177.26.176","80","26","12168","10","924","16","11244","34.612020000","1.7991","4108.83","49999.67"
"77.197.210.80","38811","41.177.26.176","80","22","11647","8","792","14","10855","61.938985000","1.7984","3523.23","48288.68"
"85.26.113.153","3350","41.177.98.127","210","14","1162","7","631","7","531","42.369824000","1.7971","2809.00","2363.84"
"244.3.160.239","62174","244.176.48.167","80","10","2163","6","1534","4","629","120.430719000","1.7970","6829.26","2800.26"
"26.244.48.209","55686","41.177.26.91","80","226","236973","69","4933","157","232040","53.671396000","1.7917","22025.70","1036051.85"
"244.3.160.239","62498","198.123.241.156","80","101","90100","38","3394","63","86706","182.024622000","1.7906","15163.45","387378.46"
"77.197.128.55","24183","41.177.26.176","80","24","12275","9","879","15","11396","172.720948000","1.7891","3930.52","50958.09"
"15.186.110.142","45923","41.177.26.176","80","30","12758","15","1547","15","11211","132.019799000","1.7868","6926.31","50194.45"
"77.197.128.13","35944","41.177.26.176","80","27","12888","11","1007","16","11881","109.896478000","1.7862","4510.01","53210.95"
"77.197.128.47","10841","41.177.26.176","80","23","12500","8","813","15","11687","104.532747000","1.7813","3651.29","52487.80"
"253.160.251.79","2820","253.37.253.43","446","23","24312","0","0","23","24312","206.077911000","1.7782","N/A","109379.68"
"77.197.128.13","54573","41.177.26.176","80","24","13819","11","1018","13","12801","181.765411000","1.7736","4591.76","57739.80"
"197.45.108.197","40801","41.177.98.127","210","22","3217","12","992","10","2225","85.411646000","1.7721","4478.23","10044.42"
"15.186.110.142","42634","41.177.26.176","80","24","12176","12","1308","12","10868","87.255502000","1.7715","5906.73","49078.26"
"77.197.217.20","38351","41.177.26.176","80","23","11730","9","884","14","10846","32.569165000","1.7681","3999.75","49073.90"
"244.3.153.239","2353","41.177.24.241","993","27","3564","13","1324","14","2240","232.498857000","1.7673","5993.23","10139.60"
"244.3.153.239","2352","41.177.24.241","993","27","3615","13","1342","14","2273","232.495018000","1.7672","6075.10","10289.65"
"77.197.128.41","24516","41.177.26.176","80","25","11530","10","940","15","10590","227.581684000","1.7665","4257.07","47960.00"
"77.197.128.223","55826","41.177.26.176","80","23","11865","9","873","14","10992","160.432756000","1.7647","3957.71","49831.78"
"244.3.160.239","61370","198.123.241.156","80","29","21301","12","1949","17","19352","18.386509000","1.7637","8840.63","87780.35"
"77.197.210.186","35416","41.177.26.176","80","23","12181","8","819","15","11362","63.935981000","1.7632","3715.87","51550.35"
"77.197.128.13","45870","41.177.26.176","80","27","12538","12","1061","15","11477","144.308347000","1.7617","4818.00","52117.07"
"15.186.110.142","45295","41.177.26.176","80","31","13075","15","1547","16","11528","123.028138000","1.7617","7025.12","52350.09"
"128.181.211.197","2689","41.177.98.127","210","15","1273","8","692","7","581","102.244038000","1.7601","3145.30","2640.78"
"77.197.217.224","38721","41.177.26.176","80","20","11994","6","683","14","11311","24.464173000","1.7570","3109.88","51502.04"
"77.197.210.67","16472","41.177.26.176","80","25","12483","10","949","15","11534","51.948341000","1.7543","4327.54","52596.24"
"244.3.160.248","49186","41.177.26.193","80","303","300485","104","8380","199","292105","162.755833000","1.7531","38241.35","1332994.12"
"77.197.210.159","26911","41.177.26.176","80","25","11930","10","931","15","10999","80.228936000","1.7511","4253.21","50248.18"
"77.197.210.48","1073","41.177.26.176","80","26","12647","11","1012","15","11635","53.440210000","1.7506","4624.66","53169.92"
"77.197.128.46","29903","41.177.26.176","80","25","11720","10","939","15","10781","153.845410000","1.7501","4292.29","49281.36"
"77.197.128.13","47447","41.177.26.176","80","25","12169","10","943","15","11226","151.261873000","1.7494","4312.23","51335.20"
"68.157.168.106","45027","41.177.26.176","80","31","12372","16","1474","15","10898","231.104635000","1.7469","6750.05","49906.44"
"77.197.128.18","23954","41.177.26.176","80","22","11569","9","867","13","10702","180.948810000","1.7451","3974.50","49060.04"
"77.197.128.46","26286","41.177.26.176","80","25","12154","10","959","15","11195","140.206354000","1.7437","4399.80","51361.55"
"77.197.210.82","44038","41.177.26.176","80","21","11534","7","728","14","10806","146.287490000","1.7426","3342.05","49607.46"
"77.197.128.41","63332","41.177.26.176","80","25","12391","10","930","15","11461","179.523939000","1.7421","4270.72","52630.85"
"252.77.177.67","3262","41.177.26.176","80","4","256","2","128","2","128","5.694237000","1.7359","589.91","589.91"
"149.214.94.34","38755","41.177.26.176","80","25","12091","13","1532","12","10559","112.797605000","1.7317","7077.46","48779.95"
"77.197.210.67","18362","41.177.26.176","80","37","30049","12","1079","25","28970","56.939800000","1.7296","4990.86","133999.32"
"77.197.128.167","54078","41.177.26.176","80","27","13406","11","1004","16","12402","9.188004000","1.7286","4646.64","57398.03"
"83.202.121.77","2469","41.177.98.127","210","14","1159","7","628","7","531","135.174026000","1.7278","2907.73","2458.61"
"77.197.128.224","50842","41.177.26.176","80","22","13496","10","990","12","12506","217.187406000","1.7263","4587.79","57954.43"
"77.197.128.225","11073","41.177.26.176","80","24","11676","10","937","14","10739","210.948480000","1.7254","4344.50","49792.54"
"77.197.210.82","42814","41.177.26.176","80","22","12005","9","882","13","11123","143.337782000","1.7249","4090.76","51588.99"
"244.3.31.241","50888","244.3.41.84","21","24","1907","12","796","12","1111","61.971711000","1.7221","3697.86","5161.21"
"253.160.251.90","1361","253.37.253.43","446","553","775148","0","0","553","775148","42.949409000","1.7208","N/A","3603571.27"
"77.197.128.18","54927","41.177.26.176","80","24","11879","9","856","15","11023","132.693911000","1.7194","3982.74","51287.03"
"194.168.141.39","35639","41.177.98.127","210","15","1232","8","695","7","537","184.337617000","1.7179","3236.51","2500.73"
"15.186.110.142","39575","41.177.26.176","80","29","12665","14","1465","15","11200","45.719633000","1.7177","6822.89","52161.35"
"244.3.160.239","62756","41.43.180.128","80","152","141986","56","4747","96","137239","226.898186000","1.7155","22136.37","639977.43"
"77.197.128.118","6416","41.177.26.176","80","22","12060","9","855","13","11205","200.984542000","1.7133","3992.21","52318.98"
"151.41.242.13","45003","41.177.98.127","210","17","2446","9","729","8","1717","6.676965000","1.7132","3404.13","8017.68"
"15.186.110.142","45792","41.177.26.176","80","28","12739","14","1477","14","11262","130.191726000","1.7118","6902.83","52633.49"
"77.197.128.193","51432","41.177.26.176","80","25","13657","10","942","15","12715","227.506965000","1.7115","4403.12","59432.83"
"77.197.128.18","32044","41.177.26.176","80","25","12554","10","972","15","11582","148.248756000","1.7077","4553.51","54257.93"
"244.3.160.239","61336","244.3.31.108","80","60","55560","22","2358","38","53202","9.099535000","1.7049","11064.42","249639.13"
"15.186.110.142","36862","41.177.26.176","80","26","11381","13","1386","13","9995","9.464650000","1.7039","6507.37","46927.22"
"77.197.217.152","22390","41.177.26.176","80","23","11757","9","873","14","10884","86.774826000","1.7036","4099.55","51110.56"
"244.3.153.34","58038","244.3.31.117","443","65","29084","32","3503","33","25581","0.347734000","1.7035","16451.26","120136.95"
"15.186.110.142","48154","41.177.26.176","80","30","12747","15","1547","15","11200","162.303462000","1.7028","7268.02","52619.18"
"77.197.128.13","43167","41.177.26.176","80","24","12236","10","957","14","11279","134.443515000","1.7003","4502.76","53068.53"
"77.197.128.223","6285","41.177.26.176","80","24","11854","10","938","14","10916","177.958877000","1.6971","4421.74","51458.16"
"15.186.110.142","49474","41.177.26.176","80","29","12170","14","1477","15","10693","180.400015000","1.6959","6967.56","50442.87"
"244.3.160.239","62037","81.67.210.26","80","11","2140","6","1551","5","589","108.600425000","1.6942","7323.67","2781.20"
"77.197.128.167","3911","41.177.26.176","80","25","11785","10","935","15","10850","29.580111000","1.6940","4415.70","51241.06"
"77.197.128.224","7944","41.177.26.176","80","24","12250","10","947","14","11303","174.940037000","1.6938","4472.87","53386.36"
"77.197.128.55","63044","41.177.26.176","80","25","12161","10","933","15","11228","110.625801000","1.6935","4407.33","53039.16"
"77.197.128.13","54149","41.177.26.176","80","20","11803","9","905","11","10898","179.126066000","1.6918","4279.56","51534.41"
"15.186.110.142","49317","41.177.26.176","80","28","12607","14","1477","14","11130","178.147163000","1.6884","6998.44","52737.07"
"83.202.121.77","2476","41.177.98.127","210","14","1159","7","628","7","531","135.504530000","1.6881","2976.21","2516.51"
"77.197.128.18","49737","41.177.26.176","80","25","12368","10","950","15","11418","232.710120000","1.6875","4503.64","54129.07"
"244.3.160.239","62499","244.239.197.117","80","146","165827","29","2735","117","163092","183.862360000","1.6850","12984.97","774312.55"
"194.168.61.239","58409","41.177.98.127","210","12","977","5","440","7","537","91.756213000","1.6849","2089.09","2549.64"
"77.197.210.123","39377","41.177.26.176","80","26","12171","11","1004","15","11167","7.889150000","1.6835","4770.95","53064.91"
"77.197.128.55","19826","41.177.26.176","80","25","13095","10","1085","15","12010","159.068802000","1.6777","5173.76","57268.95"
"77.197.217.20","60689","41.177.26.176","80","21","11737","9","873","12","10864","84.341459000","1.6728","4175.13","51957.18"
"40.138.160.255","15635","244.3.160.239","80","46","32963","16","2260","30","30703","20.863430000","1.6701","10825.56","147069.50"
"77.197.210.202","26871","41.177.26.15","80","226","216373","76","5276","150","211097","10.063254000","1.6698","25277.20","1011361.21"
"77.197.128.92","11674","41.177.26.176","80","25","12429","10","953","15","11476","191.680915000","1.6696","4566.45","54989.08"
"77.197.128.47","18543","41.177.26.176","80","25","12098","10","928","15","11170","120.518095000","1.6691","4447.97","53538.57"
"15.186.110.142","45276","41.177.26.176","80","27","14572","13","1377","14","13195","122.769638000","1.6671","6607.73","63318.06"
"77.197.128.18","22818","41.177.26.176","80","25","12172","10","930","15","11242","179.233631000","1.6639","4471.29","54049.70"
"41.177.135.193","3508","244.3.160.239","80","12","2274","6","1640","6","634","108.596367000","1.6613","7897.58","3053.09"
"77.197.210.128","33988","41.177.26.176","80","27","12130","11","1015","16","11115","46.350162000","1.6601","4891.26","53562.94"
"77.197.128.139","28623","41.177.26.176","80","24","12013","10","950","14","11063","93.487169000","1.6582","4583.42","53375.15"
"41.77.105.0","3093","244.3.210.197","80","31","23036","15","2637","16","20399","70.163612000","1.6571","12730.42","98478.52"
"77.197.210.159","31149","41.177.26.176","80","25","12482","10","949","15","11533","91.936239000","1.6567","4582.54","55690.70"
"77.197.128.55","43013","41.177.26.15","80","104","98033","35","2543","69","95490","217.494894000","1.6554","12289.61","461476.57"
"40.138.160.255","2343","244.3.160.239","80","11","2072","6","1586","5","486","81.475819000","1.6548","7667.35","2349.51"
"77.161.130.31","61648","41.177.98.127","210","14","1172","7","636","7","536","127.337060000","1.6519","3080.12","2595.83"
"77.197.128.13","59800","41.177.26.176","80","22","12060","9","866","13","11194","200.229863000","1.6515","4195.03","54225.33"
"77.197.128.13","53023","41.177.26.176","80","28","13239","12","1105","16","12134","172.008933000","1.6502","5356.78","58822.82"
"77.197.217.224","41567","41.177.26.176","80","38","27590","15","1279","23","26311","29.598985000","1.6493","6203.97","127625.26"
"77.197.128.41","52117","41.177.26.176","80","26","12203","10","980","16","11223","148.005592000","1.6460","4763.06","54546.75"
"77.197.128.180","55677","41.177.26.176","80","25","11997","10","939","15","11058","40.832064000","1.6438","4569.79","53815.46"
"244.3.160.239","62023","81.67.210.26","80","11","3163","6","1573","5","1590","107.528850000","1.6438","7655.37","7738.10"
"244.3.160.248","50012","41.177.26.55","80","10","2540","5","1780","5","760","230.952383000","1.6398","8683.96","3707.76"
"77.197.217.218","59434","41.177.26.176","80","33","25737","11","1024","22","24713","75.754993000","1.6383","5000.33","120676.97"
"77.197.128.127","49821","41.177.26.176","80","30","21109","12","1088","18","20021","32.829312000","1.6371","5316.83","97838.51"
"77.197.128.72","22649","41.177.26.176","80","39","28766","15","1279","24","27487","122.527608000","1.6353","6256.88","134466.65"
"77.161.130.31","61614","41.177.98.127","210","14","1172","7","636","7","536","8.454175000","1.6339","3114.08","2624.44"
"15.186.110.142","38613","41.177.26.176","80","28","12277","13","1426","15","10851","32.244666000","1.6313","6993.08","53213.15"
"145.95.41.251","65055","145.95.81.118","23","107","8216","42","2765","65","5451","69.544070000","1.6312","13560.65","26733.86"
"197.154.210.84","62573","41.177.98.127","210","15","1230","8","693","7","537","84.598646000","1.6293","3402.64","2636.68"
"77.197.128.118","45309","41.177.26.176","80","25","12500","10","949","15","11551","152.169556000","1.6287","4661.53","56738.98"
"197.154.210.84","64045","41.177.98.127","210","17","2264","9","790","8","1474","202.395789000","1.6282","3881.58","7242.34"
"77.197.13.80","30844","41.177.26.176","80","25","12337","10","989","15","11348","208.590002000","1.6248","4869.49","55873.58"
"77.197.128.224","21762","41.177.26.176","80","30","24102","11","1023","19","23079","184.939271000","1.6235","5040.84","113721.94"
"77.197.128.18","30295","41.177.26.176","80","25","12273","10","940","15","11333","142.186571000","1.6171","4650.38","56066.73"
"77.197.128.224","48540","41.177.26.176","80","37","27090","15","1271","22","25819","214.967059000","1.6156","6293.48","127845.23"
"244.3.160.239","62684","246.220.26.95","80","532","511376","180","12647","352","498729","215.340223000","1.6152","62638.91","2470138.54"
"77.197.128.92","18070","41.177.26.176","80","23","12077","9","882","14","11195","214.782795000","1.6146","4370.02","55467.51"
"77.197.128.84","35739","41.177.26.176","80","24","11952","9","861","15","11091","168.687202000","1.6139","4267.86","54976.53"
"77.197.128.180","57874","41.177.26.176","80","30","21072","12","1087","18","19985","44.997797000","1.6125","5392.85","99150.02"
"41.177.135.193","4926","244.3.160.239","80","12","3297","6","1628","6","1669","107.524385000","1.6122","8078.46","8281.91"
"77.197.210.186","52243","41.177.26.15","80","329","313764","112","7472","217","306292","111.732489000","1.6071","37195.29","1524708.40"
"151.77.192.83","10087","244.3.160.239","80","26","19758","11","1423","15","18335","41.354724000","1.6065","7086.34","91305.67"
"77.197.128.251","37588","41.177.26.176","80","31","23880","11","1023","20","22857","10.064333000","1.6064","5094.49","113826.85"
"15.186.110.142","37480","41.177.26.176","80","29","12297","14","1494","15","10803","18.088467000","1.6064","7440.28","53800.10"
"244.3.160.239","62189","188.68.193.91","80","22","15461","10","1706","12","13755","121.889827000","1.6046","8505.30","68575.83"
"15.186.110.142","49512","41.177.26.176","80","34","15967","16","1581","18","14386","180.973591000","1.6034","7888.45","71779.40"
"210.176.151.45","1997","41.177.26.15","80","127","131767","34","2643","93","129124","178.722677000","1.5983","13229.01","646304.68"
"253.160.251.85","44919","253.37.253.43","446","524","731432","0","0","524","731432","204.527044000","1.5961","N/A","3666047.87"
"77.197.128.46","24976","41.177.26.176","80","25","11996","10","953","15","11043","136.254945000","1.5890","4798.00","55597.44"
"77.197.128.31","3436","41.177.26.176","80","29","20024","13","1151","16","18873","37.243975000","1.5845","5811.18","95286.24"
"16.176.93.164","4614","244.3.160.239","80","125","88628","44","3953","81","84675","16.712871000","1.5833","19973.20","427834.64"
"77.197.128.47","5852","41.177.26.176","80","22","12744","10","944","12","11800","98.636304000","1.5804","4778.48","59731.03"
"77.197.128.224","31998","41.177.26.176","80","31","15638","13","1111","18","14527","198.382069000","1.5745","5644.91","73810.62"
"15.186.110.142","48976","41.177.26.176","80","26","12368","13","1393","13","10975","173.641694000","1.5696","7100.02","55938.78"
"77.197.128.180","63489","41.177.26.176","80","24","12011","10","951","14","11060","64.729718000","1.5674","4853.97","56451.00"
"186.136.103.68","4896","244.3.160.239","80","18","6365","9","1488","9","4877","76.757139000","1.5673","7595.31","24894.05"
"77.197.128.223","61822","41.177.26.176","80","20","13178","8","856","12","12322","167.625827000","1.5643","4377.56","63014.35"
"15.71.149.241","56785","41.177.26.15","80","522","657304","65","4827","457","652477","22.937279000","1.5599","24755.15","3346211.79"
"77.197.217.224","63648","41.177.26.176","80","22","11555","9","910","13","10645","83.047390000","1.5594","4668.56","54611.87"
"151.77.192.83","9969","244.3.160.239","80","92","82821","34","2683","58","80138","113.830983000","1.5577","13778.89","411559.02"
"151.77.39.25","10206","244.3.160.239","80","797","526398","268","18364","529","508034","215.336792000","1.5571","94347.87","2610102.81"
"142.117.244.30","3303","41.177.26.176","80","27","10350","11","1024","16","9326","227.417113000","1.5570","5261.34","47917.21"
"77.197.128.92","16320","41.177.26.176","80","25","11985","10","945","15","11040","208.615245000","1.5569","4855.69","56726.80"
"254.210.244.164","23867","41.177.98.127","210","14","1184","7","637","7","547","42.064069000","1.5559","3275.19","2812.44"
"244.3.160.239","62678","246.220.26.95","80","493","466525","174","12290","319","454235","214.553399000","1.5551","63223.46","2336721.50"
"16.176.93.164","3423","244.3.160.239","80","12","2591","6","1408","6","1183","87.883153000","1.5548","7244.71","6087.00"
"15.71.149.241","57471","41.177.26.15","80","539","663917","76","5585","463","658332","27.975766000","1.5540","28750.92","3389015.83"
"77.197.210.186","33763","41.177.26.176","80","25","12394","10","952","15","11442","59.885421000","1.5540","4900.91","58903.55"
"77.197.128.165","25252","41.177.26.15","80","311","303308","101","6768","210","296540","229.787157000","1.5514","34899.55","1529124.21"
"194.168.141.39","35591","41.177.98.127","210","15","1166","8","629","7","537","159.954927000","1.5483","3250.01","2774.65"
"77.197.210.181","44667","41.177.26.15","80","285","286713","86","5808","199","280905","190.743066000","1.5480","30014.92","1451677.29"
"41.177.176.156","11723","244.3.160.239","80","10","2229","5","1578","5","651","122.175930000","1.5476","8157.05","3365.17"
"77.197.128.224","51960","41.177.26.176","80","24","12616","10","969","14","11647","149.420556000","1.5474","5009.80","60215.80"
"254.210.244.164","27127","41.177.98.127","210","14","1184","7","637","7","547","43.621330000","1.5363","3317.08","2848.42"
"198.222.241.108","2876","41.177.98.127","210","14","1181","7","650","7","531","24.344017000","1.5334","3391.06","2770.24"
"244.3.160.248","50018","41.177.26.55","80","15","9302","7","1904","8","7398","232.695131000","1.5333","9934.43","38600.26"
"142.197.48.208","3223","41.177.98.127","210","14","1172","7","624","7","548","102.725311000","1.5321","3258.38","2861.52"
"197.154.210.84","62555","41.177.98.127","210","15","1227","8","690","7","537","84.225423000","1.5296","3608.74","2808.54"
"253.160.251.79","2741","253.37.253.43","446","171","227325","0","0","171","227325","130.504100000","1.5282","N/A","1190039.16"
"151.77.192.83","2683","244.3.160.239","80","98","91252","37","3088","61","88164","112.300947000","1.5269","16179.18","461923.86"
"186.136.103.68","10046","244.3.160.239","80","15","2296","8","1399","7","897","76.757241000","1.5259","7334.46","4702.65"
"77.197.128.94","35865","41.177.26.176","80","30","17011","12","1090","18","15921","6.970126000","1.5257","5715.24","83479.27"
"186.136.103.68","9850","244.3.160.239","80","15","2181","8","1382","7","799","76.757131000","1.5244","7252.78","4193.18"
"77.197.128.251","63591","41.177.26.176","80","25","13827","12","1079","13","12748","67.890353000","1.5243","5662.96","66905.86"
"194.168.141.39","35483","41.177.98.127","210","15","1278","8","697","7","581","97.435923000","1.5238","3659.22","3050.22"
"77.197.210.160","15583","41.177.26.15","80","108","102931","36","2654","72","100277","218.846712000","1.5230","13941.01","526737.88"
"77.197.128.139","59834","41.177.26.176","80","25","11936","10","940","15","10996","26.895951000","1.5222","4940.23","57790.15"
"197.193.211.106","3292","41.177.98.127","210","14","1160","7","630","7","530","191.922574000","1.5217","3312.07","2786.35"
"142.197.48.208","3158","41.177.98.127","210","14","1166","7","618","7","548","6.129486000","1.5216","3249.17","2881.14"
"241.204.15.82","60335","41.177.98.127","210","14","1229","7","628","7","601","71.335624000","1.5215","3301.94","3159.98"
"15.186.110.132","45955","41.177.26.91","80","40","29750","18","1697","22","28053","65.930269000","1.5213","8923.85","147519.55"
"142.197.48.208","3159","41.177.98.127","210","14","1166","7","618","7","548","7.650790000","1.5206","3251.42","2883.13"
"244.3.160.239","62709","198.123.241.156","80","67","60539","25","2680","42","57859","219.020819000","1.5146","14155.85","305613.22"
"15.71.149.89","55031","244.3.210.197","80","179","139867","84","6112","95","133755","139.360013000","1.5073","32438.82","709891.00"
"142.197.48.208","3222","41.177.98.127","210","14","1172","7","624","7","548","101.218502000","1.5073","3311.95","2908.57"
"77.197.210.2","50441","41.177.26.176","80","23","11949","9","891","14","11058","81.562983000","1.5062","4732.31","58731.68"
"198.222.241.108","4537","41.177.98.127","210","14","1179","7","648","7","531","158.363435000","1.5060","3442.20","2820.69"
"197.193.211.106","3281","41.177.98.127","210","14","1160","7","630","7","530","157.120348000","1.5046","3349.70","2818.00"
"241.204.15.82","60378","41.177.98.127","210","14","1229","7","628","7","601","96.202084000","1.5037","3341.09","3197.44"
"254.214.213.72","3397","41.177.98.127","210","14","1164","7","632","7","532","139.485877000","1.5024","3365.28","2832.80"
"77.197.210.217","15647","41.177.26.15","80","162","143936","62","4349","100","139587","41.091599000","1.5006","23184.84","744148.48"
"241.204.15.82","60355","41.177.98.127","210","14","1229","7","628","7","601","77.689971000","1.5001","3349.07","3205.08"
"186.136.103.68","5317","244.3.160.239","80","16","7200","8","1403","8","5797","76.757126000","1.4964","7500.68","30991.75"
"41.177.223.45","7044","244.3.160.239","80","114","107604","40","3790","74","103814","16.437917000","1.4909","20336.25","557041.43"
"77.197.217.224","62662","41.177.26.176","80","22","11495","9","889","13","10606","80.188760000","1.4899","4773.37","56947.57"
"244.3.160.239","61723","41.43.180.128","80","92","83728","35","3501","57","80227","60.421552000","1.4842","18870.80","432432.87"
"77.197.217.20","57536","41.177.26.176","80","30","13697","13","1140","17","12557","73.264443000","1.4828","6150.35","67745.59"
"16.176.93.164","12189","244.3.160.239","80","57","38864","21","2477","36","36387","121.269832000","1.4807","13382.49","196588.06"
"85.41.34.188","15585","244.3.210.197","80","18","9605","9","1418","9","8187","43.730576000","1.4788","7671.22","44290.77"
"77.197.128.18","37441","41.177.26.176","80","22","12948","9","961","13","11987","212.590186000","1.4753","5211.13","65000.84"
"85.41.34.188","15580","244.3.210.197","80","35","24604","17","4314","18","20290","42.094066000","1.4737","23418.30","110143.11"
"254.214.213.72","3278","41.177.98.127","210","14","1164","7","632","7","532","84.539654000","1.4729","3432.66","2889.52"
"41.177.176.156","4007","244.3.160.239","80","12","2483","6","1555","6","928","113.647925000","1.4703","8460.62","5049.17"
"244.3.160.239","62705","117.246.95.43","80","102","107496","23","2201","79","105295","218.720449000","1.4659","12012.07","574652.81"
"15.186.110.142","51416","41.177.26.176","80","30","13010","15","1529","15","11481","207.469799000","1.4658","8345.13","62662.16"
"15.186.110.142","51732","41.177.26.176","80","30","12794","14","1472","16","11322","211.445058000","1.4647","8039.63","61837.43"
"244.3.160.239","61514","85.224.40.142","80","13","4982","7","873","6","4109","44.615094000","1.4585","4788.62","22538.86"
"15.186.110.142","41760","41.177.26.176","80","28","12975","14","1504","14","11471","75.312097000","1.4553","8267.84","63058.74"
"68.33.110.176","3575","244.3.160.239","80","73","58427","18","1919","55","56508","216.001560000","1.4520","10572.75","311331.34"
"244.3.241.204","10955","244.3.160.239","80","179","119456","67","5071","112","114385","218.716025000","1.4498","27981.75","631175.84"
"213.197.255.209","58439","41.177.98.127","210","14","1229","7","628","7","601","81.849234000","1.4488","3467.66","3318.57"
"213.197.255.209","58455","41.177.98.127","210","14","1229","7","628","7","601","111.522071000","1.4483","3468.83","3319.69"
"15.186.110.142","51419","41.177.26.176","80","29","12942","14","1459","15","11483","207.543529000","1.4481","8060.07","63436.43"
"77.197.217.218","61156","41.177.26.176","80","25","11986","10","953","15","11033","84.127646000","1.4481","5264.83","60951.59"
"77.197.128.127","50560","41.177.26.176","80","23","13498","10","954","13","12544","37.314368000","1.4469","5274.69","69356.12"
"106.37.181.3","64966","244.3.210.197","80","35","19743","18","1572","17","18171","180.287410000","1.4452","8702.17","100589.83"
"244.3.160.239","62195","244.176.48.167","80","10","2182","6","1553","4","629","122.235574000","1.4447","8599.55","3483.01"
"77.197.210.186","36004","41.177.26.176","80","24","12450","9","871","15","11579","65.803805000","1.4442","4824.90","64141.81"
"106.37.181.3","54453","244.3.210.197","80","33","20321","16","1476","17","18845","13.647284000","1.4419","8189.15","104555.91"
"253.160.251.90","1675","253.37.253.43","446","583","815336","0","0","583","815336","167.097103000","1.4405","N/A","4527971.61"
"77.197.128.55","29787","41.177.26.15","80","256","246002","86","5807","170","240195","193.131957000","1.4400","32261.47","1334431.49"
"68.33.110.176","10501","244.3.160.239","80","75","58555","20","2047","55","56508","124.827939000","1.4359","11404.88","314834.99"
"213.197.255.209","58407","41.177.98.127","210","14","1229","7","628","7","601","38.737438000","1.4335","3504.70","3354.02"
"77.197.128.18","33526","41.177.26.176","80","25","12765","9","903","16","11862","198.499948000","1.4311","5047.92","66310.53"
"77.197.210.249","14183","41.177.26.176","80","24","11671","10","957","14","10714","55.711815000","1.4300","5353.79","59937.79"
"77.197.128.13","61598","41.177.26.176","80","26","12312","11","1030","15","11282","207.559208000","1.4298","5763.23","63126.94"
"77.197.210.108","22621","41.177.26.15","80","255","246960","83","5615","172","241345","10.308290000","1.4272","31474.08","1352825.03"
"197.154.210.84","62234","41.177.98.127","210","15","1230","8","693","7","537","57.950183000","1.4250","3890.47","3014.70"
"244.3.153.0","3547","41.177.24.241","993","68","8001","28","3155","40","4846","173.288032000","1.4246","17717.03","27212.91"
"253.37.253.43","2001","253.176.160.57","515","26","15241","26","15241","0","0","146.741124000","1.4235","85653.13","N/A"
"77.197.210.198","45637","41.177.26.176","80","22","11412","9","855","13","10557","56.091569000","1.4231","4806.35","59345.79"
"15.186.110.142","49418","41.177.26.176","80","20","9606","10","1131","10","8475","179.513852000","1.4225","6360.52","47661.69"
"40.138.160.255","7463","244.3.160.239","80","13","2612","7","2056","6","556","220.708924000","1.4196","11586.44","3133.30"
"244.3.160.239","62685","244.3.31.75","80","62","55973","23","2150","39","53823","216.013638000","1.4173","12135.34","303795.54"
"213.197.255.209","58422","41.177.98.127","210","14","1229","7","628","7","601","53.687668000","1.4171","3545.31","3392.89"
"41.177.176.156","12463","244.3.160.239","80","12","3215","6","1555","6","1660","114.185348000","1.4131","8803.56","9398.01"
"77.197.210.67","58865","41.177.26.176","80","21","12309","9","924","12","11385","8.409146000","1.4130","5231.43","64458.64"
"244.3.210.203","3794","244.3.210.39","3211","93","26290","46","12586","47","13704","187.052616000","1.4118","71316.91","77651.91"
"244.3.160.239","62113","85.224.40.142","80","89","82638","33","2550","56","80088","113.840368000","1.4117","14451.13","453867.59"
"244.3.210.203","3799","244.3.210.153","3211","70","18216","35","8833","35","9383","188.357258000","1.4097","50128.72","53250.06"
"77.197.210.2","51311","41.177.26.176","80","23","12375","8","834","15","11541","83.792807000","1.4083","4737.78","65561.99"
"198.222.241.108","4856","41.177.98.127","210","14","1162","7","631","7","531","228.450506000","1.4072","3587.39","3018.87"
"16.176.93.164","15813","244.3.160.239","80","90","62808","32","3217","58","59591","15.566752000","1.4048","18319.51","339346.59"
"186.136.103.68","9362","244.3.160.239","80","13","1967","7","1379","6","588","76.757250000","1.4000","7879.95","3359.98"
"77.197.128.55","5150","41.177.26.176","80","25","12908","10","969","15","11939","127.586087000","1.3955","5555.05","68443.49"
"244.3.160.239","61317","128.71.90.164","80","16","6409","8","1373","8","5036","6.887615000","1.3922","7889.72","28938.56"
"77.197.128.211","37168","41.177.26.15","80","264","261673","82","5552","182","256121","145.229190000","1.3889","31978.99","1475232.41"
"77.197.128.18","58658","41.177.26.176","80","25","11765","10","959","15","10806","136.875317000","1.3863","5534.19","62359.20"
"244.3.160.239","61435","244.3.31.75","80","157","153056","55","4198","102","148858","29.935519000","1.3856","24237.81","859454.79"
"77.197.128.18","1779","41.177.26.176","80","23","12925","10","954","13","11971","157.139298000","1.3779","5539.04","69505.09"
"253.160.251.90","1775","253.37.253.43","446","583","816622","0","0","583","816622","216.744681000","1.3776","N/A","4742308.69"
"244.3.160.239","62215","244.3.31.75","80","62","55973","23","2150","39","53823","124.844662000","1.3762","12498.18","312878.94"
"77.197.217.224","37554","41.177.26.176","80","22","11985","8","833","14","11152","22.142813000","1.3749","4846.93","64889.46"
"77.197.128.18","34634","41.177.26.176","80","24","12395","10","959","14","11436","202.201346000","1.3734","5585.97","66612.25"
"77.197.128.118","46610","41.177.26.176","80","24","13330","11","1054","13","12276","157.497587000","1.3714","6148.32","71609.82"
"177.149.224.75","40989","41.177.26.15","80","3","192","2","128","1","64","6.224287000","1.3672","748.96","N/A"
"15.186.110.142","37659","41.177.26.176","80","29","12533","13","1421","16","11112","20.045788000","1.3667","8318.07","65045.98"
"77.197.128.18","35370","41.177.26.176","80","24","12446","10","969","14","11477","205.014506000","1.3654","5677.28","67242.70"
"77.197.128.84","45476","41.177.26.176","80","24","12374","9","920","15","11454","207.089517000","1.3649","5392.21","67132.97"
"77.197.128.13","53773","41.177.26.176","80","19","12645","8","812","11","11833","176.063952000","1.3612","4772.25","69544.37"
"77.197.210.176","45792","41.177.26.15","80","256","250834","82","5552","174","245282","221.876612000","1.3593","32675.31","1443563.44"
"77.197.128.13","59487","41.177.26.176","80","25","12619","10","979","15","11640","198.867797000","1.3578","5768.26","68582.84"
"77.197.210.186","30808","41.177.26.176","80","27","12738","11","1034","16","11704","53.725171000","1.3577","6092.54","68962.42"
"77.197.128.139","38759","41.177.26.15","80","294","288312","94","6319","200","281993","112.901842000","1.3575","37239.56","1661860.46"
"77.197.217.218","62612","41.177.26.176","80","24","14200","10","1008","14","13192","92.512676000","1.3568","5943.32","77782.04"
"77.197.128.225","4271","41.177.26.176","80","26","12955","10","990","16","11965","201.580322000","1.3554","5843.09","70618.77"
"77.197.210.48","10975","41.177.26.176","80","25","16040","11","1052","14","14988","67.263994000","1.3539","6216.24","88563.63"
"244.3.160.239","61769","197.154.128.197","80","60","52091","23","2198","37","49893","74.389836000","1.3537","12990.02","294863.91"
"15.186.110.142","37340","41.177.26.176","80","31","13392","15","1568","16","11824","16.175706000","1.3530","9271.37","69913.72"
"77.197.128.127","51727","41.177.26.15","80","173","166906","57","3951","116","162955","190.977332000","1.3521","23376.40","964135.92"
"77.197.128.13","60241","41.177.26.176","80","26","12246","11","992","15","11254","201.948992000","1.3473","5890.24","66823.37"
"77.197.210.82","37823","41.177.26.176","80","29","14252","12","1080","17","13172","133.161329000","1.3453","6422.42","78329.75"
"77.197.210.80","39565","41.177.26.176","80","24","12627","9","915","15","11712","63.759957000","1.3435","5448.27","69737.84"
"77.197.128.41","14189","41.177.26.176","80","29","14766","12","1074","17","13692","201.219587000","1.3369","6426.89","81933.93"
"244.3.160.239","62192","244.176.48.167","80","10","2168","6","1539","4","629","122.081920000","1.3357","9217.60","3767.30"
"77.197.210.128","36413","41.177.26.176","80","21","11848","7","785","14","11063","51.691683000","1.3346","4705.39","66313.01"
"77.197.210.122","20349","41.177.26.176","80","24","13763","11","1017","13","12746","7.377140000","1.3332","6102.77","76485.66"
"16.176.93.164","12975","244.3.160.239","80","86","59354","31","3141","55","56213","41.366698000","1.3265","18942.97","339013.41"
"77.197.217.218","59849","41.177.26.176","80","24","12138","9","885","15","11253","77.570044000","1.3246","5344.96","67962.49"
"77.197.128.13","39140","41.177.26.176","80","27","14686","12","1147","15","13539","121.936932000","1.3240","6930.47","81806.09"
"77.197.128.251","45680","41.177.26.176","80","24","12107","9","903","15","11204","28.861480000","1.3238","5456.82","67705.71"
"16.176.93.164","14146","244.3.160.239","80","34","19300","14","2078","20","17222","76.288244000","1.3197","12597.24","104403.12"
"77.197.128.225","64235","41.177.26.176","80","25","12263","10","976","15","11287","196.996991000","1.3125","5948.82","68795.43"
"77.197.210.181","35290","41.177.26.15","80","199","188120","68","4655","131","183465","13.309640000","1.3115","28396.05","1119158.18"
"41.177.223.45","15972","244.3.160.239","80","16","5751","7","1040","9","4711","6.885801000","1.3113","6344.73","28740.40"
"41.177.176.156","12550","244.3.160.239","80","70","42908","26","2978","44","39930","148.008678000","1.3110","18172.39","243661.33"
"77.197.210.82","39959","41.177.26.176","80","28","13744","11","1034","17","12710","136.672429000","1.3080","6324.15","77736.88"
"77.197.210.48","64890","41.177.26.176","80","25","12054","10","965","15","11089","51.830236000","1.3067","5907.82","67887.87"
"68.33.110.176","15414","244.3.160.239","80","86","71297","19","4443","67","66854","117.665483000","1.3061","27214.45","409496.88"
"168.117.3.145","7025","244.3.160.239","80","70","45659","25","2626","45","43033","43.080924000","1.3019","16136.55","264434.22"
"40.138.160.255","7312","244.3.160.239","80","22","12538","10","1808","12","10730","20.603558000","1.3002","11124.13","66018.78"
"16.176.93.164","13270","244.3.160.239","80","16","4665","8","2579","8","2086","43.828979000","1.2945","15938.00","12891.30"
"41.177.176.156","14418","244.3.160.239","80","28","14820","11","1856","17","12964","100.717379000","1.2922","11490.80","80262.26"
"203.22.57.22","1371","244.3.41.84","23","8","1822","5","343","3","1479","180.421030000","1.2882","2130.04","9184.64"
"16.176.93.164","14680","244.3.160.239","80","38","23021","15","2217","23","20804","76.290493000","1.2849","13803.92","129533.99"
"77.197.128.41","62381","41.177.26.176","80","22","11814","9","885","13","10929","176.595819000","1.2838","5515.08","68106.51"
"244.3.160.239","61400","244.3.31.75","80","235","231233","82","6061","153","225172","25.029646000","1.2814","37841.07","1405832.40"
"244.3.181.123","4914","244.3.160.239","80","194","184241","70","12539","124","171702","120.617063000","1.2796","78393.98","1073483.03"
"77.197.210.198","37204","41.177.26.176","80","24","11342","9","901","15","10441","39.354240000","1.2796","5633.20","65278.79"
"77.197.128.92","16820","41.177.26.176","80","27","11938","11","1029","16","10909","210.670804000","1.2794","6434.30","68213.60"
"77.197.128.142","27456","41.177.26.15","80","127","120708","42","2991","85","117717","116.028644000","1.2794","18703.17","736102.18"
"77.197.128.106","46723","41.177.26.15","80","219","217190","68","4656","151","212534","3.698483000","1.2779","29147.98","1330527.67"
"244.3.160.239","61950","128.71.90.164","80","15","5825","8","1435","7","4390","101.936998000","1.2770","8990.08","27502.75"
"244.3.160.239","61567","85.224.40.142","80","12","2811","7","873","5","1938","47.430228000","1.2751","5477.20","12159.02"
"77.197.128.18","36883","41.177.26.176","80","24","11758","10","950","14","10808","210.563860000","1.2749","5961.24","67820.11"
"244.3.160.239","62162","244.3.31.108","80","82","70372","32","5155","50","65217","117.684777000","1.2719","32424.62","410210.77"
"40.138.160.255","15740","244.3.160.239","80","22","12240","10","1792","12","10448","218.318904000","1.2702","11286.24","65802.83"
"18.132.77.186","13875","244.3.160.239","80","188","140602","64","4944","124","135658","53.309936000","1.2698","31148.21","854673.18"
"77.197.210.128","49369","41.177.26.15","80","149","137181","53","3695","96","133486","101.987397000","1.2666","23338.60","843133.15"
"151.77.185.176","4500","244.3.160.239","80","72","47504","26","2732","46","44772","37.680726000","1.2644","17286.00","283282.82"
"77.197.128.55","4259","41.177.26.176","80","29","14718","12","1102","17","13616","123.301263000","1.2606","6993.29","86407.11"
"77.197.210.186","33266","41.177.26.15","80","215","202056","74","5040","141","197016","70.381199000","1.2587","32031.90","1252142.41"
"77.197.210.198","25485","41.177.26.176","80","23","12908","10","944","13","11964","7.377461000","1.2584","6001.25","76058.18"
"77.197.128.251","41363","41.177.26.176","80","25","11976","10","969","15","11007","15.992197000","1.2580","6162.32","69998.60"
"47.3.161.202","2591","244.3.41.84","23","8","1480","5","332","3","1148","223.046433000","1.2574","2112.25","7303.81"
"77.197.128.41","55368","41.177.26.176","80","21","12771","9","889","12","11882","157.326749000","1.2573","5656.75","75605.80"
"244.3.160.239","61497","244.3.31.75","80","243","239983","85","6118","158","233865","40.197499000","1.2567","38946.35","1488752.71"
"77.197.128.41","25819","41.177.26.176","80","25","11982","10","965","15","11017","232.456657000","1.2560","6146.60","70173.15"
"77.197.210.80","40101","41.177.26.176","80","21","13367","9","889","12","12478","67.403259000","1.2538","5672.52","79619.45"
"77.197.217.20","56868","41.177.26.176","80","29","14811","12","1109","17","13702","71.988079000","1.2517","7087.72","87570.69"
"77.197.210.198","50161","41.177.26.176","80","24","12481","9","912","15","11569","66.230194000","1.2514","5830.11","73956.70"
"77.197.128.12","38776","41.177.26.176","80","23","11715","9","902","14","10813","36.517874000","1.2513","5766.64","69129.31"
"77.197.128.180","1943","41.177.26.176","80","25","11592","10","976","15","10616","73.024772000","1.2512","6240.36","67876.70"
"15.186.110.142","51530","41.177.26.176","80","28","13020","14","1495","14","11525","209.000870000","1.2498","9569.84","73774.16"
"253.160.251.90","1349","253.37.253.43","446","414","574921","0","0","414","574921","34.523487000","1.2493","N/A","3681671.00"
"244.3.160.239","61509","85.224.40.142","80","10","1545","6","809","4","736","43.820035000","1.2482","5185.04","4717.17"
"77.197.210.128","40277","41.177.26.176","80","21","12484","8","849","13","11635","60.559725000","1.2477","5443.47","74599.23"
"77.197.210.67","17293","41.177.26.176","80","19","11520","6","712","13","10808","53.775937000","1.2476","4565.70","69306.38"
"77.197.128.18","25552","41.177.26.176","80","29","14825","12","1098","17","13727","184.355492000","1.2466","7046.27","88091.21"
"77.197.128.18","64193","41.177.26.176","80","29","14946","12","1096","17","13850","148.391213000","1.2458","7038.08","88939.26"
"77.197.210.128","41835","41.177.26.176","80","22","11693","8","814","14","10879","64.854188000","1.2448","5231.38","69916.73"
"168.117.3.145","10125","244.3.160.239","80","67","46469","24","2562","43","43907","192.463262000","1.2442","16473.32","282316.10"
"77.197.128.18","28680","41.177.26.176","80","24","12403","9","914","15","11489","139.082373000","1.2427","5884.07","73962.84"
"77.197.210.224","7750","41.177.26.15","80","128","105494","54","3927","74","101567","160.282646000","1.2416","25303.16","654434.98"
"15.186.110.142","43051","41.177.26.176","80","32","13563","15","1597","17","11966","93.083787000","1.2409","10295.83","77144.57"
"244.3.160.239","62248","40.248.176.156","80","15","4865","8","2041","7","2824","135.023364000","1.2393","13175.22","18229.70"
"77.197.128.108","3129","41.177.26.176","80","22","12175","9","924","13","11251","219.907426000","1.2380","5970.82","72703.19"
"77.197.128.12","33290","41.177.26.176","80","25","11691","10","939","15","10752","25.634460000","1.2370","6072.62","69534.46"
"77.197.210.67","6135","41.177.26.176","80","25","11632","10","936","15","10696","39.484872000","1.2325","6075.35","69425.13"
"244.3.160.239","62426","94.2.202.203","80","11","2177","6","1174","5","1003","164.479160000","1.2321","7622.56","6512.29"
"77.197.128.139","60639","41.177.26.176","80","25","12353","10","968","15","11385","31.158307000","1.2286","6303.01","74132.01"
"68.33.110.176","9029","244.3.160.239","80","10","2156","5","1102","5","1054","164.455743000","1.2279","7180.01","6867.27"
"244.3.160.239","61508","122.248.218.117","80","50","43300","19","2314","31","40986","43.154782000","1.2274","15082.30","267140.51"
"77.197.128.41","54982","41.177.26.176","80","25","12391","10","929","15","11462","155.072445000","1.2253","6065.45","74835.49"
"77.197.210.128","18112","41.177.26.176","80","21","12970","9","880","12","12090","7.196456000","1.2236","5753.39","79043.70"
"77.197.128.13","3111","41.177.26.176","80","25","12548","10","976","15","11572","232.006820000","1.2229","6384.82","75701.96"
"77.197.210.128","38900","41.177.26.176","80","27","14877","10","983","17","13894","56.696713000","1.2222","6434.20","90942.79"
"244.3.210.255","3290","68.83.160.23","1984","6","390","3","198","3","192","80.432965000","1.2210","1297.28","1257.97"
"16.176.93.164","13068","244.3.160.239","80","26","17897","11","1731","15","16166","78.486852000","1.2181","11368.06","106167.55"
"41.177.244.188","54415","244.3.210.197","80","4","280","2","140","2","140","1.950133000","1.2138","922.75","922.75"
"77.197.128.41","3929","41.177.26.176","80","25","11990","10","966","15","11024","187.547898000","1.2136","6367.88","72670.34"
"77.197.128.18","37755","41.177.26.176","80","24","14718","10","1012","14","13706","214.199778000","1.2128","6675.41","90408.30"
"15.186.110.142","46269","41.177.26.176","80","32","12506","16","1629","16","10877","136.669101000","1.2128","10745.50","71748.79"
"15.186.110.142","48638","41.177.26.176","80","28","12511","13","1415","15","11096","168.834783000","1.2109","9348.55","73308.49"
"41.177.176.156","8369","244.3.160.239","80","14","3808","7","1886","7","1922","119.873831000","1.2097","12472.65","12710.73"
"77.197.128.225","6128","41.177.26.15","80","169","164455","54","3759","115","160696","70.994782000","1.2093","24867.90","1063094.26"
"186.136.103.68","10753","244.3.160.239","80","13","1974","7","1387","6","587","73.983934000","1.2088","9179.04","3884.71"
"16.176.93.164","16360","244.3.160.239","80","13","4232","6","1500","7","2732","117.414600000","1.2087","9927.84","18081.91"
"77.197.128.223","4277","41.177.26.176","80","25","12495","10","982","15","11513","175.045257000","1.2084","6501.38","76222.44"
"77.197.210.128","42148","41.177.26.176","80","41","31269","18","1727","23","29542","67.088526000","1.2076","11440.69","195704.11"
"77.197.128.127","59201","41.177.26.15","80","160","154615","52","3631","108","150984","200.975834000","1.2066","24074.58","1001067.48"
"15.186.110.142","51182","41.177.26.176","80","30","12339","14","1491","16","10848","204.054013000","1.2043","9904.75","72063.51"
"77.197.128.18","17763","41.177.26.176","80","22","12204","9","907","13","11297","173.525917000","1.2040","6026.37","75060.57"
"15.186.110.142","49612","41.177.26.176","80","32","12380","16","1595","16","10785","182.367834000","1.2026","10609.95","71741.87"
"77.197.210.198","27757","41.177.26.15","80","139","131868","47","3311","92","128557","11.345511000","1.2024","22029.75","855354.49"
"77.197.128.18","33590","41.177.26.176","80","20","12588","8","816","12","11772","157.235435000","1.2020","5430.74","78346.42"
"15.186.110.142","47875","41.177.26.176","80","24","12242","12","1345","12","10897","158.376998000","1.1999","8967.37","72652.36"
"41.177.92.61","2157","41.177.98.176","80","31","23276","12","1902","19","21374","229.170758000","1.1990","12690.24","142608.37"
"77.197.128.84","39615","41.177.26.176","80","31","17537","13","1168","18","16369","184.600637000","1.1942","7824.43","109655.85"
"77.197.128.118","45858","41.177.26.176","80","25","12044","10","944","15","11100","153.982769000","1.1918","6336.70","74509.90"
"253.160.251.79","2768","253.37.253.43","446","389","539689","0","0","389","539689","167.199181000","1.1908","N/A","3625860.90"
"77.197.210.48","7932","41.177.26.176","80","23","13191","9","903","14","12288","66.033234000","1.1849","6096.73","82964.17"
"244.3.160.239","61881","176.41.89.121","80","14","5964","8","1529","6","4435","92.712641000","1.1847","10325.36","29949.62"
"77.197.128.251","61744","41.177.26.176","80","21","12077","9","897","12","11180","64.185832000","1.1835","6063.21","75570.41"
"41.177.199.139","12636","244.3.160.239","80","12","4084","6","1718","6","2366","135.020482000","1.1798","11649.82","16043.93"
"41.177.176.156","5816","244.3.160.239","80","10","2583","5","1466","5","1117","149.486740000","1.1792","9945.58","7577.91"
"77.197.210.67","20222","41.177.26.176","80","20","12720","8","812","12","11908","67.540317000","1.1768","5520.16","80953.32"
"77.197.210.249","15821","41.177.26.176","80","25","12139","10","940","15","11199","61.307797000","1.1735","6408.09","76344.87"
"244.3.160.239","61478","197.154.128.197","80","55","45573","21","2151","34","43422","37.684291000","1.1713","14691.24","296570.51"
"244.3.160.248","49705","41.177.26.193","80","65","56129","24","3445","41","52684","199.691045000","1.1697","23561.25","360319.63"
"77.197.128.251","63804","41.177.26.176","80","22","13378","10","943","12","12435","69.434997000","1.1682","6457.95","85158.69"
"77.197.217.20","61252","41.177.26.176","80","25","12830","10","974","15","11856","87.972829000","1.1653","6686.66","81393.21"
"77.197.128.142","18865","41.177.26.15","80","160","152860","53","3695","107","149165","102.374670000","1.1651","25372.28","1024264.17"
"77.197.128.127","59954","41.177.26.15","80","160","153469","53","3695","107","149774","202.350668000","1.1648","25378.71","1028706.44"
"77.197.210.2","33264","41.177.26.15","80","172","164341","57","3950","115","160391","41.666613000","1.1644","27137.39","1101922.38"
"77.197.128.84","38706","41.177.26.176","80","24","11978","10","939","14","11039","178.736487000","1.1621","6463.97","75991.17"
"90.218.241.186","39678","244.3.210.197","80","62","43820","28","10461","34","33359","51.877952000","1.1618","72035.04","229711.96"
"77.197.217.218","51929","41.177.26.15","80","155","147876","52","3631","103","144245","207.741544000","1.1617","25004.67","993334.79"
"244.3.181.123","10119","244.3.160.239","80","28","13943","12","2026","16","11917","120.617580000","1.1615","13954.60","82081.41"
"68.33.110.176","5436","244.3.160.239","80","61","47487","15","4201","46","43286","187.617431000","1.1605","28959.38","298389.86"
"77.197.128.55","64039","41.177.26.176","80","24","12937","10","980","14","11957","112.478130000","1.1569","6776.48","82679.96"
"242.161.82.241","50693","244.3.210.197","80","40","35432","14","1533","26","33899","6.616648000","1.1559","10609.80","234613.02"
"77.197.217.224","63256","41.177.26.176","80","19","11625","8","785","11","10840","81.829948000","1.1547","5438.67","75102.15"
"77.197.210.108","34222","41.177.26.15","80","109","100287","39","2858","70","97429","10.709300000","1.1511","19862.03","677095.16"
"41.177.176.198","1293","41.177.98.176","80","38","27512","15","3047","23","24465","230.702005000","1.1507","21182.82","170081.27"
"77.197.217.224","64512","41.177.26.176","80","20","11768","7","752","13","11016","86.559618000","1.1493","5234.51","76680.05"
"77.197.210.2","51968","41.177.26.176","80","24","14368","10","1034","14","13334","85.410793000","1.1488","7200.58","92855.48"
"244.3.160.239","61865","188.68.214.108","80","11","2498","6","1319","5","1179","88.115569000","1.1483","9189.25","8213.90"
"77.197.210.71","29911","41.177.26.15","80","144","133047","51","3567","93","129480","71.662439000","1.1472","24874.63","902934.38"
"77.197.210.80","37745","41.177.26.176","80","25","12851","10","972","15","11879","59.043348000","1.1464","6782.72","82892.91"
"244.3.160.239","62758","198.123.241.156","80","80","71378","30","2676","50","68702","227.869702000","1.1449","18699.16","480071.00"
"77.197.128.165","24560","41.177.26.15","80","192","186828","62","4272","130","182556","228.450672000","1.1447","29856.14","1275846.98"
"68.33.110.176","10200","244.3.160.239","80","290","255794","57","4575","233","251219","25.740453000","1.1430","32019.68","1758240.91"
"244.3.160.239","62024","81.67.210.26","80","13","3539","7","1637","6","1902","107.529913000","1.1410","11477.19","13335.13"
"41.177.176.156","8080","244.3.160.239","80","12","2760","6","1308","6","1452","115.078854000","1.1402","9177.44","10187.80"
"77.197.128.13","44226","41.177.26.176","80","26","12093","11","1027","15","11066","137.917374000","1.1398","7208.54","77672.56"
"40.138.160.255","15020","244.3.160.239","80","13","2636","7","2080","6","556","22.543394000","1.1394","14603.96","3903.75"
"77.197.210.231","49557","41.177.26.91","80","46","43714","16","1272","30","42442","139.978506000","1.1387","8936.33","298172.60"
"68.33.110.176","3455","244.3.160.239","80","290","255634","57","4415","233","251219","30.887605000","1.1383","31029.49","1765616.65"
"77.197.128.180","60059","41.177.26.176","80","25","12208","10","973","15","11235","52.033125000","1.1379","6840.83","78989.41"
"41.177.230.253","44031","244.3.31.40","22","90","42281","43","14998","47","27283","156.674999000","1.1367","105551.80","192010.25"
"77.197.128.139","60288","41.177.26.176","80","24","12335","10","969","14","11366","29.345083000","1.1366","6820.07","79996.76"
"244.3.160.239","62507","244.3.31.108","80","57","46533","23","4593","34","41940","187.630415000","1.1346","32385.61","295722.29"
"122.188.116.253","21235","244.3.210.197","80","30","23348","13","2229","17","21119","125.389767000","1.1338","15727.00","149007.89"
"77.197.217.224","47293","41.177.26.15","80","136","127575","47","3311","89","124264","192.842692000","1.1337","23364.89","876899.48"
"77.197.210.186","46991","41.177.26.91","80","36","30871","13","1108","23","29763","103.460170000","1.1307","7839.41","210581.61"
"244.3.160.239","62525","122.248.218.117","80","50","44296","19","2314","31","41982","192.538373000","1.1303","16377.27","297126.46"
"90.38.138.255","9120","244.3.160.239","80","96","72242","23","2187","73","70055","227.843600000","1.1298","15486.30","496064.25"
"77.197.210.56","43117","41.177.26.15","80","94","93278","28","2095","66","91183","11.402623000","1.1298","14835.13","645685.64"
"15.186.110.132","48030","41.177.26.91","80","47","37205","20","1880","27","35325","89.933150000","1.1275","13339.31","250644.13"
"77.197.217.218","62761","41.177.26.176","80","25","13223","10","984","15","12239","93.913748000","1.1249","6997.81","87038.85"
"77.197.217.20","37380","41.177.26.176","80","24","11865","9","873","15","10992","27.395046000","1.1247","6209.60","78185.49"
"77.197.128.12","29182","41.177.26.176","80","25","12207","10","963","15","11244","17.311657000","1.1243","6852.25","80006.90"
"77.197.210.2","56319","41.177.26.176","80","23","12894","10","953","13","11941","97.637063000","1.1243","6781.28","84968.76"
"77.197.217.218","63062","41.177.26.176","80","23","13794","10","990","13","12804","97.365554000","1.1240","7046.55","91135.32"
"77.197.128.139","24890","41.177.26.176","80","25","11929","10","963","15","10966","82.887935000","1.1236","6856.48","78077.05"
"77.197.128.139","37070","41.177.26.15","80","128","119808","44","3118","84","116690","110.271266000","1.1232","22206.99","831088.36"
"68.159.161.120","35976","41.177.26.176","80","37","15495","18","1486","19","14009","63.312335000","1.1221","10594.60","99878.71"
"77.197.128.254","35625","41.177.26.176","80","23","12581","9","909","14","11672","19.475399000","1.1200","6493.14","83375.08"
"77.197.210.159","34378","41.177.26.176","80","18","12460","7","761","11","11699","97.609961000","1.1197","5437.31","83588.77"
"77.197.128.13","33212","41.177.26.176","80","21","12875","9","880","12","11995","102.452391000","1.1190","6291.42","85756.29"
"77.197.128.47","19854","41.177.26.176","80","24","11612","9","899","15","10713","122.840729000","1.1183","6431.06","76636.25"
"68.33.110.176","4256","244.3.160.239","80","292","255762","59","4543","233","251219","36.027996000","1.1178","32513.75","1797946.69"
"77.197.128.41","6481","41.177.26.176","80","18","11011","7","814","11","10197","191.570656000","1.1174","5828.03","73007.87"
"77.197.128.84","34925","41.177.26.176","80","25","12424","10","974","15","11450","165.599193000","1.1173","6973.70","81980.34"
"41.177.176.156","2132","244.3.160.239","80","12","3123","6","1556","6","1567","115.125422000","1.1172","11142.45","11221.22"
"77.197.128.55","26175","41.177.26.176","80","27","13382","11","1048","16","12334","185.209245000","1.1154","7516.86","88466.58"
"77.197.128.31","63530","41.177.26.176","80","29","14780","12","1094","17","13686","25.020997000","1.1153","7847.28","98169.89"
"77.197.128.223","16110","41.177.26.176","80","25","12312","10","963","15","11349","201.949447000","1.1136","6917.94","81528.20"
"77.197.210.181","62250","41.177.26.15","80","130","123017","44","3119","86","119898","71.725248000","1.1131","22417.34","861748.66"
"41.177.3.215","35745","41.177.3.224","30383","14","2442","8","1385","6","1057","214.063855000","1.1108","9975.22","7612.85"
"244.3.160.239","61445","244.3.31.75","80","242","239920","84","6054","158","233866","30.903950000","1.1107","43603.72","1684411.44"
"77.197.210.2","46848","41.177.26.176","80","21","14071","9","960","12","13111","73.867084000","1.1107","6914.70","94436.01"
"41.177.176.156","2114","244.3.160.239","80","10","2777","5","1300","5","1477","108.966550000","1.1104","9365.77","10640.96"
"77.197.210.122","19857","41.177.26.176","80","23","12001","9","913","14","11088","2.924957000","1.1094","6583.77","79957.17"
"41.177.135.193","6349","244.3.160.239","80","12","3551","6","1628","6","1923","107.526109000","1.1076","11758.31","13888.96"
"77.197.128.251","17516","41.177.26.176","80","20","12838","9","889","11","11949","96.255854000","1.1070","6424.77","86355.03"
"244.3.160.239","61406","244.3.31.75","80","242","240055","84","6189","158","233866","25.763755000","1.1066","44743.95","1690755.97"
"244.3.160.239","61260","128.71.90.164","80","23","14550","10","1483","13","13067","1.884070000","1.1064","10722.91","94481.64"
"77.197.210.2","55009","41.177.26.176","80","25","14523","10","1018","15","13505","92.778560000","1.1059","7364.00","97692.42"
"77.197.210.82","41663","41.177.26.176","80","23","11948","8","835","15","11113","140.115462000","1.1048","6046.15","80468.05"
"77.197.128.225","5067","41.177.26.176","80","25","12179","10","963","15","11216","203.821631000","1.1012","6995.69","81478.32"
"244.3.210.255","3279","68.83.160.23","1984","6","390","3","198","3","192","33.850039000","1.1007","1439.13","1395.52"
"77.197.128.176","28617","41.177.26.176","80","24","12235","9","897","15","11338","30.955813000","1.0987","6531.62","82559.05"
"77.197.128.139","61655","41.177.26.176","80","25","12634","10","976","15","11658","37.524340000","1.0975","7114.45","84979.83"
"77.197.217.20","35350","41.177.26.176","80","22","13418","9","943","13","12475","20.077151000","1.0974","6874.12","90938.08"
"77.197.106.128","59647","41.177.26.91","80","45","40758","17","1406","28","39352","3.830890000","1.0965","10258.29","287115.39"
"77.197.128.108","48888","41.177.26.176","80","25","12225","10","980","15","11245","105.876740000","1.0963","7151.15","82055.81"
"151.77.192.83","13782","244.3.160.239","80","15","5239","7","941","8","4298","114.063890000","1.0959","6869.02","31374.12"
"151.77.192.83","4835","244.3.160.239","80","15","5106","7","942","8","4164","44.611416000","1.0937","6890.17","30457.19"
"244.3.210.98","2794","68.83.160.23","1984","6","390","3","198","3","192","150.019662000","1.0935","1448.54","1404.65"
"77.197.128.225","13726","41.177.26.176","80","25","11972","10","961","15","11011","215.605356000","1.0934","7031.38","80564.49"
"77.197.210.186","3748","41.177.26.176","80","22","10878","8","815","14","10063","3.219666000","1.0934","5963.27","73629.98"
"244.3.160.239","61471","244.3.31.75","80","242","239920","84","6054","158","233866","36.043531000","1.0920","44352.95","1713354.24"
"77.197.128.251","65167","41.177.26.15","80","126","114189","46","3247","80","110942","224.741379000","1.0903","23824.85","814036.63"
"77.197.210.111","21261","41.177.26.15","80","152","150611","46","3247","106","147364","220.414917000","1.0899","23833.77","1081687.74"
"77.197.128.180","59442","41.177.26.176","80","25","12026","10","969","15","11057","50.265000000","1.0893","7116.73","81207.05"
"77.197.128.139","57417","41.177.26.176","80","25","12443","10","975","15","11468","18.767705000","1.0892","7161.36","84232.25"
"77.197.210.231","43042","244.3.210.197","80","27","20309","12","1120","15","19189","129.775165000","1.0863","8248.18","141316.40"
"15.186.110.142","46474","41.177.26.176","80","28","12711","14","1503","14","11208","139.283688000","1.0862","11070.07","82550.46"
"244.3.160.239","62636","177.124.75.164","80","112","98687","41","4425","71","94262","209.138724000","1.0860","32596.47","694374.90"
"77.197.128.223","20443","41.177.26.176","80","21","13689","9","946","12","12743","212.829114000","1.0852","6973.89","93941.07"
"253.160.251.85","44719","253.37.253.43","446","340","468797","0","0","340","468797","51.134706000","1.0842","N/A","3459041.67"
"77.197.128.13","55470","41.177.26.176","80","23","12783","10","940","13","11843","186.558054000","1.0828","6945.00","87499.64"
"77.197.217.224","35071","41.177.26.176","80","25","12583","10","965","15","11618","16.636569000","1.0814","7138.77","85946.34"
"15.128.184.13","54593","41.177.26.176","80","29","13202","14","1670","15","11532","1.386606000","1.0795","12376.18","85462.34"
"244.3.210.255","3274","68.83.160.23","1984","6","390","3","198","3","192","9.465282000","1.0792","1467.73","1423.25"
"77.197.210.110","1405","41.177.26.15","80","129","135060","34","2478","95","132582","41.524496000","1.0787","18377.74","983276.10"
"77.197.210.186","32966","41.177.26.176","80","22","13127","10","949","12","12178","57.841352000","1.0763","7053.64","90515.58"
"77.197.128.18","60025","41.177.26.176","80","30","15310","12","1094","18","14216","139.085793000","1.0729","8157.02","105996.51"
"244.3.160.239","62630","30.222.71.108","80","42","35752","17","2387","25","33365","208.055216000","1.0692","17860.70","249653.23"
"18.132.77.186","14848","244.3.160.239","80","18","13978","6","1311","12","12667","209.069780000","1.0691","9809.96","94784.76"
"77.197.128.209","60433","41.177.26.15","80","44","38529","16","1327","28","37202","81.281450000","1.0684","9936.16","278556.86"
"244.3.210.98","2791","68.83.160.23","1984","6","390","3","198","3","192","57.968145000","1.0674","1483.98","1439.01"
"77.197.128.225","14804","41.177.26.176","80","23","12914","11","1017","12","11897","217.636301000","1.0673","7623.26","89177.89"
"77.197.128.180","57496","41.177.26.176","80","22","11169","9","900","13","10269","43.929125000","1.0669","6748.33","76998.49"
"186.136.103.68","16099","244.3.160.239","80","13","1968","7","1380","6","588","77.761396000","1.0659","10357.08","4413.02"
"77.197.210.181","51755","41.177.26.15","80","109","105382","35","2543","74","102839","202.738527000","1.0655","19093.13","772126.88"
"244.41.38.43","54569","41.177.98.127","210","8","745","3","338","5","407","0.157267000","1.0639","2541.66","3060.52"
"15.186.110.142","40659","41.177.26.176","80","31","13357","15","1567","16","11790","59.962914000","1.0638","11783.86","88660.95"
"244.3.160.239","61382","198.123.241.156","80","40","32097","16","2107","24","29990","21.128240000","1.0630","15857.40","225706.37"
"77.197.128.13","41409","41.177.26.176","80","21","11666","8","835","13","10831","130.091410000","1.0601","6301.55","81739.00"
"244.3.160.239","61367","41.43.180.128","80","95","86995","36","3501","59","83494","16.912753000","1.0593","26439.78","630552.07"
"77.197.128.41","15612","41.177.26.176","80","24","12134","9","899","15","11235","204.901169000","1.0583","6795.55","84925.53"
"244.3.160.239","61612","177.124.75.164","80","152","138381","54","5370","98","133011","53.376597000","1.0554","40703.25","1008189.92"
"15.186.110.142","48277","41.177.26.176","80","27","12587","13","1426","14","11161","164.150216000","1.0516","10848.26","84907.05"
"186.136.103.68","2967","244.3.160.239","80","13","1971","7","1383","6","588","77.849368000","1.0501","10536.51","4479.73"
"77.197.128.139","60914","41.177.26.176","80","20","10930","8","878","12","10052","32.596992000","1.0500","6689.43","76585.65"
"77.197.217.20","61951","41.177.26.176","80","25","12096","10","987","15","11109","93.856086000","1.0485","7530.80","84761.57"
"77.197.128.41","1819","41.177.26.176","80","25","11772","10","945","15","10827","185.527303000","1.0481","7213.16","82642.23"
"41.177.176.156","16261","244.3.160.239","80","30","17571","12","1922","18","15649","111.739166000","1.0481","14671.03","119452.09"
"41.177.176.156","5173","244.3.160.239","80","12","2762","6","1530","6","1232","117.304114000","1.0475","11685.44","9409.46"
"77.197.128.224","5929","41.177.26.176","80","21","12625","8","853","13","11772","172.781011000","1.0474","6515.20","89914.33"
"77.197.210.67","14690","41.177.26.176","80","24","12140","9","899","15","11241","47.418348000","1.0462","6874.47","85957.62"
"77.197.210.153","45790","41.177.26.15","80","138","127037","49","3439","89","123598","41.481559000","1.0455","26314.38","945741.42"
"77.197.128.92","17624","41.177.26.176","80","23","12419","9","911","14","11508","213.632430000","1.0450","6974.00","88097.50"
"77.197.210.82","46191","41.177.26.176","80","22","12121","8","846","14","11275","159.082494000","1.0442","6481.46","86381.17"
"253.160.251.79","2798","253.37.253.43","446","228","310378","0","0","228","310378","202.242931000","1.0441","N/A","2378186.41"
"244.3.160.239","61364","128.71.90.164","80","113","108214","41","4120","72","104094","16.440385000","1.0438","31575.78","797778.97"
"15.186.110.142","37444","41.177.26.176","80","29","12269","14","1491","15","10778","17.403074000","1.0416","11451.13","82776.84"
"253.160.251.85","44734","253.37.253.43","446","439","610735","0","0","439","610735","52.955917000","1.0408","N/A","4694251.27"
"16.176.93.164","13522","244.3.160.239","443","18","5653","8","1975","10","3678","119.618640000","1.0355","15257.78","28414.24"
"77.197.128.108","57072","41.177.26.176","80","25","14698","10","1023","15","13675","160.231566000","1.0342","7913.14","105779.28"
"15.186.110.142","49950","41.177.26.176","80","31","13475","15","1571","16","11904","186.953193000","1.0334","12161.68","92153.16"
"186.136.103.68","15501","244.3.160.239","80","13","1958","7","1370","6","588","77.848237000","1.0321","10619.27","4557.76"
"244.3.160.239","61907","244.176.48.167","80","36","27366","15","1730","21","25636","97.489632000","1.0315","13417.54","198827.71"
"46.194.188.194","49439","244.3.210.197","80","8","4220","4","1250","4","2970","71.939627000","1.0302","9706.54","23062.74"
"77.197.210.198","41803","41.177.26.176","80","22","12037","9","910","13","11127","46.604830000","1.0290","7074.99","86509.22"
"77.197.210.198","48838","41.177.26.176","80","25","12021","10","974","15","11047","63.286953000","1.0256","7597.70","86172.32"
"254.51.75.100","50263","244.3.210.197","80","28","19010","12","2420","16","16590","32.882886000","1.0248","18891.25","129506.55"
"244.3.210.230","3397","68.83.160.23","1984","6","390","3","198","3","192","50.358363000","1.0236","1547.43","1500.54"
"77.197.210.198","23877","41.177.26.176","80","23","11712","8","828","15","10884","0.468453000","1.0231","6474.55","85107.55"
"77.197.128.223","23160","41.177.26.176","80","20","12852","8","823","12","12029","217.345345000","1.0207","6450.21","94276.52"
"77.197.128.167","5052","41.177.26.176","80","23","11666","9","870","14","10796","34.251078000","1.0206","6819.66","84626.55"
"244.3.160.239","61330","176.41.89.121","80","16","6225","10","5480","6","745","8.253367000","1.0204","42964.26","5840.94"
"41.177.211.185","3421","244.3.160.239","80","251","186906","84","6677","167","180229","176.915595000","1.0182","52462.29","1416088.92"
"41.177.176.156","13350","244.3.160.239","80","17","7634","8","2788","9","4846","111.731117000","1.0172","21926.34","38111.57"
"77.197.128.13","46993","41.177.26.176","80","24","12407","10","983","14","11424","149.634199000","1.0172","7731.06","89847.08"
"77.197.210.82","5278","244.3.210.197","80","29","21031","13","1084","16","19947","39.353211000","1.0163","8532.97","157017.71"
"244.3.210.98","2796","68.83.160.23","1984","6","390","3","198","3","192","160.392247000","1.0156","1559.68","1512.42"
"77.197.128.92","15435","41.177.26.176","80","23","11849","9","885","14","10964","205.557191000","1.0145","6978.86","86458.95"
"92.244.186.20","55247","41.177.26.15","80","21","17518","7","925","14","16593","81.813504000","1.0144","7294.87","130858.07"
"77.197.210.123","57620","41.177.26.176","80","25","12705","10","982","15","11723","65.244062000","1.0144","7744.53","92453.32"
"77.197.128.18","31659","41.177.26.176","80","23","11447","9","919","14","10528","146.436804000","1.0117","7267.07","83251.05"
"145.219.142.106","51670","41.177.26.176","80","91","56718","27","6867","64","49851","219.313223000","1.0098","54404.04","394946.22"
"77.197.128.13","53456","41.177.26.176","80","22","12776","10","943","12","11833","174.308023000","1.0082","7482.48","93892.02"
"77.197.210.82","57442","41.177.26.176","80","21","13042","9","880","12","12162","179.881410000","1.0070","6990.88","96617.17"
"16.176.93.164","2183","244.3.160.239","80","16","4753","8","2623","8","2130","19.398436000","1.0062","20855.45","16935.61"
"77.197.128.165","23370","41.177.26.15","80","110","102800","38","2735","72","100065","226.240382000","1.0061","21747.43","795669.60"
"77.197.128.180","64044","41.177.26.176","80","22","11844","9","916","13","10928","68.288204000","1.0058","7285.56","86917.70"
"244.3.160.239","61261","128.71.90.164","80","14","5724","7","1290","7","4434","1.885100000","1.0053","10265.29","35283.94"
"77.197.128.223","63469","41.177.26.176","80","29","14947","12","1110","17","13837","169.397917000","1.0042","8842.62","110230.06"
"244.3.210.255","3296","68.83.160.23","1984","6","390","3","198","3","192","154.461780000","1.0039","1577.84","1530.03"
"77.197.128.118","26295","41.177.26.176","80","25","11875","10","955","15","10920","125.604523000","1.0032","7615.75","87082.73"
"77.197.128.223","59978","41.177.26.176","80","25","11983","10","974","15","11009","165.542340000","1.0026","7771.80","87843.69"
"77.197.128.150","19566","41.177.26.176","80","23","11529","9","919","14","10610","106.842884000","1.0011","7343.66","84783.69"
"41.177.93.39","1181","244.3.41.84","23","5","2106","2","149","3","1957","212.007989000","1.0001","1191.86","15654.17"
"15.186.110.142","49347","41.177.26.176","80","30","13081","14","1504","16","11577","178.464219000","0.9991","12043.32","92703.14"
"77.197.128.46","27781","41.177.26.176","80","25","11947","10","960","15","10987","145.667450000","0.9961","7709.81","88237.21"
"77.197.13.80","30741","41.177.26.176","80","42","36707","15","1227","27","35480","207.568966000","0.9941","9873.86","285513.11"
"77.197.128.118","40166","41.177.26.176","80","20","11196","8","805","12","10391","143.272326000","0.9930","6485.69","83717.71"
"244.3.210.230","3386","68.83.160.23","1984","6","390","3","198","3","192","4.415806000","0.9903","1599.56","1551.09"
"40.138.160.255","15023","244.3.160.239","80","11","2075","6","1589","5","486","3.233313000","0.9900","12840.51","3927.30"
"186.136.103.68","3267","244.3.160.239","80","13","1961","7","1373","6","588","77.920818000","0.9897","11098.51","4753.04"
"77.197.210.181","5944","41.177.26.15","80","96","91392","31","2287","65","89105","80.450957000","0.9887","18505.84","721015.60"
"77.197.128.92","61487","41.177.26.176","80","22","11738","9","910","13","10828","127.618010000","0.9887","7363.54","87618.03"
"244.3.210.98","2813","68.83.160.23","1984","6","390","3","198","3","192","218.704889000","0.9883","1602.73","1554.16"
"244.3.210.255","3284","68.83.160.23","1984","6","390","3","198","3","192","69.931963000","0.9874","1604.25","1555.64"
"253.160.251.90","1542","253.37.253.43","446","290","399005","0","0","290","399005","149.606913000","0.9869","N/A","3234476.33"
"77.197.210.224","20208","41.177.26.15","80","119","105513","45","3183","74","102330","69.787523000","0.9844","25866.32","831574.31"
"77.197.210.67","57911","41.177.26.176","80","24","12644","9","903","15","11741","0.274500000","0.9841","7340.78","95446.46"
"77.197.210.106","45798","41.177.26.15","80","37","30634","14","1199","23","29435","130.721572000","0.9776","9811.47","240867.98"
"244.3.160.239","61378","85.224.40.142","80","10","1357","6","923","4","434","20.402655000","0.9752","7571.43","3560.13"
"18.22.43.17","53554","41.177.26.15","80","105","91187","38","3872","67","87315","228.227456000","0.9740","31804.18","717195.78"
"244.3.210.98","2799","68.83.160.23","1984","6","390","3","198","3","192","182.862547000","0.9724","1628.88","1579.52"
"41.177.3.215","35438","41.177.3.224","30383","14","2442","8","1385","6","1057","93.754846000","0.9711","11409.22","8707.26"
"77.197.128.55","41269","41.177.26.15","80","14","9357","6","745","8","8612","214.858977000","0.9694","6148.03","71069.59"
"244.3.210.98","2797","68.83.160.23","1984","6","390","3","198","3","192","174.097451000","0.9694","1634.04","1584.53"
"244.3.160.239","62754","198.123.241.156","80","25","15757","11","1434","14","14323","226.733440000","0.9686","11843.37","118293.32"
"77.197.210.82","54720","41.177.26.176","80","21","12787","9","872","12","11915","174.272721000","0.9681","7205.79","98459.78"
"77.197.217.20","61139","41.177.26.176","80","20","12617","9","880","11","11737","86.939576000","0.9679","7273.34","97008.12"
"244.3.210.255","3281","68.83.160.23","1984","6","390","3","198","3","192","46.108744000","0.9665","1638.93","1589.27"
"77.197.210.2","38165","41.177.26.15","80","52","43949","20","1583","32","42366","50.235650000","0.9663","13105.00","350730.43"
"77.197.217.224","36779","41.177.26.176","80","19","12902","8","860","11","12042","20.330048000","0.9658","7123.59","99746.84"
"77.197.128.13","39491","41.177.26.176","80","22","12804","10","951","12","11853","123.711307000","0.9652","7881.93","98238.17"
"244.3.160.239","61358","41.43.180.128","80","68","61645","26","2893","42","58752","15.786575000","0.9618","24062.41","488667.46"
"77.197.128.209","55190","41.177.26.15","80","103","99081","33","2414","70","96667","70.129465000","0.9615","20085.78","804321.69"
"77.197.128.139","31826","41.177.26.15","80","125","118995","42","2991","83","116004","102.005047000","0.9589","24952.50","967766.56"
"77.197.217.224","54245","41.177.26.176","80","21","12641","9","916","12","11725","70.012852000","0.9589","7642.47","97825.32"
"244.3.160.254","61363","41.177.230.41","79","17","1583","9","584","8","999","16.396522000","0.9587","4873.33","8336.39"
"244.3.210.255","3295","68.83.160.23","1984","6","390","3","198","3","192","122.574389000","0.9537","1660.88","1610.55"
"244.3.160.239","61744","117.246.95.43","80","120","104975","43","3473","77","101502","67.559963000","0.9530","29154.83","852079.95"
"244.3.210.230","3408","68.83.160.23","1984","6","390","3","198","3","192","158.550537000","0.9527","1662.62","1612.23"
"244.3.210.230","3401","68.83.160.23","1984","6","390","3","198","3","192","82.003834000","0.9527","1662.65","1612.27"
"90.38.138.255","8573","244.3.160.239","80","25","15610","8","1201","17","14409","226.705370000","0.9526","10086.59","121013.87"
"244.3.160.239","61785","197.154.128.197","80","33","25418","14","1622","19","23796","77.266059000","0.9516","13635.59","200044.77"
"41.177.176.156","11750","244.3.160.239","80","10","2637","5","1520","5","1117","158.424007000","0.9512","12784.05","9394.60"
"41.177.176.156","11200","244.3.160.239","80","15","7375","7","1377","8","5998","113.256686000","0.9493","11604.57","50547.73"
"41.177.211.185","3549","244.3.160.239","80","58","36790","21","2744","37","34046","208.052194000","0.9482","23150.43","287237.42"
"77.197.217.224","3363","41.177.26.176","80","21","12758","9","889","12","11869","98.117573000","0.9472","7508.53","100246.10"
"77.197.128.211","39772","41.177.26.15","80","100","95667","32","2351","68","93316","148.345728000","0.9467","19866.40","788538.16"
"244.3.160.239","62532","30.222.71.108","80","43","36565","17","1908","26","34657","195.355220000","0.9449","16154.95","293439.17"
"68.33.110.176","2922","244.3.160.239","80","57","47171","13","1599","44","45572","40.185508000","0.9439","13552.31","386245.12"
"15.186.110.132","44349","41.177.26.91","80","46","36790","20","1887","26","34903","48.094934000","0.9422","16022.30","296357.30"
"41.177.4.139","57611","244.3.41.84","1522","47","15048","23","7121","24","7927","126.102362000","0.9418","60485.99","67332.17"
"244.3.153.102","2866","244.3.160.80","443","75","52759","28","3370","47","49389","210.733655000","0.9418","28625.58","419521.88"
"77.197.128.225","12659","41.177.26.15","80","85","75375","31","2287","54","73088","76.235482000","0.9408","19447.09","621490.65"
"41.177.176.156","6352","244.3.160.239","80","49","29155","18","2033","31","27122","97.460670000","0.9398","17306.31","230881.29"
"168.117.3.145","12184","244.3.160.239","80","73","47957","26","2690","47","45267","36.425932000","0.9387","22926.37","385802.27"
"77.197.128.142","28251","41.177.26.15","80","14","9361","6","746","8","8615","117.407755000","0.9374","6366.84","73525.88"
"77.197.128.251","47380","41.177.26.176","80","23","13823","10","936","13","12887","38.867258000","0.9366","7995.19","110079.09"
"41.177.40.117","3348","244.3.160.239","80","14","6154","6","1595","8","4559","92.709812000","0.9343","13657.31","39036.80"
"244.3.155.77","3844","244.3.160.239","80","163","113914","58","5125","105","108789","67.557489000","0.9329","43951.33","932960.28"
"77.197.128.82","50099","41.177.26.91","80","21","16310","8","809","13","15501","172.778677000","0.9323","6941.99","133013.41"
"68.33.110.176","14208","244.3.160.239","80","58","47235","14","1663","44","45572","35.051502000","0.9307","14294.09","391708.05"
"68.33.110.176","12646","244.3.160.239","80","66","56912","14","1663","52","55249","29.919583000","0.9299","14306.50","475297.52"
"41.177.223.45","2340","244.3.160.239","80","9","1451","5","891","4","560","1.881271000","0.9289","7673.67","4822.96"
"244.3.210.255","3287","68.83.160.23","1984","6","390","3","198","3","192","78.303834000","0.9275","1707.76","1656.01"
"242.161.82.241","51479","244.3.210.197","80","138","144500","42","3424","96","141076","112.981084000","0.9250","29611.63","1220061.36"
"89.160.185.98","36282","244.3.210.197","80","10","2166","6","1348","4","818","56.630758000","0.9239","11671.79","7082.73"
"244.3.210.230","3405","68.83.160.23","1984","6","390","3","198","3","192","105.571505000","0.9231","1716.01","1664.01"
"41.177.223.45","10761","244.3.160.239","80","9","1448","5","890","4","558","1.882210000","0.9223","7719.90","4840.12"
"41.177.176.156","11266","244.3.160.239","80","12","2342","6","1311","6","1031","113.270655000","0.9218","11378.22","8948.09"
"41.177.176.156","10601","244.3.160.239","80","12","2271","6","1306","6","965","112.332174000","0.9175","11386.93","8413.77"
"77.197.128.106","46150","41.177.26.15","80","77","69284","28","2095","49","67189","2.702044000","0.9164","18289.08","586551.20"
"244.3.253.224","3906","244.3.160.239","80","187","114068","82","7588","105","106480","220.938225000","0.9115","66596.24","934523.87"
"77.197.128.13","52710","41.177.26.176","80","21","12773","9","880","12","11893","170.577698000","0.9114","7724.08","104389.23"
"151.77.192.83","8237","244.3.160.239","80","12","2813","6","878","6","1935","47.419490000","0.9105","7714.70","17002.21"
"244.3.160.239","61653","117.246.95.43","80","117","104172","42","3412","75","100760","58.456400000","0.9098","30000.81","885956.02"
"244.3.210.98","2798","68.83.160.23","1984","6","390","3","198","3","192","176.793190000","0.9096","1741.43","1688.66"
"151.77.192.83","9063","244.3.160.239","80","12","1669","6","878","6","791","43.816196000","0.9037","7772.69","7002.50"
"77.197.128.224","17404","41.177.26.176","80","19","11029","8","899","11","10130","181.784845000","0.9020","7973.78","89849.17"
"244.3.160.239","61447","177.124.75.164","80","196","177798","70","6612","126","171186","31.428169000","0.8978","58920.37","1525460.20"
"15.71.149.241","59278","41.177.26.15","80","224","260928","41","3149","183","257779","32.944342000","0.8977","28064.08","2297341.98"
"77.197.128.106","45355","41.177.26.15","80","89","80719","31","2287","58","78432","1.442322000","0.8951","20440.20","700990.62"
"244.3.153.0","3555","41.177.24.241","993","28","4785","12","1297","16","3488","177.578097000","0.8946","11598.25","31190.97"
"77.197.128.13","54988","41.177.26.176","80","22","13446","10","951","12","12495","184.076844000","0.8927","8522.12","111970.39"
"244.3.34.223","1420","244.3.41.84","923","8","2742","4","318","4","2424","219.194525000","0.8916","2853.35","21750.05"
"244.3.155.77","4471","244.3.160.239","80","163","113500","58","5191","105","108309","58.453667000","0.8900","46660.10","973552.01"
"77.197.106.40","11255","244.3.210.197","80","23","18381","9","925","14","17456","156.601182000","0.8868","8344.35","157469.09"
"254.51.75.100","50266","244.3.210.197","80","33","23546","14","2777","19","20769","195.196145000","0.8857","25081.85","187585.52"
"77.197.128.127","57452","41.177.26.15","80","95","88668","31","2287","64","86381","198.335232000","0.8832","20715.20","782422.42"
"244.3.160.239","62256","85.224.40.142","80","111","107225","40","3176","71","104049","137.979735000","0.8828","28779.68","942851.80"
"244.3.160.239","61851","117.246.95.43","80","74","58978","28","2531","46","56447","86.897358000","0.8826","22941.73","511652.15"
"77.197.128.12","15354","244.3.210.197","80","22","16114","10","964","12","15150","129.051648000","0.8799","8764.39","137739.17"
"77.197.128.209","58443","41.177.26.15","80","30","26073","11","1007","19","25066","77.162355000","0.8791","9164.01","228108.35"
"77.197.128.251","36783","41.177.26.176","80","49","41270","18","1432","31","39838","8.999970000","0.8790","13033.07","362577.72"
"77.197.210.239","20624","41.177.26.91","80","22","17573","9","894","13","16679","58.895739000","0.8783","8143.34","151926.98"
"77.197.128.13","33678","41.177.26.176","80","23","13746","10","936","13","12810","103.910982000","0.8769","8538.79","116861.04"
"253.160.251.79","2531","253.37.253.43","446","226","307599","0","0","226","307599","17.536084000","0.8754","N/A","2811135.37"
"41.177.176.156","5365","244.3.160.239","80","12","3183","6","1312","6","1871","114.199360000","0.8718","12039.94","17169.76"
"244.3.153.0","3561","41.177.24.241","993","61","32854","24","2066","37","30788","180.827372000","0.8716","18962.89","282589.32"
"16.176.93.164","7412","244.3.160.239","80","12","2584","6","1415","6","1169","84.728604000","0.8708","12999.03","10739.13"
"77.197.128.13","38887","41.177.26.176","80","22","13116","9","924","13","12192","120.640032000","0.8700","8496.68","112112.02"
"16.176.93.164","5605","244.3.160.239","80","15","7188","7","1548","8","5640","81.157653000","0.8676","14273.50","52004.21"
"77.197.210.117","56778","41.177.26.15","80","39","33782","14","1199","25","32583","222.329843000","0.8662","11073.31","300918.81"
"16.176.93.164","16028","244.3.160.239","80","18","10844","8","1546","10","9298","77.603839000","0.8662","14278.49","85874.13"
"41.177.176.156","6064","244.3.160.239","80","10","2208","5","1522","5","686","120.523843000","0.8648","14079.54","6345.97"
"41.177.4.139","57656","244.3.41.84","1522","47","15048","23","7121","24","7927","216.396314000","0.8640","65931.60","73394.16"
"77.197.106.40","7281","244.3.210.197","80","22","16280","9","881","13","15399","116.272561000","0.8637","8160.65","142639.96"
"244.3.160.239","62531","30.222.71.108","80","34","26612","14","1931","20","24681","195.017540000","0.8632","17895.87","228735.33"
"244.3.155.77","13254","244.3.160.239","80","106","64653","42","4023","64","60630","86.894188000","0.8632","37285.00","561916.34"
"77.197.210.103","51326","41.177.26.15","80","35","31369","12","1070","23","30299","101.288465000","0.8629","9920.49","280916.63"
"168.91.64.164","1127","244.3.210.197","80","16","12708","6","434","10","12274","102.723851000","0.8621","4027.47","113901.39"
"41.177.176.156","4801","244.3.160.239","80","12","2532","6","1315","6","1217","115.064116000","0.8616","12209.84","11299.91"
"77.197.128.13","39740","41.177.26.176","80","23","13091","10","990","13","12101","125.012995000","0.8608","9200.22","112456.42"
"77.197.128.72","22285","41.177.26.176","80","25","17347","10","990","15","16357","121.625322000","0.8590","9220.17","152337.76"
"41.177.98.252","3294","244.3.160.239","80","59","47894","23","2336","36","45558","38.531711000","0.8566","21815.57","425459.59"
"186.136.103.68","6053","244.3.160.239","80","12","3422","6","1276","6","2146","74.006417000","0.8566","11917.52","20043.10"
"77.197.128.153","49926","244.3.210.197","80","22","16142","10","968","12","15174","159.061689000","0.8565","9041.28","141727.65"
"41.177.4.139","57634","244.3.41.84","1522","48","15114","24","7187","24","7927","186.300231000","0.8562","67153.32","74067.67"
"41.177.176.156","12195","244.3.160.239","80","42","25143","16","2175","26","22968","110.318141000","0.8558","20332.23","214708.38"
"41.177.176.156","11792","244.3.160.239","80","12","3034","6","1306","6","1728","111.868952000","0.8551","12217.95","16165.87"
"244.3.160.239","61472","122.248.218.117","80","53","45598","20","2378","33","43220","36.500418000","0.8547","22259.09","404557.59"
"151.77.192.83","6960","244.3.160.239","80","166","115194","57","4358","109","110836","137.972037000","0.8539","40827.85","1038365.11"
"253.160.251.79","2564","253.37.253.43","446","394","547533","0","0","394","547533","34.283109000","0.8532","N/A","5133743.54"
"168.223.67.89","2667","244.3.210.197","80","9","3662","6","1274","3","2388","17.671916000","0.8527","11953.13","22405.07"
"244.3.210.230","3392","68.83.160.23","1984","6","390","3","198","3","192","20.848947000","0.8512","1860.89","1804.50"
"41.177.176.156","5132","244.3.160.239","80","12","2228","6","1314","6","914","114.212694000","0.8502","12364.51","8600.58"
"77.197.128.13","39965","41.177.26.176","80","20","12697","8","825","12","11872","126.192315000","0.8501","7764.13","111728.19"
"77.197.210.181","7860","41.177.26.15","80","89","83110","30","2223","59","80887","83.769174000","0.8487","20954.23","762449.23"
"41.177.176.156","8180","244.3.160.239","80","12","2834","6","1529","6","1305","112.793729000","0.8475","14433.80","12319.24"
"41.177.98.252","12246","244.3.160.239","80","143","134661","49","4384","94","130277","31.423536000","0.8475","41385.33","1229825.95"
"77.197.128.13","38044","41.177.26.176","80","22","13057","10","991","12","12066","116.834465000","0.8471","9359.54","113957.85"
"77.197.210.198","39145","41.177.26.176","80","20","13409","8","816","12","12593","41.777320000","0.8439","7735.36","119376.67"
"16.176.93.164","4557","244.3.160.239","80","10","2275","5","1399","5","876","74.685332000","0.8439","13262.72","8304.61"
"77.197.128.13","58868","41.177.26.176","80","19","12216","8","862","11","11354","196.573176000","0.8382","8226.81","108361.02"
"77.197.210.123","54236","41.177.26.176","80","25","15656","12","1142","13","14514","51.070582000","0.8381","10900.50","138537.48"
"77.197.210.123","40765","41.177.26.15","80","29","23391","11","1007","18","22384","10.355638000","0.8375","9619.10","213817.31"
"77.197.217.20","34972","41.177.26.176","80","20","12714","8","816","12","11898","18.967322000","0.8367","7802.39","113765.69"
"77.197.210.122","45700","41.177.26.176","80","18","12874","7","752","11","12122","60.700255000","0.8343","7210.84","116236.37"
"77.197.106.40","7028","244.3.210.197","80","21","16104","9","876","12","15228","89.441053000","0.8329","8413.93","146264.16"
"77.197.128.84","39383","41.177.26.176","80","24","13263","11","1018","13","12245","182.553388000","0.8321","9786.84","117720.86"
"244.3.160.239","62763","40.248.176.156","80","145","132194","51","4675","94","127519","230.314933000","0.8319","44957.87","1226306.36"
"77.197.217.152","21274","41.177.26.176","80","19","12622","7","751","12","11871","83.329775000","0.8319","7222.24","114161.38"
"244.3.160.239","61298","198.123.241.156","80","82","75036","30","2674","52","72362","5.239011000","0.8316","25725.02","696153.27"
"77.197.128.167","17206","244.3.210.197","80","23","18788","9","810","14","17978","68.845136000","0.8301","7805.98","173254.17"
"77.197.210.123","54881","41.177.26.176","80","21","12905","7","761","14","12144","54.319135000","0.8283","7349.67","117285.74"
"77.197.210.81","42674","41.177.26.15","80","29","21326","13","1135","16","20191","10.954963000","0.8280","10965.68","195073.17"
"77.197.128.84","39755","41.177.26.176","80","23","13206","10","988","13","12218","186.119147000","0.8232","9601.04","118730.29"
"16.176.93.164","11983","244.3.160.239","80","12","2712","6","1486","6","1226","85.601350000","0.8219","14463.78","11933.11"
"41.177.4.139","57562","244.3.41.84","1522","47","15050","23","7123","24","7927","36.000850000","0.8215","69366.55","77196.22"
"77.197.210.2","50187","41.177.26.176","80","20","12676","9","889","11","11787","80.700302000","0.8215","8657.47","114786.97"
"244.3.160.239","62478","244.3.31.75","80","170","169017","59","4970","111","164047","176.918142000","0.8210","48430.46","1598565.60"
"77.197.128.225","59001","41.177.26.176","80","21","12777","9","880","12","11897","189.995406000","0.8180","8605.87","116345.54"
"16.176.93.164","15424","244.3.160.239","80","14","3298","7","1932","7","1366","73.669827000","0.8179","18896.83","13360.80"
"253.160.251.85","44898","253.37.253.43","446","279","383249","0","0","279","383249","196.672974000","0.8179","N/A","3748591.83"
"77.197.128.84","39510","41.177.26.176","80","23","13715","10","944","13","12771","183.545702000","0.8179","9233.82","124920.68"
"244.3.160.239","61893","40.248.176.156","80","79","69353","29","2532","50","66821","96.165878000","0.8177","24770.95","653720.29"
"41.177.211.185","11272","244.3.160.239","80","60","37613","20","2207","40","35406","195.352374000","0.8171","21607.41","346638.89"
"77.197.128.13","55256","41.177.26.176","80","23","12903","10","940","13","11963","185.409685000","0.8167","9207.99","117186.37"
"41.177.176.156","3725","244.3.160.239","80","48","28860","18","2037","30","26823","99.885385000","0.8112","20089.72","264539.35"
"244.3.160.239","61930","177.124.75.164","80","109","122962","21","3144","88","119818","99.752208000","0.8111","31008.75","1181744.88"
"77.197.128.13","38642","41.177.26.176","80","20","12720","9","889","11","11831","119.568838000","0.8105","8775.04","116780.04"
"40.138.160.255","13172","244.3.160.239","80","11","2047","6","1561","5","486","197.739016000","0.8103","15412.39","4798.48"
"16.176.93.164","6469","244.3.160.239","80","12","2407","6","1450","6","957","20.141680000","0.8101","14318.60","9450.28"
"15.186.110.132","40287","41.177.26.91","80","28","17136","14","1461","14","15675","3.091876000","0.8099","14432.16","154841.96"
"122.155.141.12","10981","244.3.160.239","80","12","3427","6","1536","6","1891","158.866659000","0.8050","15265.11","18793.18"
"16.176.93.164","2156","244.3.160.239","80","13","3202","6","1852","7","1350","227.176146000","0.8034","18442.06","13443.19"
"77.197.217.224","54063","41.177.26.15","80","61","56647","20","1583","41","55064","202.609983000","0.8027","15777.26","548805.62"
"41.177.3.215","35403","41.177.3.203","30383","14","2434","8","1377","6","1057","77.356516000","0.8002","13766.87","10567.60"
"244.3.160.239","61905","40.248.176.156","80","79","69579","29","2820","50","66759","97.235260000","0.8000","28200.95","667612.53"
"41.177.176.156","6945","244.3.160.239","80","12","2629","6","1534","6","1095","112.754835000","0.7978","15381.86","10979.88"
"77.197.128.225","10531","41.177.26.176","80","20","13441","8","862","12","12579","209.949565000","0.7963","8660.48","126380.67"
"18.132.77.186","5201","244.3.160.239","80","87","76395","31","2756","56","73639","211.916296000","0.7946","27748.55","741428.00"
"16.176.93.164","6896","244.3.160.239","80","12","3181","6","1837","6","1344","40.113073000","0.7939","18511.87","13543.80"
"77.197.128.186","36138","41.177.26.15","80","84","75619","29","2159","55","73460","74.383470000","0.7930","21781.82","741126.55"
"77.197.217.20","34366","41.177.26.176","80","21","13008","9","926","12","12082","17.958550000","0.7924","9349.32","121985.42"
"16.176.93.164","11483","244.3.160.239","80","12","2204","6","1492","6","712","83.936374000","0.7903","15103.81","7207.72"
"18.132.77.186","4546","244.3.160.239","80","103","94534","36","3071","67","91463","211.915362000","0.7898","31107.67","926473.81"
"77.197.210.67","12681","41.177.26.176","80","21","13612","8","826","13","12786","44.122433000","0.7871","8395.52","129957.84"
"77.197.210.82","39093","41.177.26.176","80","22","13407","9","926","13","12481","135.153526000","0.7863","9421.06","126980.90"
"244.3.160.239","62615","30.222.71.108","80","27","20076","12","1776","15","18300","203.346620000","0.7860","18076.06","186256.70"
"77.197.128.55","37895","41.177.26.15","80","84","78276","28","2095","56","76181","208.781852000","0.7857","21330.35","775640.64"
"41.177.4.139","57616","244.3.41.84","1522","47","15050","23","7123","24","7927","156.200400000","0.7839","72693.04","80898.18"
"244.3.160.239","61333","198.123.241.156","80","78","70079","29","2597","49","67482","8.392683000","0.7825","26549.58","689880.08"
"77.197.128.31","64906","41.177.26.176","80","20","13511","8","863","12","12648","29.213401000","0.7822","8826.78","129364.01"
"77.197.128.225","63559","41.177.26.176","80","20","13163","8","862","12","12301","196.064011000","0.7821","8817.58","125829.53"
"77.197.210.198","48412","41.177.26.176","80","20","13339","8","862","12","12477","62.486779000","0.7813","8826.56","127759.90"
"77.197.128.55","23594","41.177.26.176","80","20","13156","8","862","12","12294","170.298977000","0.7789","8853.86","126275.41"
"253.37.253.43","54734","253.160.108.253","21","15","1258","15","1258","0","0","101.389982000","0.7786","12925.96","N/A"
"77.197.210.117","57428","41.177.26.91","80","34","26993","15","1314","19","25679","223.501459000","0.7781","13509.87","264018.16"
"242.161.82.241","61659","244.3.210.197","80","33","26088","14","1928","19","24160","8.682389000","0.7780","19825.47","248435.39"
"244.3.160.239","62318","81.67.217.159","80","102","108952","23","2509","79","106443","152.406431000","0.7778","25807.28","1094860.27"
"244.3.153.22","2018","41.177.24.241","443","19","5132","9","2006","10","3126","155.509124000","0.7772","20648.53","32177.13"
"16.176.93.164","8834","244.3.160.239","80","14","3981","7","2241","7","1740","230.046031000","0.7768","23079.15","17919.56"
"77.197.210.217","19698","244.3.210.197","80","24","17371","11","1030","13","16341","47.325744000","0.7757","10622.40","168524.94"
"77.197.210.186","33677","41.177.26.91","80","96","88988","35","2506","61","86482","70.803753000","0.7738","25909.34","894130.72"
"244.3.160.239","61387","198.123.241.156","80","71","64263","26","2424","45","61839","23.391326000","0.7734","25073.34","639649.55"
"77.197.210.186","4471","41.177.26.176","80","20","13695","8","862","12","12833","5.070687000","0.7731","8919.89","132794.55"
"77.197.210.82","58486","41.177.26.176","80","25","13797","12","1117","13","12680","182.966169000","0.7728","11563.60","131268.04"
"253.160.251.85","44945","253.37.253.43","446","188","253680","0","0","188","253680","217.341510000","0.7721","N/A","2628348.67"
"41.177.199.139","8633","244.3.160.239","80","107","70790","37","3126","70","67664","96.163879000","0.7717","32406.75","701462.11"
"41.177.40.117","7609","244.3.160.239","80","15","6281","8","5453","7","828","8.250353000","0.7713","56557.44","8587.85"
"77.197.128.13","34987","41.177.26.176","80","22","13517","9","889","13","12628","107.654819000","0.7702","9234.22","131169.51"
"77.197.210.110","35057","41.177.26.91","80","25","20311","10","939","15","19372","108.329828000","0.7701","9754.72","201244.27"
"242.161.82.241","53493","244.3.210.197","80","38","31463","15","1529","23","29934","83.649021000","0.7700","15886.56","311019.16"
"41.177.199.139","4678","244.3.160.239","80","145","131969","51","4480","94","127489","230.312431000","0.7697","46562.14","1325035.99"
"77.197.217.224","42966","41.177.26.176","80","21","12913","9","926","12","11987","34.466092000","0.7694","9628.39","124638.84"
"244.3.160.239","62717","41.43.180.128","80","114","109874","41","4952","73","104922","220.943559000","0.7688","51527.98","1091764.71"
"77.197.128.46","24260","41.177.26.176","80","18","12717","7","799","11","11918","134.448517000","0.7683","8320.18","124104.95"
"77.197.210.2","43340","41.177.26.176","80","22","13226","9","926","13","12300","69.514667000","0.7676","9651.44","128199.45"
"77.197.128.47","6426","41.177.26.176","80","22","12844","10","941","12","11903","100.894371000","0.7675","9808.30","124068.26"
"244.3.77.218","7290","244.3.160.239","80","139","78369","64","4872","75","73497","5.225676000","0.7662","50872.48","767441.41"
"77.197.210.128","37799","41.177.26.176","80","24","14877","10","1014","14","13863","54.002980000","0.7660","10590.67","144791.42"
"77.197.128.13","60631","41.177.26.176","80","20","12704","8","826","12","11878","203.531605000","0.7656","8630.88","124113.30"
"77.197.210.198","44760","41.177.26.176","80","19","12665","7","761","12","11904","54.324009000","0.7656","7952.29","124394.24"
"77.197.210.186","3280","41.177.26.176","80","21","13916","9","926","12","12990","0.952598000","0.7654","9678.93","135776.76"
"77.197.210.67","15645","41.177.26.176","80","20","12381","8","863","12","11518","49.481850000","0.7645","9030.30","120522.62"
"77.197.210.181","40322","41.177.26.176","80","22","13022","9","880","13","12142","4.988858000","0.7643","9211.15","127092.95"
"16.176.93.164","13267","244.3.160.239","80","12","2436","6","1413","6","1023","81.724585000","0.7640","14795.37","10711.72"
"66.95.68.201","58315","41.177.26.176","80","11","1850","6","1009","5","841","43.496262000","0.7637","10569.94","8810.03"
"77.197.128.108","61536","41.177.26.176","80","20","12808","8","863","12","11945","189.985601000","0.7632","9046.67","125217.19"
"186.136.103.68","12120","244.3.160.239","80","13","1966","7","1378","6","588","78.256741000","0.7627","14453.14","6167.23"
"77.197.128.180","5025","41.177.26.176","80","20","12920","8","862","12","12058","81.359062000","0.7627","9041.33","126473.67"
"77.197.128.223","21922","41.177.26.176","80","21","13649","9","927","12","12722","214.903206000","0.7619","9733.97","133587.45"
"77.197.128.225","15017","41.177.26.176","80","22","14142","9","926","13","13216","218.963805000","0.7606","9740.17","139012.99"
"244.3.160.239","62262","40.248.176.156","80","177","162765","64","5469","113","157296","138.328866000","0.7605","57527.62","1654573.93"
"77.197.210.213","56460","41.177.26.15","80","39","34899","13","1135","26","33764","40.253805000","0.7603","11943.39","355292.25"
"77.197.128.13","34028","41.177.26.176","80","20","13002","9","880","11","12122","105.095024000","0.7598","9265.93","127638.12"
"244.3.210.98","2805","77.197.64.211","80","24","16316","11","835","13","15481","202.648619000","0.7590","8801.29","163176.90"
"41.177.4.139","57556","244.3.41.84","1522","47","15048","23","7121","24","7927","6.893368000","0.7580","75152.90","83659.18"
"77.197.210.122","45084","41.177.26.176","80","19","13252","7","799","12","12453","57.943829000","0.7579","8433.93","131448.98"
"77.197.210.198","43838","41.177.26.176","80","18","11896","7","751","11","11145","52.123657000","0.7573","7933.03","117727.84"
"77.197.128.139","51655","41.177.26.176","80","19","12726","8","817","11","11909","9.855761000","0.7568","8636.87","125895.27"
"77.197.128.180","11257","41.177.26.176","80","21","13756","9","927","12","12829","91.478529000","0.7566","9801.95","135651.82"
"244.3.160.248","47701","41.177.26.55","80","30","18579","13","1270","17","17309","54.243475000","0.7563","13433.89","183092.33"
"77.197.210.128","41714","41.177.26.176","80","22","12906","10","990","12","11916","64.043434000","0.7560","10475.73","126089.73"
"90.38.138.255","5386","244.3.160.239","80","96","71092","25","2315","71","68777","8.363540000","0.7543","24553.70","729473.06"
"77.197.210.122","41483","41.177.26.176","80","20","12693","8","816","12","11877","49.590568000","0.7539","8659.10","126034.47"
"41.177.176.156","4850","244.3.160.239","80","10","2614","5","1546","5","1068","156.264886000","0.7538","16406.69","11333.99"
"77.197.128.84","38546","41.177.26.176","80","19","13137","8","862","11","12275","177.976518000","0.7537","9150.11","130298.86"
"77.197.128.118","41017","41.177.26.176","80","21","12958","8","863","13","12095","144.492145000","0.7532","9165.99","128461.97"
"41.177.199.139","2360","244.3.160.239","80","104","70610","36","3062","68","67548","97.233225000","0.7528","32538.73","717807.30"
"77.197.210.159","30068","41.177.26.176","80","21","12650","9","876","12","11774","87.483916000","0.7528","9309.41","125124.37"
"77.197.128.55","21288","41.177.26.176","80","20","12937","8","862","12","12075","162.381094000","0.7525","9164.64","128379.43"
"145.67.150.3","16363","244.3.160.239","80","64","63641","18","1721","46","61920","23.367669000","0.7519","18310.78","658804.88"
"77.197.210.164","7221","41.177.26.15","80","34","26516","14","1199","20","25317","100.457118000","0.7514","12765.74","269549.87"
"77.197.210.160","58995","41.177.26.176","80","18","12183","6","734","12","11449","2.767389000","0.7509","7819.53","121969.80"
"47.241.184.51","61840","41.177.26.91","80","46","34910","19","2741","27","32169","172.958527000","0.7509","29202.37","342725.64"
"40.138.160.255","12398","244.3.160.239","80","11","2014","6","1528","5","486","184.539659000","0.7499","16301.62","5184.94"
"77.197.217.20","35824","41.177.26.176","80","19","12743","7","798","12","11945","21.406610000","0.7496","8516.54","127481.32"
"77.197.128.251","14003","41.177.26.176","80","21","12965","10","990","11","11975","89.080407000","0.7495","10567.50","127824.00"
"168.223.67.89","2668","244.3.210.197","80","10","3859","7","1338","3","2521","17.809730000","0.7493","14286.04","26917.12"
"77.197.210.82","57966","41.177.26.176","80","20","12780","7","751","13","12029","180.954130000","0.7490","8021.16","128477.38"
"244.3.160.239","61271","128.71.90.164","80","14","5114","7","1282","7","3832","2.251235000","0.7485","13702.60","40958.17"
"15.186.110.41","48847","244.3.210.197","80","39","28315","18","1783","21","26532","166.862006000","0.7482","19064.88","283695.68"
"41.177.135.193","4097","244.3.160.239","80","144","111502","50","4361","94","107141","152.400803000","0.7473","46685.34","1146964.88"
"77.197.210.198","1303","41.177.26.15","80","36","32921","12","1070","24","31851","114.231548000","0.7469","11460.93","341160.96"
"77.197.217.224","33515","41.177.26.176","80","19","13298","7","748","12","12550","13.505039000","0.7464","8017.00","134509.80"
"77.197.128.46","15384","41.177.26.176","80","21","12795","9","927","12","11868","104.432393000","0.7462","9938.53","127238.88"
"77.197.128.12","31266","41.177.26.176","80","19","12727","8","862","11","11865","21.421339000","0.7457","9247.28","127284.16"
"77.197.128.118","38692","41.177.26.176","80","21","12732","9","879","12","11853","141.229585000","0.7451","9437.49","127261.23"
"244.3.160.239","61502","41.43.180.128","80","64","58185","24","2753","40","55432","41.572193000","0.7443","29590.10","595800.37"
"244.3.160.239","61880","176.41.89.121","80","10","2205","6","1394","4","811","92.180790000","0.7436","14997.15","8725.03"
"90.218.241.186","39682","244.3.210.197","80","81","57790","36","14083","45","43707","52.330818000","0.7433","151572.92","470410.97"
"41.177.40.117","5677","244.3.160.239","80","7","1923","4","1360","3","563","91.921497000","0.7426","14651.40","6065.25"
"77.197.210.159","20183","41.177.26.176","80","19","12347","8","816","11","11531","70.815686000","0.7424","8793.15","124257.14"
"77.197.210.198","43030","41.177.26.176","80","20","13114","8","817","12","12297","49.850735000","0.7422","8806.00","132542.73"
"244.3.153.0","3558","41.177.24.241","993","27","3996","12","1296","15","2700","179.135738000","0.7415","13983.22","29131.71"
"41.177.176.156","14432","244.3.160.239","80","33","18780","13","1759","20","17021","105.438070000","0.7413","18983.05","183689.85"
"77.197.128.223","22804","41.177.26.176","80","21","12981","9","926","12","12055","216.510413000","0.7389","10026.19","130524.52"
"77.197.128.47","13123","41.177.26.176","80","20","12282","8","862","12","11420","109.153182000","0.7388","9334.56","123666.68"
"15.186.110.142","46332","41.177.26.176","80","14","5822","7","966","7","4856","137.529777000","0.7386","10462.87","52595.95"
"77.197.128.84","39852","41.177.26.176","80","22","12905","10","988","12","11917","187.211070000","0.7381","10709.05","129169.85"
"77.197.210.128","35163","244.3.210.197","80","52","44951","20","1538","32","43413","165.734415000","0.7380","16672.52","470613.74"
"77.197.128.186","37282","41.177.26.15","80","27","21350","11","1007","16","20343","76.374743000","0.7378","10919.33","220587.88"
"41.177.211.185","7624","244.3.160.239","80","45","27329","17","2205","28","25124","195.013669000","0.7370","23934.68","272714.20"
"77.197.128.13","45073","41.177.26.176","80","23","14497","10","989","13","13508","140.856895000","0.7346","10770.21","147102.10"
"244.3.31.241","38276","41.177.98.220","7000","17","4393","10","1559","7","2834","44.901946000","0.7342","16987.80","30880.96"
"77.197.128.180","53338","41.177.26.176","80","22","12705","10","943","12","11762","39.216149000","0.7333","10288.09","128322.93"
"18.91.139.163","15712","244.3.160.239","80","108","98405","38","3390","70","95015","185.713821000","0.7331","36992.78","1036834.55"
"77.197.210.82","45598","41.177.26.176","80","19","12932","7","752","12","12180","155.150851000","0.7330","8206.92","132925.90"
"77.197.210.186","3540","41.177.26.176","80","22","13124","8","815","14","12309","1.807858000","0.7324","8902.39","134453.32"
"77.197.128.18","46911","41.177.26.176","80","19","12735","8","825","11","11910","228.828048000","0.7315","9021.98","130244.54"
"77.197.210.198","24608","41.177.26.176","80","21","12866","9","889","12","11977","3.293845000","0.7309","9729.95","131086.18"
"77.197.128.41","54266","41.177.26.176","80","20","12881","8","863","12","12018","152.878370000","0.7308","9447.79","131568.40"
"77.197.128.31","65493","41.177.26.176","80","21","12866","8","812","13","12054","30.893904000","0.7294","8906.41","132214.18"
"77.197.210.123","53893","41.177.26.176","80","20","13314","8","862","12","12452","49.643902000","0.7292","9457.46","136617.48"
"77.197.128.139","27963","41.177.26.176","80","20","12811","9","926","11","11885","90.262289000","0.7291","10160.00","130401.27"
"77.197.210.80","39819","41.177.26.176","80","20","12716","8","825","12","11891","65.177323000","0.7291","9052.85","130481.78"
"77.197.128.18","23401","41.177.26.176","80","20","12873","8","825","12","12048","130.201856000","0.7276","9071.19","132472.39"
"77.197.217.224","65347","41.177.26.176","80","19","12651","8","825","11","11826","90.356522000","0.7274","9073.65","130066.64"
"77.197.128.55","42394","41.177.26.15","80","27","21857","10","943","17","20914","216.533127000","0.7267","10381.63","230245.45"
"77.197.210.122","44833","41.177.26.176","80","22","12943","10","936","12","12007","57.118875000","0.7261","10313.23","132297.97"
"77.197.128.180","56909","41.177.26.176","80","21","12947","8","825","13","12122","42.478752000","0.7258","9092.89","133604.83"
"77.197.210.159","29888","41.177.26.176","80","21","12859","9","889","12","11970","86.653925000","0.7257","9799.54","131946.63"
"77.197.128.13","63447","41.177.26.176","80","20","12795","8","862","12","11933","216.598844000","0.7252","9508.67","131632.18"
"77.197.128.46","30549","41.177.26.176","80","19","12625","8","812","11","11813","157.699531000","0.7247","8963.34","130398.91"
"77.197.128.18","31877","41.177.26.176","80","21","12631","9","926","12","11705","147.449540000","0.7247","10222.71","129219.04"
"77.197.217.20","58118","41.177.26.176","80","21","13053","8","816","13","12237","74.948676000","0.7244","9011.70","135142.30"
"16.176.93.164","13081","244.3.160.239","80","12","2336","6","1411","6","925","87.152728000","0.7243","15585.43","10217.24"
"77.197.128.180","53938","41.177.26.176","80","24","13705","11","1017","13","12688","40.053586000","0.7242","11234.96","140166.37"
"77.197.210.82","39526","41.177.26.176","80","19","12647","8","808","11","11839","135.944933000","0.7236","8933.57","130896.69"
"244.3.160.239","62019","244.176.48.167","80","22","14893","10","1457","12","13436","107.258225000","0.7231","16119.42","148648.26"
"16.176.93.164","12051","244.3.160.239","80","12","2222","6","1485","6","737","86.426285000","0.7230","16431.47","8154.88"
"77.197.128.142","25519","41.177.26.15","80","30","24265","12","1070","18","23195","112.765623000","0.7228","11843.54","256739.13"
"77.197.128.55","24025","41.177.26.176","80","20","13420","8","862","12","12558","171.944569000","0.7222","9548.32","139104.24"
"16.176.93.164","4770","244.3.160.239","80","10","3309","5","1530","5","1779","118.660408000","0.7218","16956.71","19716.34"
"77.197.128.18","27155","41.177.26.176","80","21","13235","8","825","13","12410","135.956449000","0.7215","9147.23","137596.50"
"77.197.128.180","57256","41.177.26.176","80","19","12845","7","798","12","12047","43.207151000","0.7215","8848.42","133580.05"
"242.161.82.241","54438","244.3.210.197","80","25","16983","10","1196","15","15787","107.837534000","0.7215","13261.92","175055.17"
"77.197.128.41","25181","41.177.26.176","80","21","13587","9","926","12","12661","229.407989000","0.7212","10271.90","140445.46"
"77.197.210.82","42085","41.177.26.176","80","21","12965","9","876","12","12089","141.222109000","0.7210","9720.24","134141.50"
"77.197.217.224","38330","41.177.26.176","80","22","12931","9","926","13","12005","23.652789000","0.7207","10279.08","133261.73"
"77.197.128.223","7695","41.177.26.176","80","21","14209","9","880","12","13329","179.730137000","0.7204","9771.98","148012.22"
"77.197.210.198","24778","41.177.26.176","80","23","14059","10","990","13","13069","4.103885000","0.7203","10994.98","145144.79"
"77.197.128.55","4924","41.177.26.176","80","20","13034","8","813","12","12221","126.189116000","0.7201","9032.59","135777.76"
"77.197.128.13","37195","41.177.26.176","80","21","12612","9","875","12","11737","113.642935000","0.7199","9723.30","130425.60"
"77.197.210.80","40000","41.177.26.176","80","21","13227","9","872","12","12355","66.591875000","0.7194","9696.93","137391.70"
"77.197.217.20","61033","41.177.26.176","80","20","12620","8","816","12","11804","86.123744000","0.7194","9074.42","131267.68"
"77.197.210.128","17770","41.177.26.176","80","21","13053","9","926","12","12127","4.466843000","0.7191","10301.55","134910.27"
"40.138.160.255","2777","244.3.160.239","80","11","2079","6","1593","5","486","147.679750000","0.7188","17728.91","5408.82"
"77.197.128.55","64717","41.177.26.176","80","21","13615","8","825","13","12790","113.723272000","0.7187","9183.44","142371.14"
"77.197.128.41","17424","41.177.26.176","80","19","13410","8","863","11","12547","218.663836000","0.7184","9610.74","139728.80"
"77.197.128.55","24816","41.177.26.176","80","20","13001","8","817","12","12184","176.238913000","0.7182","9100.42","135715.37"
"77.197.217.224","42569","41.177.26.176","80","21","13249","8","826","13","12423","32.843431000","0.7181","9201.69","138392.96"
"77.197.128.13","61182","41.177.26.176","80","22","12978","10","988","12","11990","205.835549000","0.7179","11009.58","133608.20"
"77.197.128.13","36715","41.177.26.176","80","22","12848","10","953","12","11895","111.969220000","0.7179","10620.22","132557.71"
"77.197.217.20","37931","41.177.26.176","80","21","13056","9","876","12","12180","30.137367000","0.7173","9769.56","135837.06"
"77.197.128.41","61143","41.177.26.176","80","21","13704","9","876","12","12828","173.388949000","0.7173","9770.26","143074.03"
"77.197.128.13","60868","41.177.26.176","80","23","12758","10","943","13","11815","204.617445000","0.7168","10524.67","131865.31"
"77.197.210.123","37712","41.177.26.176","80","19","12566","8","817","11","11749","3.232158000","0.7167","9119.94","131150.83"
"77.197.128.47","16464","41.177.26.176","80","20","12736","8","817","12","11919","116.375236000","0.7165","9121.60","133072.64"
"77.197.210.80","37020","41.177.26.176","80","22","12849","10","953","12","11896","57.339624000","0.7164","10642.32","132844.77"
"77.197.128.176","26753","41.177.26.176","80","24","14205","10","941","14","13264","25.215946000","0.7163","10510.11","148146.70"
"77.197.210.159","30338","41.177.26.176","80","21","13098","9","890","12","12208","88.875061000","0.7163","9940.55","136353.10"
"77.197.128.180","10862","41.177.26.176","80","20","13032","8","825","12","12207","90.065844000","0.7162","9215.77","136359.83"
"77.197.128.84","38133","41.177.26.176","80","19","12619","7","748","12","11871","176.542446000","0.7159","8358.51","132652.25"
"77.197.128.18","57289","41.177.26.176","80","20","13137","8","816","12","12321","134.638593000","0.7153","9126.78","137807.62"
"77.197.210.181","59060","41.177.26.176","80","21","13582","9","926","12","12656","65.717332000","0.7150","10360.49","141600.84"
"77.197.210.198","40992","41.177.26.176","80","20","13570","7","752","13","12818","45.027514000","0.7150","8414.37","143424.80"
"77.197.128.41","12089","41.177.26.176","80","20","13650","7","798","13","12852","196.758580000","0.7147","8932.09","143853.73"
"77.197.128.18","64591","41.177.26.176","80","21","12942","8","816","13","12126","149.799172000","0.7146","9135.10","135750.33"
"77.197.128.251","43810","41.177.26.176","80","18","13033","7","761","11","12272","21.662151000","0.7144","8521.31","137415.95"
"77.197.128.72","23516","41.177.26.176","80","20","13180","8","862","12","12318","125.513822000","0.7144","9652.46","137933.93"
"77.197.210.181","58903","41.177.26.176","80","19","12866","7","798","12","12068","64.946060000","0.7143","8937.02","135152.84"
"77.197.128.127","50337","41.177.26.176","80","20","12713","9","876","11","11837","35.914951000","0.7142","9812.73","132595.14"
"77.197.210.80","34276","41.177.26.176","80","21","12892","9","876","12","12016","52.329322000","0.7141","9813.46","134610.24"
"77.197.128.251","45114","41.177.26.176","80","24","13940","10","944","14","12996","26.141787000","0.7140","10576.57","145607.12"
"77.197.128.167","1619","41.177.26.176","80","20","12928","8","862","12","12066","28.187189000","0.7140","9657.97","135189.11"
"77.197.210.67","20068","41.177.26.176","80","19","12653","8","825","11","11828","66.072901000","0.7140","9243.83","132528.47"
"77.197.217.20","61652","41.177.26.176","80","20","13007","8","816","12","12191","90.814323000","0.7139","9143.59","136604.74"
"77.197.128.55","23376","41.177.26.176","80","20","13095","8","812","12","12283","169.488128000","0.7137","9102.20","137687.52"
"77.197.128.41","52925","41.177.26.176","80","21","13213","8","812","13","12401","150.052152000","0.7134","9105.22","139056.43"
"77.197.128.18","3010","41.177.26.176","80","24","14105","10","990","14","13115","158.569175000","0.7132","11104.99","147113.05"
"77.197.210.181","40589","41.177.26.176","80","20","12693","7","761","13","11932","5.920902000","0.7130","8539.17","133888.77"
"77.197.128.223","22402","41.177.26.176","80","24","14085","10","953","14","13132","215.706666000","0.7127","10696.78","147397.78"
"77.197.210.80","35964","41.177.26.176","80","20","12724","9","877","11","11847","55.596380000","0.7121","9852.66","133095.16"
"77.197.128.223","26105","41.177.26.176","80","19","12835","8","825","11","12010","224.824245000","0.7117","9273.60","135001.08"
"77.197.128.46","23843","41.177.26.176","80","19","12808","7","744","12","12064","133.606071000","0.7111","8369.58","135713.15"
"16.176.93.164","4475","244.3.160.239","80","12","2237","6","1492","6","745","83.222390000","0.7110","16787.06","8382.28"
"77.197.128.18","21526","41.177.26.176","80","19","12967","8","863","11","12104","177.625952000","0.7100","9723.82","136381.37"
"77.197.210.128","41509","41.177.26.176","80","20","12994","7","761","13","12233","63.228111000","0.7100","8574.79","137838.95"
"77.197.128.55","26372","41.177.26.176","80","22","13000","10","944","12","12056","186.433901000","0.7097","10641.25","135901.40"
"77.197.210.128","39723","41.177.26.176","80","21","13065","9","876","12","12189","58.931287000","0.7088","9886.64","137566.57"
"77.197.128.18","1130","41.177.26.176","80","20","13178","8","813","12","12365","153.835079000","0.7088","9176.69","139569.27"
"77.197.128.13","45312","41.177.26.176","80","22","13126","10","944","12","12182","141.845954000","0.7086","10656.99","137524.82"
"77.197.128.84","37080","41.177.26.176","80","20","12728","8","825","12","11903","173.202261000","0.7081","9320.18","134470.40"
"16.176.93.164","11179","244.3.160.239","80","15","4514","7","2502","8","2012","63.340257000","0.7081","28266.83","22730.96"
"77.197.217.224","35701","41.177.26.176","80","22","12972","9","890","13","12082","17.875294000","0.7080","10056.31","136517.27"
"41.177.192.117","10420","244.3.160.239","80","94","64461","33","3899","61","60562","167.667044000","0.7077","44073.55","684581.32"
"16.176.93.164","9202","244.3.160.239","80","10","1896","5","1426","5","470","124.915394000","0.7076","16123.22","5314.10"
"145.67.223.161","3079","244.3.160.239","80","12","3413","6","1522","6","1891","76.383391000","0.7074","17211.11","21383.84"
"77.197.128.223","25029","41.177.26.176","80","21","12880","9","889","12","11991","222.468734000","0.7074","10053.35","135601.46"
"77.197.210.247","43949","41.177.26.15","80","32","25237","13","1135","19","24102","189.333642000","0.7073","12838.24","272623.16"
"77.197.210.249","11254","41.177.26.176","80","21","12804","9","877","12","11927","50.591682000","0.7073","9919.96","134909.18"
"77.197.128.167","64777","41.177.26.176","80","35","27289","13","1112","22","26177","27.374839000","0.7070","12582.76","296204.10"
"77.197.128.47","15110","41.177.26.176","80","19","12668","8","826","11","11842","113.696950000","0.7065","9352.67","134085.17"
"77.197.128.204","16412","41.177.26.176","80","24","13912","10","944","14","12968","77.015839000","0.7064","10691.40","146870.87"
"77.197.128.18","1245","41.177.26.176","80","20","12905","8","862","12","12043","154.656082000","0.7062","9764.50","136419.76"
"77.197.210.123","55021","41.177.26.176","80","19","13205","7","753","12","12452","55.230033000","0.7060","8532.31","141094.75"
"77.197.128.94","35373","41.177.26.176","80","21","12962","9","881","12","12081","5.516493000","0.7059","9984.06","136909.73"
"77.197.217.20","61513","41.177.26.176","80","18","12691","7","762","11","11929","90.043922000","0.7059","8635.93","135194.25"
"77.197.210.48","63904","41.177.26.176","80","20","12260","8","862","12","11398","50.234122000","0.7059","9769.27","129176.48"
"77.197.210.48","64424","41.177.26.176","80","22","13645","9","889","13","12756","51.003803000","0.7058","10076.48","144584.46"
"77.197.128.41","50085","41.177.26.176","80","19","12840","7","761","12","12079","142.260931000","0.7058","8625.87","136914.41"
"77.197.128.47","7091","41.177.26.176","80","21","12644","9","880","12","11764","101.902554000","0.7056","9977.37","133379.25"
"77.197.128.139","59177","41.177.26.176","80","38","27942","15","1248","23","26694","23.802678000","0.7054","14154.45","302755.61"
"77.197.210.82","58237","41.177.26.176","80","18","12674","7","798","11","11876","182.103867000","0.7053","9051.99","134713.63"
"77.197.128.18","32667","41.177.26.176","80","19","12674","8","816","11","11858","196.303993000","0.7052","9257.59","134530.05"
"77.197.210.82","19875","41.177.26.15","80","14","9333","6","741","8","8592","80.584788000","0.7050","8408.73","97500.36"
"77.197.128.251","45506","41.177.26.176","80","36","27732","14","1199","22","26533","28.152950000","0.7049","13608.07","301136.65"
"77.197.128.84","38346","41.177.26.176","80","21","13715","9","880","12","12835","177.265980000","0.7049","9987.81","145674.52"
"77.197.128.118","41661","41.177.26.176","80","22","12934","9","889","13","12045","145.269104000","0.7045","10095.73","136786.40"
"77.197.128.180","11418","41.177.26.176","80","20","13002","8","825","12","12177","92.270032000","0.7044","9370.17","138303.69"
"77.197.210.186","33521","41.177.26.176","80","18","11820","7","753","11","11067","59.043353000","0.7042","8554.24","125723.50"
"77.197.128.72","23956","41.177.26.176","80","22","14477","9","926","13","13551","127.185191000","0.7042","10520.10","153950.15"
"77.197.210.67","58091","41.177.26.176","80","22","12945","9","881","13","12064","1.368191000","0.7041","10009.42","137064.24"
"77.197.128.167","4892","41.177.26.176","80","21","12938","8","808","13","12130","32.834175000","0.7041","9180.42","137819.96"
"41.177.176.156","7658","244.3.160.239","80","73","49160","26","2823","47","46337","98.430629000","0.7041","32075.95","526497.74"
"244.3.160.239","61949","81.67.210.81","80","11","2141","6","928","5","1213","101.876128000","0.7039","10547.66","13786.97"
"77.197.128.223","19246","41.177.26.176","80","20","12799","9","880","11","11919","211.442695000","0.7038","10002.87","135482.06"
"77.197.210.82","45163","41.177.26.176","80","20","12707","8","825","12","11882","151.975132000","0.7036","9380.10","135096.22"
"41.177.135.193","13223","244.3.160.239","80","10","2181","5","957","5","1224","101.832763000","0.7031","10888.41","13926.24"
"77.197.210.181","47000","41.177.26.176","80","20","12856","8","825","12","12031","41.072251000","0.7029","9390.01","136934.73"
"77.197.128.108","24506","244.3.210.197","80","25","19771","10","996","15","18775","188.858937000","0.7027","11338.36","213732.68"
"77.197.210.198","25335","41.177.26.176","80","19","12820","7","752","12","12068","6.560366000","0.7027","8560.95","137384.98"
"77.197.210.128","37277","41.177.26.176","80","19","12628","7","752","12","11876","53.208361000","0.7027","8561.67","135210.56"
"77.197.217.224","41257","41.177.26.176","80","18","12980","7","752","11","12228","28.777873000","0.7024","8564.38","139262.35"
"244.3.160.239","62219","94.2.202.203","80","13","3694","7","1409","6","2285","127.104030000","0.7023","16050.08","26028.69"
"77.197.128.41","61796","41.177.26.176","80","20","12723","8","825","12","11898","174.939388000","0.7021","9400.75","135575.84"
"77.64.39.119","41426","41.177.26.176","80","16","5215","8","791","8","4424","62.109336000","0.7017","9017.48","50434.06"
"244.3.160.239","61944","198.123.241.156","80","76","68825","28","2548","48","66277","101.421680000","0.7017","29047.67","755570.06"
"77.197.128.18","38181","41.177.26.176","80","20","12848","8","816","12","12032","218.389113000","0.7017","9303.36","137178.95"
"77.197.128.18","35669","41.177.26.176","80","22","12997","9","890","13","12107","206.411061000","0.7016","10148.30","138051.15"
"77.197.217.20","60035","41.177.26.176","80","20","13097","8","816","12","12281","80.391261000","0.7015","9305.75","140053.77"
"47.241.184.51","63020","41.177.26.91","80","22","14893","8","1272","14","13621","173.540374000","0.7014","14508.37","155360.51"
"77.197.128.180","12092","41.177.26.176","80","19","12886","8","825","11","12061","96.316369000","0.7014","9410.03","137568.99"
"77.197.210.82","42578","41.177.26.176","80","20","12613","9","876","11","11737","142.635987000","0.7013","9992.64","133885.44"
"77.197.128.94","33589","41.177.26.176","80","19","12973","8","860","11","12113","1.215870000","0.7009","9816.10","138258.70"
"77.197.217.224","32206","41.177.26.176","80","21","12919","9","876","12","12043","11.546513000","0.7006","10003.13","137520.14"
"77.197.128.18","33458","41.177.26.176","80","21","13031","9","880","12","12151","156.422027000","0.7005","10049.62","138764.70"
"77.197.217.152","22170","41.177.26.176","80","20","13174","8","825","12","12349","85.974464000","0.7005","9422.10","141034.52"
"77.197.128.47","37831","41.177.26.176","80","22","12713","9","880","13","11833","156.492307000","0.7004","10052.06","135165.93"
"77.197.128.251","44972","41.177.26.176","80","21","12878","9","880","12","11998","25.439403000","0.7001","10055.07","137091.80"
"77.197.128.118","12515","41.177.26.176","80","18","12861","7","761","11","12100","212.329519000","0.7001","8696.12","138269.52"
"77.197.217.224","1266","41.177.26.176","80","21","12662","8","808","13","11854","92.794048000","0.6998","9236.86","135512.04"
"77.197.128.193","53430","41.177.26.176","80","21","12956","9","889","12","12067","233.397357000","0.6997","10163.63","137957.84"
"77.197.210.48","57288","41.177.26.176","80","23","13005","9","883","14","12122","39.560955000","0.6996","10096.62","138608.43"
"77.197.210.217","13737","244.3.210.197","80","23","16180","11","1028","12","15152","38.998137000","0.6996","11755.93","173274.13"
"77.197.128.47","34091","41.177.26.176","80","22","12827","10","953","12","11874","149.225131000","0.6991","10905.78","135881.64"
"41.177.230.253","44059","244.3.31.40","22","1344","1158085","463","35214","881","1122871","171.828137000","0.6989","403092.39","12853432.01"
"77.197.128.12","38963","41.177.26.176","80","21","12787","8","816","13","11971","38.620724000","0.6988","9341.90","137048.91"
"77.197.128.47","17717","41.177.26.176","80","20","12804","8","825","12","11979","119.129096000","0.6986","9447.64","137179.76"
"77.197.128.55","24492","41.177.26.176","80","20","12889","8","825","12","12064","174.626781000","0.6985","9448.33","138163.24"
"77.197.128.13","46271","41.177.26.176","80","21","12863","9","890","12","11973","146.268297000","0.6985","10193.27","137128.13"
"77.197.128.13","61949","41.177.26.176","80","23","13025","10","953","13","12072","209.066578000","0.6983","10918.19","138304.76"
"16.176.93.164","2827","244.3.160.239","80","13","4542","6","1481","7","3061","75.550547000","0.6979","16975.53","35085.81"
"77.197.128.41","16732","41.177.26.176","80","21","13042","9","872","12","12170","211.830405000","0.6976","10000.04","139564.82"
"77.197.210.123","37396","41.177.26.176","80","19","12740","7","761","12","11979","2.408758000","0.6976","8727.41","137379.37"
"77.197.128.224","23850","41.177.26.176","80","20","13093","8","863","12","12230","186.730720000","0.6972","9902.48","140332.96"
"77.197.128.118","23440","41.177.26.176","80","36","27732","14","1199","22","26533","119.711111000","0.6968","13765.10","304611.57"
"77.197.217.152","21904","41.177.26.176","80","19","12836","7","761","12","12075","85.155685000","0.6964","8742.08","138712.98"
"77.197.128.13","40980","41.177.26.176","80","22","13107","9","890","13","12217","129.386571000","0.6963","10225.83","140369.62"
"77.197.128.18","22235","41.177.26.176","80","20","12601","9","889","11","11712","178.434491000","0.6961","10216.23","134592.26"
"77.197.128.84","35223","41.177.26.176","80","20","13379","8","816","12","12563","166.719207000","0.6961","9378.52","144390.06"
"77.197.210.123","55175","41.177.26.176","80","19","12472","7","752","12","11720","56.027789000","0.6960","8643.63","134711.87"
"77.197.128.193","45748","41.177.26.176","80","20","12789","8","816","12","11973","219.644394000","0.6958","9381.48","137652.53"
"77.197.217.224","43208","41.177.26.176","80","21","12788","8","816","13","11972","35.893848000","0.6954","9387.17","137724.56"
"77.197.128.139","29263","41.177.26.176","80","20","12726","9","890","11","11836","98.484155000","0.6953","10239.98","136180.20"
"77.197.128.46","16805","41.177.26.176","80","20","13042","8","863","12","12179","111.730498000","0.6953","9929.47","140128.63"
"77.197.128.84","39124","41.177.26.176","80","20","12858","9","924","11","11934","180.801687000","0.6948","10638.79","137406.16"
"77.197.217.218","63025","41.177.26.176","80","21","12853","8","825","13","12028","96.568439000","0.6947","9500.05","138505.01"
"244.3.160.239","62443","41.177.254.197","80","79","62233","30","3817","49","58416","167.671162000","0.6946","43958.95","672755.12"
"77.197.128.118","1174","41.177.26.176","80","21","12313","9","926","12","11387","193.119815000","0.6946","10664.82","131145.09"
"77.197.128.18","25083","41.177.26.176","80","22","13104","9","880","13","12224","182.741245000","0.6945","10136.28","140802.12"
"77.197.128.18","32398","41.177.26.176","80","20","12521","8","812","12","11709","150.086960000","0.6945","9353.88","134882.52"
"77.197.128.18","59508","41.177.26.176","80","21","12884","8","826","13","12058","138.267046000","0.6944","9516.16","138917.45"
"77.197.210.2","48505","41.177.26.176","80","20","12945","9","924","11","12021","77.489326000","0.6943","10647.17","138516.91"
"244.3.160.239","62004","244.176.48.167","80","25","18263","11","1520","14","16743","105.467722000","0.6943","17515.00","192930.05"
"77.197.128.224","40069","41.177.26.176","80","22","13277","9","880","13","12397","207.237820000","0.6942","10141.04","142861.88"
"242.161.82.241","58389","244.3.210.197","80","29","21968","12","1313","17","20655","101.557037000","0.6942","15132.07","238044.82"
"77.197.128.41","16376","41.177.26.176","80","21","12888","9","927","12","11961","208.960842000","0.6941","10684.91","137866.45"
"77.197.128.176","27398","41.177.26.176","80","22","14081","9","880","13","13201","26.850417000","0.6939","10145.80","152198.57"
"77.197.210.122","46195","41.177.26.176","80","20","13477","7","798","13","12679","62.188668000","0.6938","9201.25","146193.75"
"77.197.128.223","29922","41.177.26.176","80","20","12702","8","812","12","11890","233.232349000","0.6937","9363.83","137113.27"
"77.197.128.18","19507","41.177.26.176","80","21","13373","9","880","12","12493","175.333974000","0.6937","10148.00","144066.95"
"77.197.128.176","29159","41.177.26.176","80","20","12798","9","889","11","11909","32.157793000","0.6937","10252.05","137335.94"
"77.197.128.55","25222","41.177.26.176","80","20","13160","9","880","11","12280","178.681940000","0.6937","10148.60","141619.05"
"77.197.128.223","27591","41.177.26.176","80","21","13060","8","816","13","12244","227.932571000","0.6936","9411.86","141224.03"
"77.197.128.223","5188","41.177.26.176","80","20","12825","9","881","11","11944","176.416647000","0.6933","10166.06","137824.60"
"77.197.128.139","59665","41.177.26.176","80","21","12778","9","890","12","11888","26.017293000","0.6929","10276.20","137262.34"
"77.197.128.118","21689","41.177.26.176","80","26","15563","11","1008","15","14555","117.226204000","0.6928","11640.14","168077.66"
"77.197.128.108","31647","244.3.210.197","80","23","18847","9","919","14","17928","199.434089000","0.6927","10613.88","207057.25"
"77.197.128.223","28300","41.177.26.176","80","19","12904","7","761","12","12143","229.494994000","0.6927","8789.09","140244.30"
"41.177.176.156","11170","244.3.160.239","80","28","15589","11","1632","17","13957","107.195993000","0.6925","18853.78","161239.13"
"68.33.110.176","13788","244.3.160.239","80","11","3634","5","1298","6","2336","127.089493000","0.6922","15000.60","26996.46"
"77.197.210.224","24386","41.177.26.15","80","15","9397","7","805","8","8592","80.962007000","0.6922","9303.29","99296.76"
"253.160.251.85","44859","253.37.253.43","446","505","703495","0","0","505","703495","149.004293000","0.6922","N/A","8131080.66"
"41.177.3.215","35724","41.177.3.203","30383","14","2434","8","1377","6","1057","197.663273000","0.6920","15919.05","12219.64"
"77.197.128.118","12118","41.177.26.176","80","19","12613","8","825","11","11788","210.295041000","0.6920","9537.90","136282.18"
"77.197.128.18","1405","41.177.26.176","80","22","12893","9","876","13","12017","155.543548000","0.6918","10129.57","138957.79"
"77.197.210.2","54718","41.177.26.176","80","24","14403","10","953","14","13450","91.953823000","0.6915","11025.59","155607.81"
"77.197.210.186","21905","41.177.26.176","80","21","12922","8","812","13","12110","40.313310000","0.6914","9396.05","140130.82"
"77.197.128.118","11546","41.177.26.176","80","22","13646","9","876","13","12770","208.247507000","0.6913","10137.76","147784.46"
"77.197.128.118","5844","41.177.26.176","80","20","12812","9","890","11","11922","199.557274000","0.6911","10301.91","137999.29"
"77.197.128.225","14373","41.177.26.176","80","22","15328","8","823","14","14505","216.854330000","0.6911","9526.65","167902.84"
"77.197.128.13","3421","41.177.26.176","80","19","12852","8","817","11","12035","233.301929000","0.6911","9457.26","139312.32"
"77.197.210.82","40749","41.177.26.176","80","22","13312","9","890","13","12422","138.113936000","0.6911","10302.51","143795.20"
"77.197.210.186","13125","41.177.26.91","80","27","18550","13","1161","14","17389","194.975114000","0.6908","13445.03","201374.32"
"77.197.128.92","22084","41.177.26.176","80","18","12614","7","762","11","11852","228.696724000","0.6908","8824.74","137258.34"
"15.186.110.132","54009","41.177.26.91","80","43","33733","19","1858","24","31875","158.868663000","0.6907","21520.63","369198.16"
"77.197.210.122","45298","41.177.26.176","80","22","13307","9","877","13","12430","58.759187000","0.6903","10163.53","144051.01"
"77.197.128.224","20504","41.177.26.176","80","20","12992","8","825","12","12167","184.055075000","0.6900","9565.19","141066.26"
"77.197.128.55","22177","41.177.26.176","80","21","13059","8","813","13","12246","164.823765000","0.6898","9428.64","142021.10"
"77.197.128.41","60227","41.177.26.176","80","21","13992","9","876","12","13116","171.291702000","0.6895","10163.86","152179.40"
"77.197.128.176","16348","41.177.26.176","80","20","12682","8","808","12","11874","10.340966000","0.6893","9378.17","137817.37"
"77.197.210.67","19053","41.177.26.176","80","24","14350","10","943","14","13407","59.743196000","0.6891","10948.34","155656.89"
"77.197.217.152","23700","41.177.26.176","80","22","13122","9","889","13","12233","92.901071000","0.6888","10325.16","142078.36"
"77.197.128.18","35158","41.177.26.176","80","23","14035","10","936","13","13099","204.203178000","0.6887","10872.52","152157.15"
"77.197.210.82","42359","41.177.26.176","80","19","13241","8","863","11","12378","141.944703000","0.6886","10026.11","143804.40"
"68.33.110.176","8145","244.3.160.239","80","79","66100","18","2079","61","64021","25.013578000","0.6885","24158.34","743935.00"
"77.197.128.139","28414","41.177.26.176","80","20","12727","8","826","12","11901","92.659204000","0.6883","9600.03","138317.18"
"77.197.128.118","4212","41.177.26.176","80","21","13217","8","816","13","12401","196.306773000","0.6883","9484.61","144140.48"
"77.197.128.46","30268","41.177.26.176","80","20","12713","9","880","11","11833","155.876985000","0.6882","10229.48","137551.64"
"77.197.217.224","33046","41.177.26.176","80","20","12733","8","817","12","11916","12.802448000","0.6880","9499.48","138550.49"
"77.197.128.41","7735","41.177.26.176","80","20","12979","8","826","12","12153","193.507361000","0.6879","9605.38","141324.64"
"77.197.210.122","44608","41.177.26.176","80","19","12650","7","752","12","11898","56.318276000","0.6879","8745.41","138368.14"
"77.197.128.223","3188","41.177.26.176","80","22","13016","9","876","13","12140","173.392989000","0.6878","10189.20","141206.51"
"16.176.93.164","16150","244.3.160.239","80","10","2350","5","1519","5","831","73.638510000","0.6877","17669.24","9666.32"
"77.197.210.249","13957","41.177.26.176","80","20","13177","9","926","11","12251","55.015984000","0.6877","10772.86","142525.17"
"77.197.217.152","24308","41.177.26.176","80","20","12598","7","752","13","11846","95.945529000","0.6875","8751.14","137853.79"
"77.197.128.13","58446","41.177.26.176","80","19","12800","7","761","12","12039","195.225586000","0.6871","8860.11","140166.64"
"77.197.210.181","39710","41.177.26.176","80","19","12646","8","817","11","11829","3.273236000","0.6871","9512.90","137733.29"
"77.197.128.18","29315","41.177.26.176","80","22","13506","9","927","13","12579","191.709823000","0.6869","10795.61","146491.86"
"77.197.128.118","3753","41.177.26.176","80","22","13279","9","880","13","12399","195.506169000","0.6869","10249.56","144413.92"
"41.177.176.156","7406","244.3.160.239","80","18","7717","8","1673","10","6044","99.156862000","0.6868","19487.99","70403.71"
"77.197.128.72","41397","41.177.26.176","80","21","12900","8","816","13","12084","221.212089000","0.6867","9506.75","140783.78"
"244.3.160.239","61806","43.106.84.231","80","17","6895","8","1355","9","5540","78.531053000","0.6867","15786.65","64544.69"
"77.197.128.223","36687","41.177.26.176","80","20","12696","7","761","13","11935","125.352263000","0.6866","8866.73","139059.61"
"77.197.210.198","47638","41.177.26.176","80","20","12785","8","815","12","11970","61.056455000","0.6866","9495.96","139468.23"
"77.197.128.118","25982","41.177.26.176","80","19","12546","8","825","11","11721","124.809391000","0.6864","9615.68","136612.57"
"77.197.128.18","54137","41.177.26.176","80","21","12632","8","826","13","11806","131.496914000","0.6864","9627.36","137603.68"
"77.197.210.82","58694","41.177.26.176","80","23","13384","9","926","14","12458","183.756888000","0.6855","10806.46","145385.37"
"77.197.210.82","44973","41.177.26.176","80","19","12739","7","761","12","11978","150.695142000","0.6853","8884.08","139833.73"
"77.197.128.47","22621","41.177.26.176","80","23","12790","10","936","13","11854","129.077254000","0.6851","10929.60","138418.24"
"77.197.210.249","16548","41.177.26.176","80","22","12898","9","879","13","12019","65.159613000","0.6849","10267.54","140393.09"
"77.197.210.231","21234","41.177.26.15","80","14","9337","6","742","8","8595","221.224699000","0.6848","8668.50","100412.10"
"77.197.128.224","46808","41.177.26.176","80","19","12920","7","752","12","12168","213.534662000","0.6845","8788.42","142204.15"
"77.197.128.46","25837","41.177.26.176","80","20","13196","7","798","13","12398","138.602653000","0.6845","9327.14","144909.67"
"77.197.128.118","43996","41.177.26.176","80","20","12803","8","825","12","11978","148.359683000","0.6842","9646.99","140062.65"
"77.197.128.41","12856","41.177.26.176","80","20","12701","8","825","12","11876","198.163233000","0.6841","9648.35","138889.42"
"77.197.128.224","44318","41.177.26.176","80","22","13018","9","880","13","12138","211.293561000","0.6840","10292.29","141963.46"
"16.176.93.164","9714","244.3.160.239","80","12","2105","6","1401","6","704","80.471449000","0.6835","16398.84","8240.39"
"77.197.210.128","34847","41.177.26.176","80","19","12531","8","825","11","11706","48.384234000","0.6833","9659.09","137053.74"
"77.197.128.41","10743","41.177.26.176","80","19","12952","8","825","11","12127","194.336424000","0.6832","9659.77","141992.78"
"77.197.128.41","11633","41.177.26.176","80","18","12629","7","748","11","11881","195.946068000","0.6832","8759.08","139126.46"
"77.197.127.110","12537","41.177.26.176","80","19","12782","8","808","11","11974","117.820055000","0.6831","9462.67","140230.27"
"77.197.128.118","7770","41.177.26.176","80","19","12932","7","752","12","12180","204.224126000","0.6830","8807.97","142660.95"
"77.197.128.41","1382","41.177.26.176","80","20","12833","8","825","12","12008","184.698451000","0.6829","9664.17","140663.46"
"77.197.217.218","62880","41.177.26.176","80","22","13952","9","876","13","13076","95.146375000","0.6828","10263.42","153201.54"
"77.197.217.152","24202","41.177.26.176","80","22","12855","9","880","13","11975","95.134873000","0.6826","10312.81","140336.28"
"77.197.128.167","5431","41.177.26.176","80","21","12929","9","889","12","12040","36.319074000","0.6826","10419.22","141110.63"
"77.197.217.20","37214","41.177.26.176","80","20","12579","9","881","11","11698","26.617509000","0.6825","10326.07","137110.57"
"16.176.93.164","3207","244.3.160.239","80","16","6490","7","1579","9","4911","116.409515000","0.6825","18509.70","57568.80"
"77.197.217.224","43325","41.177.26.176","80","22","12949","9","880","13","12069","36.698761000","0.6823","10318.21","141511.88"
"77.197.128.18","20250","41.177.26.176","80","20","12603","8","812","12","11791","176.087898000","0.6822","9521.66","138263.41"
"77.197.127.51","49770","41.177.26.176","80","13","4918","6","677","7","4241","87.411832000","0.6821","7939.66","49737.23"
"77.197.217.224","1148","41.177.26.176","80","21","13061","9","880","12","12181","91.981712000","0.6821","10320.52","142857.14"
"77.197.128.223","58658","41.177.26.176","80","22","13119","9","880","13","12239","163.901620000","0.6821","10320.52","143537.36"
"77.197.210.80","34957","41.177.26.176","80","22","13109","9","924","13","12185","53.940223000","0.6818","10842.51","142982.66"
"90.38.138.255","15097","244.3.160.239","80","91","69637","22","2123","69","67514","101.399923000","0.6816","24918.43","792436.44"
"77.197.128.118","39614","41.177.26.176","80","22","13559","9","926","13","12633","142.523196000","0.6815","10869.63","148289.44"
"77.197.128.92","19800","41.177.26.176","80","24","14210","10","945","14","13265","218.959224000","0.6815","11093.34","155717.62"
"77.197.128.41","44779","41.177.26.176","80","21","12770","8","812","13","11958","130.501234000","0.6813","9534.20","140406.29"
"77.197.128.13","44862","41.177.26.176","80","22","13143","10","953","12","12190","140.042786000","0.6813","11190.32","143137.49"
"77.197.128.167","5203","41.177.26.176","80","21","12726","9","889","12","11837","35.472094000","0.6810","10442.93","139047.19"
"244.3.160.248","48187","41.177.26.211","2641","16","1403","8","642","8","761","96.632513000","0.6805","7546.99","8945.89"
"244.3.160.239","62252","40.248.176.176","80","11","2889","6","1715","5","1174","135.772502000","0.6804","20163.31","13802.75"
"77.197.217.20","29547","41.177.26.176","80","21","13024","9","875","12","12149","10.021813000","0.6804","10287.76","142841.19"
"77.197.128.41","16016","41.177.26.176","80","21","12741","9","876","12","11865","206.736697000","0.6801","10303.61","139557.45"
"77.197.210.48","7216","41.177.26.176","80","20","12873","8","808","12","12065","64.455623000","0.6801","9504.79","141924.90"
"77.197.128.139","61167","41.177.26.176","80","21","12967","9","890","12","12077","33.791200000","0.6799","10471.87","142099.70"
"77.197.210.128","32440","41.177.26.176","80","23","14038","9","889","14","13149","43.728014000","0.6798","10461.30","154730.75"
"77.197.128.12","38278","41.177.26.176","80","20","12840","8","816","12","12024","34.897143000","0.6798","9602.44","141494.82"
"244.3.160.239","62163","40.248.176.176","80","13","3150","7","1863","6","1287","117.791000000","0.6797","21927.16","15147.75"
"77.197.128.41","60667","41.177.26.176","80","19","12999","8","812","11","12187","172.446236000","0.6797","9557.31","143442.07"
"77.197.128.118","46238","41.177.26.176","80","20","12711","7","752","13","11959","155.199834000","0.6796","8851.76","140768.85"
"77.197.128.139","57865","41.177.26.176","80","20","12739","8","813","12","11926","19.962697000","0.6794","9572.86","140425.45"
"77.197.210.123","55293","41.177.26.176","80","20","12952","7","761","13","12191","56.853873000","0.6788","8969.30","143685.54"
"77.197.128.31","58854","41.177.26.176","80","20","12702","9","890","11","11812","1.370572000","0.6786","10492.76","139258.99"
"77.197.210.67","58799","41.177.26.176","80","19","13086","8","860","11","12226","7.461840000","0.6785","10140.25","144156.68"
"77.197.128.139","28125","41.177.26.176","80","20","13327","9","926","11","12401","91.110033000","0.6784","10920.41","146246.18"
"77.197.128.223","61001","41.177.26.176","80","18","12741","7","761","11","11980","166.699043000","0.6782","8976.53","141312.54"
"253.160.251.85","44781","253.37.253.43","446","439","610735","0","0","439","610735","82.253895000","0.6780","N/A","7206057.60"
"77.197.210.122","44114","41.177.26.176","80","18","12927","7","759","11","12168","54.840662000","0.6772","8966.52","143747.80"
"77.197.210.159","32154","41.177.26.176","80","21","12964","8","816","13","12148","94.593024000","0.6771","9641.57","143536.54"
"244.3.160.248","50016","41.177.26.193","80","161","151826","58","5343","103","146483","231.855119000","0.6770","63136.44","1730940.46"
"77.197.128.167","58756","41.177.26.176","80","20","12815","8","812","12","12003","16.255115000","0.6770","9595.37","141838.99"
"77.197.128.193","52101","41.177.26.176","80","22","13211","9","880","13","12331","229.337014000","0.6768","10402.08","145759.09"
"77.197.210.128","39403","41.177.26.176","80","21","13056","9","876","12","12180","58.121457000","0.6762","10364.12","144103.85"
"244.3.160.239","61963","198.123.241.156","80","103","97227","37","3029","66","94198","103.192089000","0.6762","35837.25","1114492.26"
"77.197.210.249","15324","41.177.26.176","80","20","13151","7","761","13","12390","59.640544000","0.6761","9003.97","146595.56"
"77.197.128.180","59770","41.177.26.176","80","20","12953","8","812","12","12141","51.354754000","0.6761","9608.34","143663.68"
"77.197.210.82","41393","41.177.26.176","80","20","12989","8","860","12","12129","139.438303000","0.6760","10177.47","143537.82"
"77.197.210.67","58654","41.177.26.176","80","22","14803","9","880","13","13923","5.840434000","0.6759","10416.24","164801.41"
"77.197.128.46","21760","41.177.26.176","80","21","12733","9","878","12","11855","126.429577000","0.6756","10397.01","140383.29"
"77.197.128.139","27594","41.177.26.176","80","20","12635","9","889","11","11746","88.734658000","0.6754","10529.51","139122.20"
"77.197.128.41","59449","41.177.26.176","80","21","12774","9","880","12","11894","168.910385000","0.6754","10423.73","140886.19"
"77.197.128.46","21955","41.177.26.176","80","20","13269","8","823","12","12446","127.637392000","0.6753","9750.02","147446.77"
"77.197.217.224","3163","41.177.26.176","80","20","12721","7","761","13","11960","96.481907000","0.6751","9017.35","141718.12"
"77.197.217.20","55912","41.177.26.176","80","21","12758","8","815","13","11943","70.395498000","0.6749","9660.88","141570.37"
"77.197.128.180","63874","41.177.26.176","80","18","12621","7","796","11","11825","67.426471000","0.6747","9438.66","140216.28"
"77.197.210.82","44506","41.177.26.176","80","18","12597","7","753","11","11844","148.034116000","0.6747","8928.94","140444.08"
"77.197.210.186","35081","41.177.26.176","80","21","13670","8","860","13","12810","63.095228000","0.6746","10198.56","151911.12"
"77.197.128.251","42232","41.177.26.176","80","22","13389","9","926","13","12463","17.904435000","0.6746","10981.84","147804.22"
"77.197.128.41","61524","41.177.26.176","80","23","13600","10","953","13","12647","174.262661000","0.6745","11302.79","149996.15"
"77.197.217.152","50394","41.177.26.15","80","14","9337","6","742","8","8595","160.355535000","0.6745","8800.66","101942.94"
"244.3.153.0","3554","41.177.24.241","993","27","4053","12","1300","15","2753","176.905785000","0.6745","15419.08","32652.87"
"244.3.181.123","9197","244.3.160.239","80","12","3220","6","1923","6","1297","117.731176000","0.6742","22818.02","15390.00"
"151.77.192.83","16231","244.3.160.239","80","10","1386","5","953","5","433","20.398038000","0.6742","11308.23","5137.95"
"77.197.128.72","24190","41.177.26.176","80","20","12721","8","826","12","11895","128.290213000","0.6741","9803.22","141173.54"
"244.3.153.142","51985","41.177.24.241","993","7","790","4","373","3","417","94.479553000","0.6740","4427.36","4949.62"
"77.197.128.176","29627","41.177.26.176","80","24","14387","10","953","14","13434","35.605556000","0.6739","11313.44","159480.27"
"77.197.128.41","13232","41.177.26.176","80","19","12520","8","816","11","11704","198.990412000","0.6737","9690.42","138991.03"
"77.197.217.20","37739","41.177.26.176","80","19","12731","7","761","12","11970","29.279228000","0.6734","9040.98","142208.39"
"18.132.77.186","15625","244.3.160.239","80","37","34931","11","1630","26","33301","99.684758000","0.6733","19368.33","395696.19"
"77.197.128.13","38463","41.177.26.176","80","23","13057","10","990","13","12067","118.689559000","0.6731","11766.82","143424.47"
"77.197.128.167","57088","41.177.26.176","80","19","12924","8","808","11","12116","13.298598000","0.6727","9608.61","144081.58"
"77.197.128.18","65238","41.177.26.176","80","21","12975","8","862","13","12113","152.232978000","0.6727","10251.10","144050.61"
"77.197.128.31","65187","41.177.26.176","80","19","12837","8","863","11","11974","30.091003000","0.6724","10267.88","142465.36"
"41.177.176.156","7174","244.3.160.239","80","10","3033","5","1474","5","1559","102.034440000","0.6723","17540.86","18552.37"
"224.47.38.154","4873","41.177.26.176","80","16","8255","9","1478","7","6777","127.435797000","0.6720","17595.66","80680.49"
"244.3.160.248","50025","41.177.26.193","80","200","196410","70","6120","130","190290","233.766444000","0.6720","72859.64","2265434.68"
"77.197.128.251","63163","41.177.26.176","80","24","13291","11","1052","13","12239","66.887496000","0.6719","12526.34","145731.87"
"77.197.128.251","45239","41.177.26.176","80","21","12786","9","877","12","11909","26.859448000","0.6718","10444.05","141822.35"
"77.197.128.224","27072","41.177.26.176","80","21","12896","8","817","13","12079","191.302344000","0.6716","9732.13","143885.41"
"77.197.128.118","11289","41.177.26.176","80","19","12059","8","826","11","11233","207.436187000","0.6711","9846.01","133898.55"
"77.197.128.47","14785","41.177.26.176","80","19","12902","8","816","11","12086","113.022112000","0.6707","9733.20","144161.12"
"77.197.210.67","19823","41.177.26.176","80","19","12965","8","862","11","12103","63.856227000","0.6706","10283.01","144379.61"
"77.197.128.224","42532","41.177.26.176","80","21","13701","8","862","13","12839","209.639305000","0.6704","10286.27","153208.20"
"77.197.210.48","7568","41.177.26.176","80","20","13424","7","751","13","12673","65.219582000","0.6701","8965.20","151286.21"
"77.197.128.84","36113","41.177.26.176","80","20","12727","8","817","12","11910","170.304708000","0.6700","9754.71","142201.53"
"77.197.128.41","64862","41.177.26.176","80","20","12620","8","816","12","11804","183.093049000","0.6698","9746.51","140990.00"
"77.197.210.67","19404","41.177.26.176","80","22","13088","9","887","13","12201","61.355583000","0.6695","10598.73","145789.33"
"77.197.128.150","35932","41.177.26.176","80","21","12764","8","816","13","11948","191.628278000","0.6694","9751.39","142781.39"
"77.197.217.20","59068","41.177.26.176","80","22","13121","9","889","13","12232","77.169759000","0.6694","10625.07","146193.38"
"77.197.210.48","44252","41.177.26.176","80","20","13527","7","751","13","12776","6.953596000","0.6692","8977.82","152730.48"
"77.197.128.41","62117","41.177.26.176","80","20","12553","8","816","12","11737","175.776383000","0.6691","9757.10","140342.07"
"77.197.128.13","47960","41.177.26.176","80","12","5459","6","752","6","4707","154.122729000","0.6686","8998.38","56323.62"
"77.197.128.118","1793","41.177.26.176","80","21","13072","8","825","13","12247","193.893385000","0.6685","9872.39","146554.16"
"77.197.128.46","19814","41.177.26.176","80","23","13173","10","944","13","12229","117.636433000","0.6684","11298.57","146366.79"
"77.197.128.180","12307","41.177.26.176","80","19","12747","8","863","11","11884","97.936253000","0.6684","10329.36","142241.16"
"244.3.160.239","61984","198.123.241.156","80","62","54556","23","2159","39","52397","104.403571000","0.6682","25847.19","627288.30"
"77.197.217.20","60400","41.177.26.176","80","22","12945","9","889","13","12056","82.637727000","0.6682","10642.99","144332.89"
"77.197.128.55","23022","41.177.26.176","80","20","12926","8","863","12","12063","167.917678000","0.6682","10332.28","144424.47"
"77.197.128.13","45698","41.177.26.176","80","21","13220","9","924","12","12296","143.510336000","0.6682","11063.32","147223.54"
"77.197.128.47","14467","41.177.26.176","80","21","13114","9","924","12","12190","112.347423000","0.6681","11064.56","145970.76"
"77.197.210.80","38162","41.177.26.176","80","20","12818","8","817","12","12001","60.361044000","0.6681","9783.42","143709.71"
"77.197.128.41","64048","41.177.26.176","80","19","12543","8","825","11","11718","181.411113000","0.6680","9880.56","140339.95"
"77.197.128.117","19474","41.177.26.176","80","19","13086","8","825","11","12261","109.464265000","0.6677","9884.87","146907.16"
"77.197.128.180","5466","41.177.26.176","80","23","12915","9","872","14","12043","82.512598000","0.6671","10457.94","144432.30"
"77.197.128.47","16162","41.177.26.176","80","21","13306","9","876","12","12430","115.702211000","0.6669","10508.54","149110.94"
"77.197.128.84","36849","41.177.26.176","80","25","14415","10","988","15","13427","172.464350000","0.6668","11853.81","161094.20"
"77.197.128.167","60544","41.177.26.176","80","21","13634","8","825","13","12809","19.858669000","0.6667","9898.84","153689.94"
"77.197.128.176","29685","41.177.26.176","80","20","12895","9","880","11","12015","36.417344000","0.6667","10558.79","144163.49"
"77.197.210.186","3082","41.177.26.176","80","20","12669","8","815","12","11854","0.156913000","0.6666","9781.11","142264.15"
"77.197.210.82","44660","41.177.26.176","80","22","13643","9","889","13","12754","148.709429000","0.6665","10669.96","153076.17"
"77.197.128.225","7266","41.177.26.176","80","21","12780","8","813","13","11967","208.481565000","0.6662","9763.00","143706.97"
"77.197.128.223","12524","41.177.26.176","80","23","14502","10","989","13","13513","185.620445000","0.6661","11878.03","162292.98"
"77.197.217.20","36646","41.177.26.176","80","19","12577","7","748","12","11829","24.631333000","0.6659","8986.48","142113.78"
"77.197.210.48","62243","41.177.26.176","80","21","12653","8","816","13","11837","46.924726000","0.6657","9806.44","142253.47"
"77.197.210.249","64569","41.177.26.176","80","18","13041","7","761","11","12280","40.006540000","0.6656","9145.95","147585.07"
"77.197.217.20","36458","41.177.26.176","80","19","13497","7","753","12","12744","23.846728000","0.6655","9052.38","153205.30"
"77.197.128.251","15508","41.177.26.46","80","8","1002","5","647","3","355","92.171050000","0.6653","7779.47","4268.49"
"244.3.160.239","61303","128.71.90.164","80","15","5736","8","1384","7","4352","5.504565000","0.6653","16641.69","52329.94"
"77.197.128.118","34576","41.177.26.176","80","21","12898","9","880","12","12018","136.280332000","0.6652","10583.71","144539.84"
"77.197.128.12","30080","41.177.26.176","80","20","12805","9","880","11","11925","19.227624000","0.6649","10588.76","143489.72"
"242.161.82.241","59210","244.3.210.197","80","26","19982","10","1133","16","18849","124.038425000","0.6648","13634.07","226821.40"
"77.197.128.118","44491","41.177.26.176","80","19","13277","8","817","11","12460","149.110467000","0.6645","9836.28","150012.27"
"90.218.193.20","10567","244.3.160.239","80","52","38500","16","2113","36","36387","103.379449000","0.6643","25445.45","438184.44"
"77.197.217.20","61740","41.177.26.176","80","21","12827","9","890","12","11937","91.634417000","0.6641","10720.74","143790.48"
"77.197.210.181","38739","41.177.26.176","80","18","12470","7","752","11","11718","0.983472000","0.6640","9060.27","141181.15"
"77.197.217.20","56375","41.177.26.176","80","21","13311","8","824","13","12487","71.181392000","0.6638","9931.42","150501.99"
"77.197.128.13","46827","41.177.26.176","80","20","12701","8","812","12","11889","148.821783000","0.6637","9787.13","143299.45"
"77.197.128.92","56453","41.177.26.176","80","20","13077","8","862","12","12215","104.234227000","0.6636","10391.04","147246.51"
"77.197.128.55","24972","41.177.26.176","80","23","14317","10","936","13","13381","177.075655000","0.6631","11292.33","161434.46"
"77.197.210.2","54092","41.177.26.176","80","22","13449","9","880","13","12569","90.320105000","0.6631","10617.20","151644.99"
"77.197.217.224","40715","41.177.26.176","80","20","12561","8","815","12","11746","27.998826000","0.6630","9834.64","141739.43"
"77.197.210.80","33331","41.177.26.176","80","20","12694","9","880","11","11814","50.086863000","0.6629","10619.39","142565.37"
"77.197.210.159","30539","41.177.26.176","80","20","12765","8","860","12","11905","89.700538000","0.6629","10378.48","143669.58"
"77.197.128.84","39252","41.177.26.176","80","20","12591","9","879","11","11712","181.636475000","0.6626","10613.19","141412.56"
"77.197.210.186","32316","41.177.26.176","80","21","13026","8","815","13","12211","56.277621000","0.6621","9847.78","147547.57"
"77.197.128.180","11690","41.177.26.176","80","23","14098","10","953","13","13145","93.872133000","0.6619","11517.52","158864.44"
"77.197.128.167","56609","41.177.26.176","80","25","15868","10","945","15","14923","12.489743000","0.6618","11422.60","180380.33"
"77.197.217.224","34782","41.177.26.176","80","20","12571","8","815","12","11756","15.964719000","0.6618","9851.79","142107.47"
"244.3.160.239","62223","151.241.241.198","80","63","48693","24","2540","39","46153","128.497864000","0.6618","30704.14","557908.73"
"77.197.128.180","10629","41.177.26.176","80","19","12631","7","751","12","11880","89.200064000","0.6618","9078.82","143617.02"
"77.197.128.47","12819","41.177.26.176","80","20","12580","9","880","11","11700","108.486661000","0.6617","10639.12","141451.91"
"77.197.128.18","38088","41.177.26.176","80","21","12879","8","825","13","12054","216.843278000","0.6614","9979.19","145805.11"
"77.197.128.84","44493","41.177.26.176","80","20","12946","8","823","12","12123","202.607797000","0.6611","9959.04","146699.18"
"77.197.128.46","19577","41.177.26.176","80","20","12993","8","862","12","12131","116.830231000","0.6610","10432.41","146816.19"
"77.197.128.55","20708","41.177.26.176","80","20","12740","8","825","12","11915","160.955976000","0.6610","9984.66","144202.69"
"244.3.160.248","49962","41.177.26.193","80","14","3489","7","2591","7","898","219.259153000","0.6610","31359.16","10868.59"
"77.197.210.2","49881","41.177.26.176","80","19","12614","7","751","12","11863","79.944219000","0.6606","9095.37","143672.91"
"77.197.128.176","28282","41.177.26.176","80","21","13496","8","862","13","12634","30.135704000","0.6603","10443.41","153064.95"
"253.160.251.90","1406","253.37.253.43","446","166","221466","0","0","166","221466","55.771532000","0.6603","N/A","2683367.08"
"77.197.128.224","38855","41.177.26.176","80","21","12653","9","877","12","11776","129.666866000","0.6602","10626.70","142690.97"
"77.197.128.223","13129","41.177.26.176","80","19","12662","7","749","12","11913","188.761333000","0.6601","9077.63","144381.62"
"41.177.168.181","4327","244.3.160.239","80","15","6665","6","1128","9","5537","78.526069000","0.6599","13674.72","67124.92"
"77.197.217.152","23458","41.177.26.176","80","20","12610","8","816","12","11794","91.452062000","0.6597","9895.62","143025.62"
"77.197.128.225","62104","41.177.26.176","80","20","12785","7","751","13","12034","193.748044000","0.6597","9107.40","145936.76"
"41.177.4.139","57577","244.3.41.84","1522","35","7114","18","4339","17","2775","61.936394000","0.6596","52622.16","33654.41"
"77.197.210.80","35482","41.177.26.176","80","19","12624","7","752","12","11872","54.689419000","0.6596","9120.24","143983.31"
"77.197.217.152","22877","41.177.26.176","80","21","12945","8","860","13","12085","88.617727000","0.6593","10436.01","146650.16"
"77.197.128.193","53164","41.177.26.176","80","20","13438","8","816","12","12622","232.584985000","0.6592","9902.63","153175.20"
"77.197.128.13","46455","41.177.26.176","80","20","13340","9","926","11","12414","147.111200000","0.6592","11237.81","150654.65"
"77.197.128.224","38446","41.177.26.176","80","19","13102","8","825","11","12277","205.743174000","0.6592","10012.82","149002.89"
"77.197.210.67","15302","41.177.26.176","80","18","12490","7","753","11","11737","48.669518000","0.6590","9141.62","142490.33"
"77.197.128.18","57858","41.177.26.176","80","22","13385","9","924","13","12461","135.511592000","0.6589","11218.82","151296.19"
"244.3.160.239","61365","177.124.75.164","80","361","341456","124","10177","237","331279","16.452840000","0.6587","123597.65","4023318.02"
"77.197.217.20","60523","41.177.26.176","80","20","13243","7","759","13","12484","83.438160000","0.6587","9218.35","151623.08"
"41.177.211.185","10601","244.3.160.239","80","33","20468","12","1883","21","18585","203.344176000","0.6586","22873.25","225756.39"
"77.197.128.193","52886","41.177.26.176","80","20","12816","8","863","12","11953","231.772245000","0.6585","10485.10","145224.14"
"77.197.128.18","30006","41.177.26.176","80","20","13088","8","860","12","12228","141.428326000","0.6584","10449.67","148579.73"
"77.197.210.48","3540","41.177.26.176","80","20","13044","7","761","13","12283","57.060671000","0.6583","9248.41","149275.00"
"77.197.210.159","30778","41.177.26.176","80","19","12665","7","761","12","11904","90.514592000","0.6582","9249.13","144680.23"
"77.197.128.18","64805","41.177.26.176","80","21","13043","9","880","12","12163","150.624326000","0.6582","10696.21","147838.65"
"77.197.128.224","13501","41.177.26.176","80","21","13230","8","825","13","12405","178.228746000","0.6581","10028.26","150788.59"
"77.197.128.18","43768","41.177.26.176","80","19","12915","8","813","11","12102","224.826358000","0.6581","9882.89","147112.86"
"77.197.128.180","60912","41.177.26.176","80","21","13252","9","926","12","12326","54.426242000","0.6580","11257.83","149853.12"
"77.197.210.152","30063","41.177.26.15","80","24","19048","9","878","15","18170","219.212635000","0.6577","10679.17","221002.88"
"77.197.210.82","44869","41.177.26.176","80","22","13099","9","924","13","12175","149.955819000","0.6577","11239.95","148102.19"
"77.197.210.122","47310","41.177.26.176","80","21","13012","9","879","12","12133","65.195926000","0.6574","10696.37","147644.04"
"77.197.128.180","61094","41.177.26.176","80","22","13115","9","889","13","12226","55.085030000","0.6574","10819.08","148789.77"
"77.197.210.198","40518","41.177.26.176","80","22","13826","9","926","13","12900","44.227018000","0.6572","11271.67","157024.33"
"77.197.128.13","1679","41.177.26.176","80","20","13139","8","817","12","12322","230.594082000","0.6571","9946.27","150009.66"
"77.197.210.160","59191","41.177.26.176","80","18","12725","7","744","11","11981","3.565934000","0.6571","9058.38","145871.60"
"77.197.128.41","14763","41.177.26.176","80","20","12548","8","816","12","11732","202.676330000","0.6571","9935.18","142842.58"
"77.197.217.152","17619","41.177.26.176","80","22","12837","10","953","12","11884","76.412820000","0.6569","11605.66","144723.64"
"77.197.210.159","29680","41.177.26.176","80","22","13315","9","887","13","12428","85.876205000","0.6568","10803.09","151365.08"
"77.197.128.225","24904","41.177.26.176","80","19","13094","8","825","11","12269","233.016339000","0.6567","10049.84","149456.32"
"77.197.210.67","16181","41.177.26.176","80","21","13324","8","815","13","12509","51.104007000","0.6567","9928.52","152387.57"
"77.197.210.67","18846","41.177.26.176","80","22","13098","9","880","13","12218","58.884250000","0.6565","10722.98","148878.81"
"77.197.210.2","54396","41.177.26.176","80","20","12853","8","862","12","11991","91.153041000","0.6565","10504.28","146121.67"
"77.197.210.217","23911","41.177.26.15","80","8","1081","5","690","3","391","58.289286000","0.6562","8411.97","4766.78"
"77.197.210.186","31840","41.177.26.176","80","21","13580","9","880","12","12700","55.414368000","0.6561","10730.27","154857.28"
"77.197.217.224","3285","41.177.26.176","80","19","12729","8","812","11","11917","97.293828000","0.6560","9901.68","145318.19"
"77.197.128.18","33031","41.177.26.176","80","19","13379","7","752","12","12627","197.092084000","0.6560","9170.73","153987.80"
"77.197.210.48","43979","41.177.26.176","80","22","13234","10","939","12","12295","5.279457000","0.6559","11452.25","149952.51"
"77.197.210.198","25141","41.177.26.176","80","21","12757","8","816","13","11941","5.721503000","0.6559","9952.46","145640.16"
"77.197.128.18","62826","41.177.26.176","80","22","13395","9","881","13","12514","144.749957000","0.6559","10745.64","152634.42"
"77.197.128.251","42849","41.177.26.176","80","19","12512","8","825","11","11687","19.205746000","0.6558","10063.80","142564.38"
"244.3.160.239","62310","128.71.90.164","80","50","41930","20","2476","30","39454","148.651752000","0.6557","30206.91","481334.18"
"77.197.128.18","48185","41.177.26.176","80","20","12757","8","815","12","11942","230.362413000","0.6557","9943.36","145697.67"
"77.197.128.224","36281","41.177.26.176","80","22","13407","9","889","13","12518","203.619442000","0.6554","10851.12","152794.56"
"244.3.160.239","62254","40.248.176.156","80","81","68964","30","3330","51","65634","136.254432000","0.6553","40652.02","801247.64"
"77.197.217.152","23913","41.177.26.176","80","21","12409","9","926","12","11483","93.711484000","0.6553","11304.73","140185.96"
"77.197.128.223","55069","41.177.26.176","80","21","12949","9","925","12","12024","159.335479000","0.6553","11293.18","146799.07"
"253.37.253.43","2000","253.160.31.248","515","77","59502","77","59502","0","0","104.072891000","0.6552","726541.22","N/A"
"41.177.3.224","39050","41.177.117.184","1606","93","37736","48","23470","45","14266","200.035721000","0.6551","286629.36","174224.73"
"77.197.128.139","29171","41.177.26.176","80","21","13621","8","825","13","12796","96.969524000","0.6550","10075.80","156278.67"
"77.197.128.31","3300","41.177.26.176","80","21","12831","8","811","13","12020","36.437487000","0.6550","9905.59","146812.75"
"77.197.210.82","58956","41.177.26.176","80","19","12883","7","796","12","12087","184.584000000","0.6549","9723.87","147653.86"
"77.197.210.123","58171","41.177.26.176","80","17","12477","6","693","11","11784","66.451137000","0.6548","8466.15","143961.22"
"77.197.210.198","24966","41.177.26.176","80","21","13211","8","815","13","12396","4.920304000","0.6548","9956.62","151438.29"
"77.197.210.198","24406","41.177.26.176","80","18","12584","7","761","11","11823","2.482002000","0.6547","9298.92","144469.22"
"77.197.128.118","7989","41.177.26.176","80","21","13715","9","880","12","12835","205.020228000","0.6547","10753.66","156844.53"
"77.197.210.123","58511","41.177.26.176","80","20","12758","8","860","12","11898","67.261155000","0.6546","10510.70","145414.32"
"77.197.128.118","64829","41.177.26.176","80","22","12992","9","889","13","12103","192.285076000","0.6543","10869.50","147979.24"
"77.197.210.82","36682","41.177.26.176","80","19","12753","7","744","12","12009","131.335416000","0.6542","9097.68","146846.77"
"77.197.217.20","39093","41.177.26.176","80","23","14396","10","951","13","13445","37.185563000","0.6542","11629.49","164414.80"
"77.197.128.223","28006","41.177.26.176","80","20","13433","8","816","12","12617","228.779554000","0.6540","9981.83","154339.22"
"16.176.93.164","8550","244.3.160.239","80","10","2263","5","1476","5","787","222.312332000","0.6539","18056.92","9627.91"
"77.197.128.13","38284","41.177.26.176","80","22","13007","9","880","13","12127","117.845663000","0.6538","10767.44","148382.67"
"77.197.210.128","33572","41.177.26.176","80","21","12859","9","879","12","11980","45.577579000","0.6537","10757.06","146609.35"
"77.197.210.181","40030","41.177.26.176","80","20","12915","8","815","12","12100","4.061465000","0.6537","9974.36","148085.60"
"77.197.210.82","45520","41.177.26.176","80","19","12767","8","825","11","11942","154.495644000","0.6535","10099.11","146186.13"
"77.197.128.13","1887","41.177.26.176","80","20","12863","8","825","12","12038","231.269093000","0.6533","10102.02","147403.71"
"77.197.128.127","36769","41.177.26.176","80","20","12819","7","761","13","12058","11.445561000","0.6531","9321.31","147695.62"
"77.197.128.55","26478","41.177.26.176","80","23","14206","10","944","13","13262","187.238653000","0.6530","11565.76","162484.19"
"77.197.128.167","59181","41.177.26.176","80","21","13038","9","880","12","12158","17.014923000","0.6528","10784.81","149001.95"
"77.197.210.122","44405","41.177.26.176","80","20","12592","8","816","12","11776","55.634784000","0.6527","10000.87","144326.33"
"77.197.128.41","3518","41.177.26.176","80","20","12683","8","812","12","11871","186.728306000","0.6527","9952.02","145493.10"
"77.197.128.18","65017","41.177.26.176","80","20","12977","9","889","11","12088","151.420934000","0.6527","10896.51","148163.13"
"77.197.128.13","58017","41.177.26.176","80","20","12995","8","816","12","12179","193.831554000","0.6527","10001.81","149279.43"
"41.177.230.253","44010","244.3.31.40","22","52","17029","26","5536","26","11493","148.142524000","0.6526","67862.79","140886.38"
"77.197.128.94","34290","41.177.26.176","80","20","12860","8","826","12","12034","3.087052000","0.6526","10125.67","147520.91"
"16.176.93.164","15913","244.3.160.239","80","12","2630","6","1387","6","1243","18.406023000","0.6526","17003.15","15237.86"
"77.197.210.67","19217","41.177.26.176","80","21","13549","8","862","13","12687","60.543432000","0.6526","10567.45","155532.74"
"77.197.128.225","1988","41.177.26.176","80","21","12712","9","876","12","11836","198.345494000","0.6525","10739.57","145106.81"
"77.197.128.94","34720","41.177.26.176","80","21","12938","9","924","12","12014","4.082719000","0.6525","11328.25","147291.76"
"77.197.210.122","20019","41.177.26.176","80","19","13375","8","860","11","12515","4.139126000","0.6524","10545.31","153458.72"
"77.197.210.186","4173","41.177.26.176","80","18","12464","7","761","11","11703","4.371156000","0.6524","9331.61","143505.73"
"68.33.110.176","16141","244.3.160.239","80","56","48226","15","1956","41","46270","128.485426000","0.6523","23988.19","567450.69"
"77.197.128.13","42437","41.177.26.176","80","19","12676","8","825","11","11851","132.664449000","0.6521","10121.50","145393.87"
"77.197.210.186","28581","41.177.26.176","80","20","12584","8","816","12","11768","49.931766000","0.6521","10011.09","144375.59"
"77.197.128.180","58350","41.177.26.176","80","21","13863","8","862","13","13001","46.611627000","0.6520","10576.30","159515.60"
"77.197.128.55","22813","41.177.26.176","80","20","12964","8","812","12","12152","167.083739000","0.6519","9965.36","149136.78"
"77.197.128.31","64342","41.177.26.176","80","20","12775","8","815","12","11960","27.725566000","0.6517","10004.30","146811.51"
"77.197.217.218","58526","41.177.26.176","80","22","13387","10","951","12","12436","73.335050000","0.6516","11675.55","152678.41"
"77.197.217.218","57718","41.177.26.176","80","20","12669","7","748","13","11921","71.617922000","0.6516","9183.60","146360.63"
"77.197.128.84","36610","41.177.26.176","80","20","12588","8","812","12","11776","171.716952000","0.6515","9971.08","144605.24"
"77.197.128.13","34661","41.177.26.176","80","21","12761","10","941","11","11820","106.830788000","0.6515","11555.33","145147.77"
"77.197.128.223","17792","41.177.26.176","80","24","14451","10","951","14","13500","208.302222000","0.6514","11680.05","165805.15"
"77.197.128.41","65359","41.177.26.176","80","20","13177","8","860","12","12317","183.908928000","0.6512","10564.70","151308.69"
"77.197.128.224","57899","41.177.26.176","80","21","12670","8","826","13","11844","157.011804000","0.6512","10147.62","145506.59"
"77.197.128.118","10994","41.177.26.176","80","20","12823","8","817","12","12006","206.612673000","0.6511","10037.98","147510.39"
"77.197.210.160","58808","41.177.26.176","80","22","12710","9","880","13","11830","1.954805000","0.6510","10813.68","145370.31"
"77.197.210.123","36895","41.177.26.176","80","21","12924","8","823","13","12101","0.799903000","0.6509","10115.63","148735.39"
"77.197.210.160","58639","41.177.26.176","80","20","12986","8","825","12","12161","1.197393000","0.6508","10142.02","149499.51"
"77.197.128.224","39320","41.177.26.176","80","20","13292","8","816","12","12476","206.565717000","0.6506","10033.41","153403.03"
"77.197.210.122","47037","41.177.26.176","80","20","13155","9","880","11","12275","64.398481000","0.6506","10820.61","150935.28"
"77.197.217.20","59452","41.177.26.176","80","19","12639","8","816","11","11823","77.978824000","0.6505","10034.91","145395.52"
"77.197.210.82","59426","41.177.26.176","80","20","13260","7","762","13","12498","186.803002000","0.6505","9370.96","153698.58"
"15.186.110.41","47751","244.3.210.197","80","26","15974","13","1397","13","14577","156.066896000","0.6504","17183.99","179306.34"
"77.197.210.80","33716","41.177.26.176","80","20","12717","7","761","13","11956","50.890623000","0.6502","9363.58","147110.26"
"77.197.128.167","61219","41.177.26.176","80","20","12794","8","816","12","11978","21.455996000","0.6501","10041.25","147394.78"
"77.197.128.18","25343","41.177.26.176","80","19","12359","8","816","11","11543","183.544151000","0.6501","10041.52","142045.62"
"77.197.210.198","41453","41.177.26.176","80","19","12931","8","816","11","12115","45.851345000","0.6498","10045.49","149143.49"
"77.197.128.12","38601","41.177.26.176","80","21","13232","9","924","12","12308","35.698800000","0.6496","11380.17","151587.79"
"77.197.128.225","3987","41.177.26.176","80","20","13086","8","821","12","12265","200.766290000","0.6495","10111.88","151062.38"
"15.186.110.41","60381","244.3.210.197","80","26","14414","13","1371","13","13043","2.683910000","0.6495","16886.39","160648.61"
"77.197.128.47","15489","41.177.26.176","80","22","13464","8","823","14","12641","114.405103000","0.6495","10137.36","155706.34"
"77.197.210.67","15885","41.177.26.176","80","20","12585","8","815","12","11770","50.299429000","0.6494","10039.65","144989.80"
"77.197.217.152","23034","41.177.26.176","80","20","12708","9","890","11","11818","89.428942000","0.6494","10963.61","145581.99"
"77.197.128.12","35092","41.177.26.176","80","22","13117","9","880","13","12237","29.222811000","0.6493","10842.01","150765.56"
"77.197.128.139","29073","41.177.26.176","80","21","13027","9","872","12","12155","96.156823000","0.6492","10746.00","149790.81"
"77.197.128.41","11202","41.177.26.176","80","21","13002","9","881","12","12121","195.138224000","0.6491","10858.71","149396.67"
"77.197.128.251","62707","41.177.26.176","80","23","15722","9","880","14","14842","65.962775000","0.6490","10848.04","182962.10"
"77.197.128.18","65506","41.177.26.176","80","21","13512","9","880","12","12632","153.062588000","0.6489","10848.31","155722.56"
"77.197.217.224","64091","41.177.26.176","80","22","12730","9","889","13","11841","84.669065000","0.6487","10964.16","146036.67"
"77.197.128.251","44648","41.177.26.176","80","21","12944","9","876","12","12068","24.216310000","0.6484","10808.08","148894.82"
"77.197.128.13","63543","41.177.26.176","80","22","13446","9","881","13","12565","217.324520000","0.6484","10869.92","155028.96"
"77.197.128.180","59081","41.177.26.176","80","20","12697","7","748","13","11949","49.007281000","0.6484","9229.21","147432.97"
"77.197.128.223","24576","41.177.26.176","80","22","13680","9","881","13","12799","221.308237000","0.6484","10870.25","157920.96"
"77.197.128.31","58683","41.177.26.176","80","21","12587","8","812","13","11775","0.103670000","0.6482","10022.36","145336.50"
"77.197.128.55","59166","41.177.26.176","80","20","12698","8","816","12","11882","102.738202000","0.6481","10071.85","146658.99"
"77.197.210.128","39958","41.177.26.176","80","19","13133","8","862","11","12271","59.842338000","0.6481","10640.94","151479.10"
"77.197.210.159","28750","41.177.26.176","80","22","13401","9","880","13","12521","83.563192000","0.6476","10870.82","154674.53"
"77.197.128.12","37819","41.177.26.176","80","22","13433","9","926","13","12507","34.147285000","0.6475","11440.31","154518.29"
"77.197.128.47","19548","41.177.26.176","80","18","13034","7","751","11","12283","122.189286000","0.6474","9280.74","151791.42"
"77.197.128.223","29194","41.177.26.176","80","20","12594","9","881","11","11713","231.217530000","0.6473","10887.51","144750.81"
"77.197.128.13","43760","41.177.26.176","80","21","13142","9","889","12","12253","136.312639000","0.6471","10991.42","151493.70"
"77.197.128.13","36967","41.177.26.176","80","21","13135","9","924","12","12211","112.778577000","0.6468","11428.89","151036.98"
"77.197.128.18","37943","41.177.26.176","80","21","12846","8","860","13","11986","215.413634000","0.6467","10638.58","148272.08"
"77.197.128.55","21936","41.177.26.176","80","18","12581","7","799","11","11782","164.010085000","0.6467","9884.62","145757.98"
"77.197.210.186","32627","41.177.26.176","80","21","12744","8","826","13","11918","57.044495000","0.6465","10220.84","147472.17"
"244.3.160.239","62440","94.2.202.203","80","71","60502","26","2512","45","57990","165.699736000","0.6465","31086.46","717636.96"
"77.197.217.20","38200","41.177.26.176","80","20","12682","8","823","12","11859","31.732541000","0.6464","10185.85","146772.75"
"77.197.210.181","54661","41.177.26.176","80","19","12662","8","825","11","11837","53.948179000","0.6464","10210.60","146500.47"
"77.197.128.47","20473","41.177.26.176","80","20","12861","8","823","12","12038","123.970037000","0.6463","10187.77","149016.27"
"77.197.210.123","37978","41.177.26.176","80","19","12715","7","751","12","11964","4.058546000","0.6462","9297.66","148118.80"
"77.197.128.180","7025","41.177.26.176","80","22","13106","9","889","13","12217","85.897016000","0.6461","11007.11","151264.15"
"194.66.204.111","1101","244.3.41.84","23","5","2843","2","219","3","2624","188.845814000","0.6461","2711.85","32492.64"
"77.197.210.122","43264","41.177.26.176","80","20","12720","8","816","12","11904","53.202711000","0.6456","10111.81","147513.41"
"77.197.128.180","11559","41.177.26.176","80","21","12654","8","824","13","11830","93.056497000","0.6453","10215.20","146657.51"
"77.197.128.18","33164","41.177.26.176","80","21","12787","8","825","13","11962","154.201851000","0.6452","10228.61","148308.64"
"77.197.128.180","11075","41.177.26.176","80","19","12539","7","751","12","11788","90.820721000","0.6452","9311.18","146152.01"
"77.197.210.128","17496","41.177.26.176","80","20","13059","8","815","12","12244","3.027607000","0.6452","10104.85","151808.26"
"77.197.210.67","58737","41.177.26.176","80","23","13260","10","953","13","12307","6.657124000","0.6452","11816.71","152600.48"
"77.197.210.159","33906","41.177.26.176","80","20","13316","8","860","12","12456","96.809851000","0.6451","10665.10","154470.27"
"77.197.128.41","22742","41.177.26.176","80","21","13215","8","812","13","12403","224.594448000","0.6450","10071.61","153840.19"
"77.197.128.223","21344","41.177.26.176","80","21","12729","9","887","12","11842","214.068368000","0.6449","11002.97","146896.42"
"77.197.210.2","52860","41.177.26.176","80","24","14455","10","952","14","13503","87.263466000","0.6448","11811.71","167535.17"
"77.197.128.223","58083","41.177.26.176","80","22","13090","9","924","13","12166","163.134568000","0.6446","11466.94","150981.33"
"77.197.128.55","24663","41.177.26.176","80","20","12748","8","815","12","11933","175.453162000","0.6444","10117.36","148135.50"
"77.197.128.224","30301","41.177.26.176","80","18","12718","7","761","11","11957","196.180063000","0.6444","9447.15","148435.74"
"77.197.210.198","46421","41.177.26.176","80","19","12867","7","759","12","12108","58.221430000","0.6443","9423.96","150336.40"
"77.197.210.123","55428","41.177.26.176","80","21","13038","8","812","13","12226","57.652286000","0.6442","10083.32","151821.08"
"77.197.210.2","49101","41.177.26.176","80","19","12644","7","751","12","11893","78.375707000","0.6441","9327.16","147707.02"
"77.197.128.118","4623","41.177.26.176","80","23","12995","9","880","14","12115","197.110114000","0.6440","10932.29","150505.31"
"77.197.128.18","32575","41.177.26.176","80","20","12581","9","879","11","11702","150.900983000","0.6439","10920.32","145380.68"
"244.3.160.239","61343","198.123.241.156","80","13","2571","7","1321","6","1250","12.034775000","0.6439","16413.46","15531.28"
"77.197.128.18","32869","41.177.26.176","80","20","12971","8","823","12","12148","152.570685000","0.6438","10226.32","150946.91"
"77.197.217.224","42715","41.177.26.176","80","21","13476","8","814","13","12662","33.652103000","0.6437","10115.95","157356.43"
"244.3.160.239","62656","177.124.75.164","80","89","77519","33","3783","56","73736","211.989135000","0.6437","47015.84","916404.90"
"77.197.128.127","46455","41.177.26.176","80","19","12837","7","799","12","12038","25.894610000","0.6433","9936.25","149702.86"
"77.197.128.223","27230","41.177.26.176","80","21","12747","8","816","13","11931","227.283566000","0.6433","10148.12","148378.91"
"77.197.128.47","7542","41.177.26.176","80","24","13691","11","1052","13","12639","102.885571000","0.6431","13085.88","157217.14"
"77.197.210.123","39096","41.177.26.176","80","19","12928","8","862","11","12066","7.058723000","0.6430","10723.94","150110.33"
"77.197.128.13","42752","41.177.26.176","80","19","13099","8","825","11","12274","133.407811000","0.6428","10267.80","152760.02"
"77.197.128.47","14155","41.177.26.176","80","20","12851","8","825","12","12026","111.700637000","0.6426","10270.46","149712.12"
"77.197.128.143","34015","41.177.26.91","80","25","19471","10","988","15","18483","132.551463000","0.6425","12301.37","230127.78"
"15.186.110.41","51526","244.3.210.197","80","29","17752","14","1505","15","16247","192.256213000","0.6424","18740.90","202314.60"
"77.197.128.139","27780","41.177.26.176","80","22","13115","9","890","13","12225","89.537106000","0.6424","11084.27","152252.97"
"77.197.210.198","43238","41.177.26.176","80","21","12620","9","875","12","11745","50.664059000","0.6423","10897.86","146280.41"
"77.197.128.41","64468","41.177.26.176","80","20","12588","8","825","12","11763","182.365214000","0.6423","10275.78","146513.94"
"77.197.217.20","32994","41.177.26.176","80","21","12670","8","816","13","11854","15.587436000","0.6422","10164.57","147660.27"
"77.197.128.13","52475","41.177.26.176","80","19","12512","8","816","11","11696","169.721056000","0.6421","10166.15","145714.82"
"77.197.128.55","4743","41.177.26.176","80","22","13047","8","862","14","12185","125.374353000","0.6420","10740.61","151826.42"
"77.197.128.55","62253","41.177.26.176","80","22","13378","9","879","13","12499","108.636320000","0.6420","10952.73","155743.02"
"77.197.128.94","35619","41.177.26.176","80","20","12667","8","811","12","11856","6.288885000","0.6420","10106.49","147746.60"
"77.197.217.224","1038","41.177.26.176","80","18","12413","7","751","11","11662","91.168677000","0.6419","9359.51","145340.34"
"77.197.128.106","44429","41.177.26.15","80","135","131811","45","2880","90","128931","0.034206000","0.6419","35893.67","1606877.13"
"77.197.217.218","61602","41.177.26.176","80","19","12622","7","751","12","11871","86.567834000","0.6417","9362.47","147991.85"
"77.197.217.218","41651","41.177.26.15","80","15","9397","7","805","8","8592","191.742847000","0.6417","10036.56","107123.15"
"77.197.128.41","24120","41.177.26.176","80","20","12600","8","825","12","11775","226.923723000","0.6414","10290.14","146868.29"
"77.197.128.18","26283","41.177.26.176","80","24","15778","10","953","14","14825","188.509972000","0.6413","11887.61","184925.31"
"77.197.128.46","29587","41.177.26.176","80","21","12928","8","860","13","12068","152.218141000","0.6413","10728.83","150552.89"
"242.161.82.241","59552","244.3.210.197","80","26","17667","11","1183","15","16484","151.969567000","0.6413","14758.47","205645.46"
"77.197.210.122","45493","41.177.26.176","80","21","12939","9","880","12","12059","59.551409000","0.6411","10980.48","150469.95"
"77.197.128.18","31453","41.177.26.176","80","20","13264","8","815","12","12449","145.614290000","0.6406","10177.34","155457.29"
"77.197.210.82","38672","41.177.26.176","80","20","12508","8","860","12","11648","134.508564000","0.6405","10740.97","145477.71"
"77.197.217.224","1962","41.177.26.176","80","20","12761","8","811","12","11950","95.638347000","0.6404","10131.01","149279.37"
"77.197.128.224","16210","41.177.26.176","80","21","13107","8","860","13","12247","180.806406000","0.6403","10745.28","153020.31"
"16.176.93.164","10372","244.3.160.239","80","19","8890","8","1594","11","7296","122.514558000","0.6401","19921.86","91185.61"
"77.197.217.20","59692","41.177.26.176","80","19","12913","7","759","12","12154","78.810532000","0.6401","9486.15","151903.40"
"77.197.128.118","45121","41.177.26.176","80","19","12630","8","816","11","11814","151.341534000","0.6401","10198.96","147660.00"
"168.223.67.89","2669","244.3.210.197","80","10","3597","7","1337","3","2260","17.916742000","0.6400","16712.19","28249.47"
"77.197.128.139","58181","41.177.26.176","80","19","13118","7","796","12","12322","20.785222000","0.6400","9950.62","154034.63"
"77.197.128.46","30409","41.177.26.176","80","22","13578","9","889","13","12689","156.888777000","0.6399","11114.84","158645.96"
"77.197.217.20","60283","41.177.26.176","80","22","13398","9","879","13","12519","81.818365000","0.6397","10991.83","156549.14"
"77.197.210.2","49535","41.177.26.176","80","19","13113","7","753","12","12360","79.132573000","0.6397","9416.68","154568.59"
"77.197.128.18","49299","41.177.26.176","80","18","13002","7","759","11","12243","231.886130000","0.6396","9493.37","153132.25"
"77.197.210.82","59289","41.177.26.176","80","20","13398","8","825","12","12573","186.011293000","0.6396","10319.34","157266.69"
"77.197.210.128","29777","41.177.26.176","80","20","12707","7","761","13","11946","39.873404000","0.6395","9520.31","149447.59"
"77.197.128.223","3754","41.177.26.176","80","20","13133","8","816","12","12317","174.231787000","0.6394","10209.01","154098.54"
"77.197.128.180","60459","41.177.26.176","80","22","12988","9","872","13","12116","53.174938000","0.6394","10910.69","151598.52"
"77.197.210.2","53695","41.177.26.176","80","22","13653","9","876","13","12777","89.506586000","0.6393","10962.11","159889.13"
"77.197.210.159","31839","41.177.26.176","80","18","12711","7","759","11","11952","93.767790000","0.6392","9499.58","149590.26"
"77.197.210.48","5850","41.177.26.176","80","20","13068","7","760","13","12308","62.252147000","0.6389","9515.76","154105.24"
"77.197.210.67","18124","41.177.26.176","80","19","12691","7","752","12","11939","56.028764000","0.6388","9418.23","149526.97"
"77.197.128.254","45111","41.177.26.176","80","19","12926","8","825","11","12101","75.381138000","0.6386","10334.83","151590.08"
"77.197.217.20","36038","41.177.26.176","80","19","12507","7","751","12","11756","22.169353000","0.6384","9410.41","147308.60"
"77.197.128.251","40624","41.177.26.176","80","21","12844","9","875","12","11969","14.609179000","0.6383","10966.17","150004.62"
"77.197.128.223","64478","41.177.26.176","80","19","12529","8","823","11","11706","170.451512000","0.6383","10314.77","146712.87"
"77.197.128.127","50217","41.177.26.176","80","21","13207","9","879","12","12328","35.095289000","0.6382","11018.40","154533.42"
"77.197.210.128","17237","41.177.26.176","80","20","13213","8","823","12","12390","2.274230000","0.6382","10316.98","155318.87"
"77.197.128.18","63212","41.177.26.176","80","22","13391","9","880","13","12511","145.601409000","0.6381","11031.99","156842.34"
"77.197.210.181","39071","41.177.26.176","80","19","12860","7","759","12","12101","1.796738000","0.6381","9515.94","151715.99"
"77.197.128.224","25008","41.177.26.176","80","21","12643","8","815","13","11828","189.043759000","0.6381","10218.15","148294.88"
"77.197.128.47","13383","41.177.26.176","80","22","13093","9","876","13","12217","109.906963000","0.6380","10983.55","153180.42"
"77.197.128.18","20823","41.177.26.176","80","20","12725","8","816","12","11909","176.812409000","0.6379","10233.39","149349.75"
"77.197.128.118","46487","41.177.26.176","80","19","13078","8","812","11","12266","156.693382000","0.6377","10186.11","153870.52"
"77.197.128.41","7346","41.177.26.176","80","19","12630","8","816","11","11814","192.807330000","0.6376","10238.67","148234.82"
"77.197.128.47","18100","41.177.26.176","80","20","13253","8","862","12","12391","119.878633000","0.6376","10816.02","155477.10"
"244.3.160.254","62152","41.177.26.211","2641","36","3056","18","1412","18","1644","116.058066000","0.6374","17721.27","20632.98"
"77.197.128.18","30760","41.177.26.176","80","22","12831","9","876","13","11955","193.557076000","0.6373","10996.08","150066.37"
"77.197.128.251","44061","41.177.26.176","80","22","13661","9","887","13","12774","22.377749000","0.6372","11136.87","160385.96"
"77.197.210.82","15866","41.177.26.15","80","28","20641","12","1071","16","19570","71.339207000","0.6372","13447.17","245715.36"
"242.161.82.241","53133","244.3.210.197","80","23","15270","10","1170","13","14100","105.991991000","0.6371","14692.63","177065.05"
"77.197.128.225","12119","41.177.26.176","80","20","13124","8","807","12","12317","212.792247000","0.6369","10137.09","154719.42"
"77.197.128.224","19224","41.177.26.176","80","21","13443","9","924","12","12519","183.131092000","0.6368","11607.99","157273.13"
"77.197.128.18","38306","41.177.26.176","80","21","12668","8","813","13","11855","218.597843000","0.6368","10214.31","148942.92"
"77.197.128.193","49770","41.177.26.176","80","19","12654","8","825","11","11829","224.199345000","0.6367","10365.33","148620.00"
"77.197.128.176","27118","41.177.26.176","80","22","13371","9","887","13","12484","26.063874000","0.6366","11145.95","156872.60"
"16.176.93.164","13487","244.3.160.239","80","10","2668","5","1512","5","1156","120.612787000","0.6366","19000.79","14527.06"
"77.197.128.223","65062","41.177.26.176","80","22","12733","9","889","13","11844","171.201868000","0.6366","11172.06","148843.52"
"77.197.128.180","12200","41.177.26.176","80","20","12755","8","860","12","11895","97.119014000","0.6366","10807.62","149484.44"
"77.197.128.224","33548","41.177.26.176","80","20","12787","8","812","12","11975","200.348701000","0.6364","10207.91","150541.59"
"77.197.128.13","61390","41.177.26.176","80","20","12693","8","816","12","11877","206.699615000","0.6362","10261.65","149359.83"
"77.197.128.225","5503","41.177.26.176","80","22","13004","9","879","13","12125","205.021223000","0.6361","11054.62","152488.39"
"77.197.210.181","38294","41.177.26.176","80","21","13044","8","823","13","12221","0.175613000","0.6361","10350.82","153702.73"
"77.197.128.13","46672","41.177.26.176","80","22","13458","9","926","13","12532","148.067269000","0.6360","11648.20","157640.67"
"77.197.210.67","19984","41.177.26.176","80","20","12709","8","825","12","11884","65.259108000","0.6360","10378.11","149495.09"
"77.197.128.12","34260","41.177.26.176","80","20","12973","8","823","12","12150","27.565334000","0.6358","10354.77","152868.17"
"77.197.128.55","21595","41.177.26.176","80","21","12935","8","815","13","12120","163.174007000","0.6358","10255.54","152511.82"
"77.197.128.41","25365","41.177.26.176","80","19","12526","7","751","12","11775","230.222917000","0.6357","9450.79","148179.84"
"77.197.128.12","37325","41.177.26.176","80","18","12861","7","748","11","12113","33.299277000","0.6356","9414.25","152452.99"
"77.197.128.167","57598","41.177.26.176","80","21","13057","9","880","12","12177","14.127739000","0.6355","11078.66","153300.94"
"77.197.128.41","16615","41.177.26.176","80","22","12919","9","876","13","12043","210.428699000","0.6355","11028.34","151614.44"
"41.177.92.61","2158","41.177.98.176","80","20","8596","10","5753","10","2843","230.281257000","0.6354","72430.15","35793.31"
"244.3.160.239","62193","94.2.202.203","80","71","60803","26","2552","45","58251","122.091972000","0.6352","32143.44","733694.09"
"77.197.128.46","29406","41.177.26.176","80","20","12885","8","815","12","12070","151.408499000","0.6351","10265.52","152030.43"
"77.197.128.13","42089","41.177.26.176","80","20","12761","9","924","11","11837","131.809553000","0.6351","11640.01","149115.58"
"77.197.128.46","24670","41.177.26.176","80","20","12715","9","889","11","11826","135.505846000","0.6350","11199.61","148983.81"
"77.197.210.249","14955","41.177.26.176","80","20","12982","8","823","12","12159","58.078831000","0.6349","10369.45","153198.24"
"77.197.210.198","49793","41.177.26.176","80","20","12576","8","815","12","11761","65.321117000","0.6349","10269.04","148189.21"
"77.197.128.41","63142","41.177.26.176","80","20","12714","9","888","11","11826","178.866253000","0.6349","11189.30","149014.32"
"77.197.210.123","38449","41.177.26.176","80","21","14178","8","823","13","13355","5.434773000","0.6347","10372.93","168323.80"
"15.186.110.41","36668","244.3.210.197","80","26","16743","13","1411","13","15332","47.537677000","0.6345","17789.49","193301.52"
"77.197.128.72","31260","41.177.26.176","80","20","12962","9","889","11","12073","162.427102000","0.6344","11210.52","152243.68"
"77.197.128.139","56593","41.177.26.176","80","20","12798","8","825","12","11973","17.305129000","0.6344","10403.86","150988.37"
"68.33.110.176","6511","244.3.160.239","80","91","64830","31","2955","60","61875","122.079397000","0.6343","37267.14","780339.85"
"77.197.128.12","34657","41.177.26.176","80","20","13431","9","924","11","12507","28.454701000","0.6343","11653.63","157740.16"
"244.3.160.239","62541","30.222.71.108","80","15","6981","8","1526","7","5455","197.229016000","0.6342","19250.94","68816.42"
"77.197.210.48","44125","41.177.26.176","80","22","13281","9","880","13","12401","6.146468000","0.6341","11103.10","156465.43"
"68.33.110.176","10758","244.3.160.239","80","84","62536","24","2376","60","60160","165.687514000","0.6340","29981.21","759120.31"
"77.197.128.223","28780","41.177.26.176","80","21","12624","9","877","12","11747","230.371988000","0.6338","11068.88","148262.44"
"77.197.128.18","62436","41.177.26.176","80","22","13256","9","887","13","12369","143.891246000","0.6338","11195.87","156123.73"
"77.197.128.142","28512","41.177.26.15","80","14","9337","6","742","8","8595","118.391038000","0.6337","9366.82","108501.15"
"77.197.128.18","31248","41.177.26.176","80","21","12738","8","816","13","11922","144.795592000","0.6336","10303.39","150535.53"
"77.197.128.12","30903","41.177.26.176","80","20","12997","9","880","11","12117","20.644059000","0.6335","11113.37","153023.58"
"77.197.217.224","34418","41.177.26.176","80","21","12966","9","926","12","12040","15.184613000","0.6334","11694.87","152058.60"
"77.197.210.2","56244","41.177.26.176","80","20","12709","7","744","13","11965","96.824310000","0.6334","9396.33","151111.63"
"77.197.128.167","61619","41.177.26.176","80","21","12744","8","812","13","11932","22.272412000","0.6332","10258.53","150744.83"
"77.197.128.72","35741","41.177.26.176","80","20","12696","9","880","11","11816","187.909636000","0.6332","11118.53","149291.59"
"77.197.128.92","19194","41.177.26.176","80","20","13154","9","872","11","12282","217.256431000","0.6332","11017.65","155182.05"
"77.197.128.55","23184","41.177.26.176","80","21","13233","8","816","13","12417","168.692163000","0.6329","10313.66","156942.05"
"77.197.210.198","24200","41.177.26.176","80","19","12795","8","860","11","11935","1.674246000","0.6328","10873.07","150895.45"
"77.197.217.218","60587","41.177.26.176","80","22","12975","9","879","13","12096","80.832866000","0.6326","11116.63","152976.92"
"77.197.128.72","18859","41.177.26.176","80","23","14308","10","953","13","13355","99.983964000","0.6325","12052.97","168906.05"
"77.197.128.193","52630","41.177.26.176","80","22","13289","9","924","13","12365","230.960498000","0.6324","11688.42","156414.79"
"77.197.128.193","48022","41.177.26.176","80","20","12739","7","762","13","11977","221.871969000","0.6324","9639.53","151512.66"
"77.197.210.2","53245","41.177.26.176","80","20","12700","7","748","13","11952","88.061633000","0.6324","9462.81","151202.62"
"77.197.128.55","23813","41.177.26.176","80","19","13073","8","825","11","12248","171.103971000","0.6322","10440.30","154997.26"
"77.197.217.224","39609","41.177.26.176","80","21","12769","8","813","13","11956","26.339224000","0.6321","10289.95","151324.29"
"77.197.210.80","38458","41.177.26.176","80","21","12762","8","825","13","11937","61.135795000","0.6319","10443.90","151113.70"
"77.197.128.46","27362","41.177.26.176","80","22","12976","9","877","13","12099","144.112686000","0.6319","11103.87","153187.77"
"77.197.128.84","35573","41.177.26.176","80","21","12654","9","889","12","11765","168.051931000","0.6318","11257.40","148980.15"
"77.197.128.139","60105","41.177.26.176","80","20","12840","8","825","12","12015","28.535986000","0.6317","10448.30","152165.17"
"77.197.217.20","61400","41.177.26.176","80","20","13488","8","815","12","12673","89.200668000","0.6317","10321.80","160500.77"
"77.197.128.41","58756","41.177.26.176","80","19","12749","8","812","11","11937","166.738963000","0.6316","10285.77","151208.45"
"244.3.56.90","4742","244.3.160.239","80","475","347234","161","11590","314","335644","16.450405000","0.6315","146835.48","4252325.19"
"77.197.128.176","29497","41.177.26.176","80","20","12796","8","862","12","11934","34.185973000","0.6315","10920.90","151194.87"
"77.197.128.18","46049","41.177.26.176","80","22","12863","9","880","13","11983","227.912478000","0.6314","11149.05","151817.10"
"77.197.128.13","40612","41.177.26.176","80","20","12649","8","814","12","11835","128.752303000","0.6314","10313.36","149949.16"
"15.186.110.41","45793","244.3.210.197","80","22","12702","11","1229","11","11473","136.889888000","0.6314","15571.70","145365.39"
"77.197.128.224","28305","41.177.26.176","80","21","12666","8","825","13","11841","193.332157000","0.6313","10455.00","150057.74"
"77.197.217.20","38672","41.177.26.176","80","20","12865","8","824","12","12041","34.340747000","0.6313","10442.66","152597.12"
"77.197.128.13","37852","41.177.26.176","80","23","13145","10","951","13","12194","116.077752000","0.6309","12059.25","154627.23"
"253.160.251.90","1572","253.37.253.43","446","119","155343","0","0","119","155343","162.050321000","0.6308","N/A","1970089.06"
"77.197.210.186","36601","41.177.26.176","80","20","12795","7","750","13","12045","67.264429000","0.6308","9511.99","152762.52"
"77.197.128.13","48247","41.177.26.176","80","20","12552","8","812","12","11740","155.445228000","0.6303","10307.02","149020.23"
"77.197.128.176","29786","41.177.26.176","80","21","12658","9","876","12","11782","37.229574000","0.6302","11119.89","149560.00"
"77.197.128.41","54793","41.177.26.176","80","20","12966","8","815","12","12151","154.282875000","0.6302","10345.63","154245.04"
"244.3.160.239","62183","244.3.31.75","80","43","35921","17","2157","26","33764","121.508833000","0.6302","27381.70","428611.78"
"253.160.251.85","44828","253.37.253.43","446","440","610799","0","0","440","610799","125.553874000","0.6302","N/A","7754036.19"
"77.197.128.18","32729","41.177.26.176","80","20","12666","9","889","11","11777","151.761081000","0.6301","11286.83","149521.91"
"77.197.210.48","43778","41.177.26.176","80","21","12773","9","889","12","11884","4.452927000","0.6301","11287.94","150895.24"
"77.197.217.20","38809","41.177.26.176","80","20","12661","8","823","12","11838","35.170108000","0.6299","10452.34","150346.00"
"77.197.128.31","1585","41.177.26.176","80","19","12657","8","816","11","11841","33.049788000","0.6299","10364.04","150392.94"
"77.197.128.46","29760","41.177.26.176","80","19","12917","8","815","11","12102","153.026464000","0.6299","10351.57","153711.32"
"77.197.210.198","49426","41.177.26.176","80","21","12853","9","879","12","11974","64.511934000","0.6298","11164.92","152091.83"
"77.197.128.180","7929","41.177.26.176","80","22","14029","9","925","13","13104","88.489970000","0.6295","11754.80","166524.23"
"77.197.128.118","24469","41.177.26.176","80","20","13067","9","879","11","12188","121.285372000","0.6295","11170.70","154890.20"
"77.197.128.55","22412","41.177.26.176","80","21","13207","8","860","13","12347","165.650764000","0.6294","10930.52","156929.29"
"77.197.128.13","57790","41.177.26.176","80","19","12540","8","816","11","11724","193.183653000","0.6294","10372.11","149022.85"
"77.197.217.218","58892","41.177.26.176","80","22","13285","9","879","13","12406","74.129593000","0.6292","11176.84","157747.34"
"77.197.128.224","14879","41.177.26.176","80","20","12779","8","824","12","11955","179.649708000","0.6291","10477.99","152019.94"
"77.197.128.41","15106","41.177.26.176","80","20","12707","8","825","12","11882","203.511760000","0.6291","10491.39","151101.52"
"244.3.160.239","62161","244.3.31.75","80","13","4041","7","1500","6","2541","117.655142000","0.6291","19076.35","32315.34"
"77.197.210.128","35250","41.177.26.176","80","18","12979","7","751","11","12228","49.158782000","0.6286","9557.00","155609.89"
"77.197.210.82","41121","41.177.26.176","80","19","12785","8","815","11","11970","138.806927000","0.6286","10371.53","152327.87"
"77.197.217.218","56146","41.177.26.176","80","19","12512","7","761","12","11751","69.085247000","0.6286","9685.65","149561.14"
"77.197.128.180","4209","41.177.26.176","80","19","12409","8","860","11","11549","78.205715000","0.6285","10946.07","146995.56"
"77.197.128.84","35436","41.177.26.176","80","20","13140","8","823","12","12317","167.419498000","0.6285","10475.59","156777.39"
"77.197.210.2","55613","41.177.26.176","80","19","12927","7","759","12","12168","93.984187000","0.6284","9661.91","154896.12"
"77.197.128.12","32690","41.177.26.176","80","21","13022","9","888","12","12134","24.159119000","0.6282","11307.82","154514.69"
"244.3.213.210","2865","244.3.160.239","80","12","4054","5","1336","7","2718","24.978088000","0.6282","17013.07","34611.91"
"77.197.128.224","3944","41.177.26.176","80","18","12732","7","759","11","11973","170.129391000","0.6281","9666.50","152486.11"
"77.197.217.218","58127","41.177.26.176","80","20","12689","8","823","12","11866","72.489015000","0.6280","10484.49","151165.25"
"77.197.128.46","26963","41.177.26.176","80","20","12592","8","823","12","11769","142.651246000","0.6279","10485.46","149943.38"
"77.197.210.186","4694","41.177.26.176","80","20","12588","7","760","13","11828","5.874758000","0.6278","9685.15","150731.56"
"15.186.110.41","42972","244.3.210.197","80","29","19367","14","1498","15","17869","110.224331000","0.6275","19097.55","227806.51"
"77.197.128.224","43406","41.177.26.176","80","22","13278","9","924","13","12354","210.448799000","0.6274","11782.03","157527.30"
"77.197.128.31","1417","41.177.26.176","80","21","12972","9","927","12","12045","32.392497000","0.6272","11823.19","153624.92"
"77.197.128.92","19519","41.177.26.176","80","20","12748","8","817","12","11931","218.329187000","0.6272","10420.34","152172.63"
"77.197.210.2","12767","41.177.26.91","80","24","17456","11","1008","13","16448","145.482611000","0.6272","12858.13","209811.98"
"77.197.210.80","36528","41.177.26.176","80","22","13207","9","880","13","12327","56.438342000","0.6271","11226.58","157261.48"
"77.197.128.224","56316","41.177.26.176","80","20","12759","7","747","13","12012","155.187832000","0.6270","9531.43","153268.54"
"77.197.128.139","61290","41.177.26.176","80","21","13219","9","924","12","12295","34.613528000","0.6269","11791.73","156904.03"
"77.197.128.13","34363","41.177.26.176","80","19","12608","8","823","11","11785","105.991753000","0.6269","10503.13","150400.17"
"77.197.128.223","1740","41.177.26.176","80","21","12635","8","815","13","11820","172.711609000","0.6267","10402.97","150875.00"
"77.197.128.47","7938","41.177.26.176","80","21","12769","9","888","12","11881","103.739147000","0.6266","11336.49","151676.62"
"77.197.128.55","25846","41.177.26.176","80","20","12667","8","810","12","11857","182.942122000","0.6264","10344.50","151425.56"
"77.197.128.13","35356","41.177.26.176","80","22","13010","10","988","12","12022","108.527832000","0.6263","12620.65","153568.32"
"77.197.217.218","61464","41.177.26.176","80","19","12651","7","749","12","11902","85.755098000","0.6263","9567.73","152036.18"
"77.197.217.224","60592","41.177.26.176","80","20","13187","8","860","12","12327","77.144490000","0.6262","10987.06","157485.50"
"15.186.110.41","53907","244.3.210.197","80","32","20505","15","1503","17","19002","214.719421000","0.6262","19202.88","242776.56"
"77.197.210.48","6337","41.177.26.176","80","20","12710","7","762","13","11948","62.992716000","0.6261","9736.29","152663.03"
"16.176.93.164","6626","244.3.160.239","80","10","2262","5","1475","5","787","221.665117000","0.6261","18848.21","10056.64"
"77.197.128.31","64083","41.177.26.176","80","20","12564","8","812","12","11752","27.010081000","0.6260","10377.23","150188.66"
"77.197.128.224","36997","41.177.26.176","80","20","12581","8","816","12","11765","204.391802000","0.6259","10430.46","150385.31"
"77.197.210.67","58471","41.177.26.176","80","21","12753","9","879","12","11874","4.401737000","0.6258","11237.50","151802.12"
"77.197.128.31","58936","41.177.26.176","80","23","13272","9","924","14","12348","2.051583000","0.6257","11813.52","157871.52"
"77.197.128.41","53849","41.177.26.176","80","19","13415","7","797","12","12618","152.052678000","0.6257","10190.01","161326.87"
"77.197.128.118","10775","41.177.26.176","80","21","12708","8","812","13","11896","205.826000000","0.6256","10384.25","152131.76"
"77.197.128.193","52389","41.177.26.176","80","21","13670","8","860","13","12810","230.150134000","0.6255","10998.34","163824.10"
"77.197.128.167","4736","41.177.26.176","80","20","12573","8","823","12","11750","32.030858000","0.6254","10527.95","150307.89"
"77.197.128.118","25320","41.177.26.176","80","21","12992","8","815","13","12177","123.186531000","0.6252","10428.55","155813.99"
"77.197.210.153","46211","41.177.26.91","80","29","19453","15","1291","14","18162","42.168539000","0.6252","16519.99","232405.92"
"77.197.128.224","53643","41.177.26.176","80","19","13303","8","826","11","12477","151.581797000","0.6249","10573.68","159718.89"
"77.197.217.152","20960","41.177.26.176","80","19","12591","7","762","12","11829","82.476231000","0.6249","9755.16","151435.43"
"77.197.128.41","25541","41.177.26.176","80","21","12751","8","812","13","11939","231.034447000","0.6244","10403.30","152961.88"
"77.197.128.47","15800","41.177.26.176","80","19","12493","8","816","11","11677","115.071516000","0.6244","10455.66","149620.97"
"41.177.3.224","39922","41.177.117.184","1618","96","42373","49","25073","47","17300","85.697863000","0.6243","321298.37","221691.13"
"77.197.210.48","3893","41.177.26.176","80","21","12733","9","889","12","11844","57.849239000","0.6240","11397.27","151843.96"
"77.197.128.118","6179","41.177.26.176","80","21","13310","8","816","13","12494","200.344056000","0.6239","10462.76","160198.23"
"77.197.210.198","43477","41.177.26.176","80","19","12596","7","759","12","11837","51.478533000","0.6238","9734.01","151807.01"
"77.197.128.55","25108","41.177.26.176","80","19","13138","8","860","11","12278","177.869775000","0.6238","11029.58","157466.53"
"254.51.75.100","50269","244.3.210.197","80","41","36612","16","1913","25","34699","196.016896000","0.6238","24534.84","445025.86"
"77.197.128.117","23115","41.177.26.176","80","20","12836","8","823","12","12013","132.440541000","0.6236","10557.91","154109.63"
"244.3.160.239","61398","244.3.31.75","80","13","3910","7","1379","6","2531","24.981974000","0.6235","17692.73","32473.02"
"77.197.128.18","30956","41.177.26.176","80","21","13056","9","925","12","12131","143.998777000","0.6234","11869.51","155663.84"
"77.197.13.176","53151","41.177.26.176","80","21","13837","9","927","12","12910","27.348538000","0.6234","11896.84","165683.02"
"77.197.128.41","13619","41.177.26.176","80","20","12745","8","823","12","11922","199.788106000","0.6232","10564.71","153040.64"
"18.132.77.186","2450","244.3.160.239","80","63","53307","23","2197","40","51110","100.332439000","0.6231","28208.39","656227.08"
"77.197.217.20","36266","41.177.26.176","80","19","12621","8","824","11","11797","22.960204000","0.6230","10580.97","151485.14"
"15.186.110.41","45382","244.3.210.197","80","29","18021","14","1443","15","16578","133.077943000","0.6230","18531.03","212894.99"
"77.197.128.224","45828","41.177.26.176","80","20","12711","8","816","12","11895","212.717458000","0.6229","10479.34","152759.50"
"77.197.128.13","37654","41.177.26.176","80","20","12677","8","811","12","11866","115.284681000","0.6228","10418.29","152433.32"
"77.197.128.72","23782","41.177.26.176","80","21","12710","9","872","12","11838","126.331003000","0.6227","11202.83","152086.08"
"77.197.128.12","31710","41.177.26.176","80","20","12755","8","823","12","11932","22.256922000","0.6227","10573.39","153294.95"
"77.197.128.118","3316","41.177.26.176","80","20","12894","8","808","12","12086","194.726640000","0.6225","10383.62","155317.35"
"77.197.128.225","4781","41.177.26.176","80","21","12774","9","889","12","11885","203.010591000","0.6225","11424.92","152739.20"
"77.197.128.118","13693","41.177.26.176","80","19","12801","7","751","12","12050","218.844368000","0.6224","9652.89","154883.32"
"77.197.128.118","42241","41.177.26.176","80","20","12552","8","811","12","11741","146.110252000","0.6223","10426.68","150948.98"
"16.176.93.164","14828","244.3.160.239","80","19","8890","8","1594","11","7296","123.058641000","0.6220","20500.16","93832.59"
"77.197.128.18","61072","41.177.26.176","80","19","12534","8","808","11","11726","141.070215000","0.6220","10392.33","150817.45"
"77.197.128.47","12190","41.177.26.176","80","18","12946","7","761","11","12185","107.170916000","0.6219","9788.73","156735.38"
"77.197.128.251","39271","41.177.26.176","80","19","13248","8","815","11","12433","12.477347000","0.6218","10485.10","159952.40"
"77.197.128.13","58670","41.177.26.176","80","20","12614","8","808","12","11806","195.948578000","0.6218","10395.84","151897.68"
"77.197.128.18","31355","41.177.26.176","80","21","12768","8","823","13","11945","194.296488000","0.6217","10590.74","153713.76"
"244.3.160.239","62501","244.239.197.117","80","110","98516","41","3497","69","95019","185.785882000","0.6215","45011.43","1223031.51"
"77.197.128.46","26103","41.177.26.176","80","20","12645","8","814","12","11831","139.475285000","0.6215","10477.69","152286.93"
"77.197.210.176","40839","41.177.26.15","80","28","20466","12","1071","16","19395","41.103001000","0.6215","13785.85","249651.25"
"77.197.217.218","59198","41.177.26.176","80","20","13139","8","815","12","12324","74.934904000","0.6213","10493.53","158677.69"
"77.197.210.67","17849","41.177.26.176","80","22","12902","8","815","14","12087","55.207402000","0.6213","10494.28","155637.21"
"244.3.160.239","62632","30.222.71.108","80","10","2255","6","1656","4","599","208.591978000","0.6212","21326.50","7714.11"
"77.197.128.94","36492","41.177.26.176","80","19","12785","8","816","11","11969","8.588100000","0.6211","10509.93","154158.49"
"77.197.128.118","5041","41.177.26.176","80","20","13333","8","815","12","12518","197.920291000","0.6211","10498.27","161248.20"
"77.197.128.193","50617","41.177.26.176","80","21","13821","8","808","13","13013","225.655730000","0.6210","10409.19","167641.99"
"77.197.217.20","59904","41.177.26.176","80","22","12913","9","926","13","11987","79.591329000","0.6210","11929.55","154427.12"
"244.3.181.123","15399","244.3.160.239","80","12","3081","6","1833","6","1248","135.768735000","0.6207","23624.03","16084.44"
"77.197.210.249","14727","41.177.26.176","80","19","12497","8","823","11","11674","57.266331000","0.6207","10607.69","150466.74"
"77.197.128.223","29970","41.177.26.176","80","19","12609","7","759","12","11850","100.761229000","0.6206","9783.92","152752.94"
"77.197.128.223","18736","41.177.26.176","80","22","13825","10","953","12","12872","210.788618000","0.6205","12286.47","165951.14"
"77.197.128.31","13476","41.177.26.176","80","19","13066","8","823","11","12243","75.543835000","0.6204","10612.20","157867.76"
"77.197.128.225","12961","41.177.26.176","80","20","13405","8","860","12","12545","214.187309000","0.6203","11090.78","161783.55"
"77.197.128.13","58230","41.177.26.176","80","21","12701","8","826","13","11875","194.507721000","0.6203","10653.73","153163.55"
"77.197.13.80","30587","41.177.26.176","80","19","12538","8","812","11","11726","206.763554000","0.6202","10473.57","151247.61"
"77.197.210.123","38766","41.177.26.176","80","21","12753","8","825","13","11928","6.247963000","0.6202","10641.81","153861.29"
"244.3.160.239","61961","198.123.241.156","80","95","88644","34","2817","61","85827","103.183030000","0.6202","36337.08","1107100.53"
"77.197.128.18","34239","41.177.26.176","80","22","12976","9","872","13","12104","200.776514000","0.6202","11248.58","156138.59"
"77.197.128.139","27336","41.177.26.176","80","21","12786","9","877","12","11909","87.895183000","0.6198","11320.11","153718.57"
"77.197.210.159","29172","41.177.26.176","80","19","12788","8","815","11","11973","84.275203000","0.6197","10521.36","154567.11"
"77.197.128.18","35004","41.177.26.176","80","20","12731","9","889","11","11842","203.579731000","0.6196","11478.21","152896.42"
"15.186.110.142","38232","41.177.26.176","80","43","27834","20","1887","23","25947","27.355616000","0.6195","24367.88","335068.05"
"41.177.176.156","6898","244.3.160.239","80","12","2340","6","1556","6","784","113.559146000","0.6195","20095.05","10125.01"
"77.197.128.251","45386","41.177.26.176","80","20","12569","8","815","12","11754","27.533053000","0.6193","10528.64","151845.02"
"77.197.128.223","12284","41.177.26.176","80","21","13276","8","860","13","12416","184.839816000","0.6191","11113.41","160446.60"
"77.197.128.176","26221","41.177.26.176","80","21","13747","9","887","12","12860","24.496874000","0.6187","11469.67","166290.86"
"77.197.217.20","58766","41.177.26.176","80","19","13554","8","860","11","12694","76.380002000","0.6180","11132.90","164326.82"
"77.197.128.18","1577","41.177.26.176","80","21","12710","9","879","12","11831","156.331974000","0.6180","11379.17","153159.29"
"77.197.210.198","58284","41.177.26.15","80","28","24379","10","943","18","23436","103.067904000","0.6178","12210.58","303464.57"
"77.197.217.20","38064","41.177.26.176","80","23","13518","9","924","14","12594","30.919026000","0.6178","11964.79","163078.47"
"77.197.210.128","35644","41.177.26.176","80","19","12672","7","761","12","11911","49.882415000","0.6174","9860.51","154334.54"
"77.197.128.139","22865","41.177.26.176","80","21","12697","9","879","12","11818","78.111153000","0.6174","11389.72","153132.74"
"77.197.128.224","55426","41.177.26.176","80","18","12985","7","749","11","12236","153.979841000","0.6174","9705.51","158553.63"
"77.197.210.198","47009","41.177.26.176","80","19","12675","7","751","12","11924","59.647034000","0.6174","9731.54","154512.50"
"77.197.128.18","33342","41.177.26.176","80","21","12774","9","889","12","11885","155.609739000","0.6174","11520.10","154011.62"
"77.197.210.123","37144","41.177.26.176","80","19","12648","8","825","11","11823","1.573706000","0.6173","10692.31","153230.54"
"77.197.210.249","15600","41.177.26.176","80","20","12772","8","860","12","11912","60.511531000","0.6173","11145.98","154384.76"
"77.197.210.123","36606","41.177.26.176","80","16","12451","6","695","10","11756","0.058846000","0.6173","9007.55","152363.67"
"41.177.192.117","11258","244.3.160.239","80","65","42593","24","2986","41","39607","170.838925000","0.6172","38700.81","513336.62"
"77.197.128.72","23122","41.177.26.176","80","21","13180","9","925","12","12255","124.258545000","0.6169","11994.99","158917.47"
"77.197.210.48","4286","41.177.26.176","80","20","12607","8","815","12","11792","59.362564000","0.6169","10569.28","152923.90"
"77.197.128.193","48798","41.177.26.176","80","22","12835","9","872","13","11963","222.671630000","0.6166","11313.11","155204.90"
"77.197.128.118","44766","41.177.26.176","80","22","13129","9","872","13","12257","149.934907000","0.6166","11314.39","159037.24"
"77.197.128.224","57368","41.177.26.176","80","21","13504","9","924","12","12580","156.394412000","0.6163","11993.36","163286.23"
"77.197.128.18","47677","41.177.26.176","80","19","13047","7","748","12","12299","229.638660000","0.6163","9709.59","159650.04"
"77.197.128.18","34047","41.177.26.176","80","20","12967","8","816","12","12151","200.120921000","0.6162","10594.53","157762.42"
"77.197.210.122","46001","41.177.26.176","80","20","12968","8","823","12","12145","61.567032000","0.6160","10688.09","157723.94"
"77.197.217.224","43100","41.177.26.176","80","21","12913","8","860","13","12053","35.277381000","0.6158","11171.77","156573.64"
"77.197.128.223","11795","41.177.26.176","80","21","12762","9","879","12","11883","183.403218000","0.6158","11418.90","154369.53"
"77.197.217.218","57301","41.177.26.176","80","19","12577","7","757","12","11820","70.819518000","0.6157","9836.28","153586.28"
"77.197.128.180","58565","41.177.26.176","80","19","13142","8","823","11","12319","47.265301000","0.6156","10695.45","160093.83"
"77.197.128.41","13955","41.177.26.176","80","20","12693","8","815","12","11878","200.602458000","0.6154","10594.05","154400.10"
"77.197.128.41","16226","41.177.26.176","80","22","12837","10","944","12","11893","208.152663000","0.6153","12273.77","154631.27"
"77.197.128.47","13635","41.177.26.176","80","19","12784","8","815","11","11969","110.548943000","0.6151","10599.16","155658.12"
"77.197.210.122","46482","41.177.26.176","80","20","13023","8","860","12","12163","62.986643000","0.6145","11195.95","158344.56"
"151.77.192.83","14106","244.3.160.239","80","6","1405","4","1275","2","130","9.093944000","0.6145","16600.13","1692.56"
"77.197.210.67","19720","41.177.26.176","80","21","12860","9","876","12","11984","63.041430000","0.6144","11405.69","156034.05"
"77.197.128.41","16523","41.177.26.176","80","22","12977","9","887","13","12090","209.788650000","0.6139","11559.73","157561.64"
"41.177.176.156","4117","244.3.160.239","80","55","36656","20","2556","35","34100","90.594693000","0.6138","33312.15","444422.72"
"77.197.128.139","57101","41.177.26.176","80","21","12927","8","860","13","12067","18.139697000","0.6138","11208.81","157275.22"
"77.197.128.47","20836","41.177.26.176","80","20","13103","8","815","12","12288","124.631302000","0.6138","10622.32","160155.88"
"77.197.128.223","23577","41.177.26.176","80","20","12950","8","823","12","12127","219.401093000","0.6137","10728.37","158083.75"
"244.3.160.239","61338","82.242.98.77","80","40","31787","16","2352","24","29435","9.398774000","0.6136","30664.23","383759.17"
"77.197.128.225","25430","41.177.26.176","80","21","13360","8","860","13","12500","233.823531000","0.6136","11213.25","162983.25"
"41.177.211.185","15848","244.3.160.239","80","22","11783","9","1848","13","9935","164.397998000","0.6135","24097.21","129548.58"
"77.197.128.46","20502","41.177.26.176","80","20","12890","8","861","12","12029","120.070070000","0.6135","11227.62","156860.70"
"77.197.128.223","5761","41.177.26.176","80","20","12576","8","816","12","11760","177.190525000","0.6133","10643.57","153392.64"
"151.77.217.75","9013","244.3.160.239","80","91","57280","37","3578","54","53702","104.400287000","0.6133","46672.94","700511.50"
"77.197.217.152","23210","41.177.26.176","80","19","13021","7","796","12","12225","90.237146000","0.6132","10384.71","159488.85"
"151.77.217.75","8781","244.3.160.239","80","164","102772","65","5512","99","97260","103.182723000","0.6131","71918.32","1269008.71"
"77.197.128.223","11322","41.177.26.176","80","20","12828","8","814","12","12014","181.979174000","0.6131","10621.93","156771.40"
"77.197.128.72","23324","41.177.26.176","80","21","12868","8","816","13","12052","124.892508000","0.6129","10650.57","157304.73"
"77.197.210.82","43877","41.177.26.176","80","20","13068","7","760","13","12308","145.672072000","0.6128","9921.74","160679.90"
"77.197.128.55","61611","41.177.26.176","80","22","12813","9","889","13","11924","106.385091000","0.6126","11610.20","155725.51"
"77.197.128.118","12760","41.177.26.176","80","20","12682","8","816","12","11866","213.743868000","0.6125","10657.52","154978.16"
"77.197.128.31","58786","41.177.26.176","80","21","12786","8","816","13","11970","0.753505000","0.6124","10659.75","156369.15"
"77.197.210.123","54568","41.177.26.176","80","22","13249","9","871","13","12378","52.696372000","0.6123","11380.36","161729.14"
"77.197.128.224","53229","41.177.26.176","80","22","12734","9","880","13","11854","150.969125000","0.6122","11499.02","154897.05"
"77.197.210.123","55576","41.177.26.176","80","22","13552","9","879","13","12673","58.465717000","0.6117","11495.02","165729.73"
"41.177.176.156","6272","244.3.160.239","80","12","2556","6","1302","6","1254","111.658986000","0.6117","17027.90","16400.14"
"77.197.210.80","34608","41.177.26.176","80","21","12777","9","890","12","11887","53.139182000","0.6117","11639.71","155462.08"
"77.197.128.12","29709","41.177.26.176","80","21","12776","8","860","13","11916","18.486843000","0.6114","11252.03","155906.09"
"253.160.251.79","2586","253.37.253.43","446","85","107073","0","0","85","107073","45.267846000","0.6114","N/A","1401107.69"
"77.197.128.225","5817","41.177.26.176","80","21","12657","8","825","13","11832","205.825996000","0.6113","10796.10","154835.67"
"77.197.128.92","60100","41.177.26.176","80","19","12576","7","757","12","11819","123.338122000","0.6112","9908.04","154693.64"
"77.197.210.48","3163","41.177.26.176","80","18","13008","7","751","11","12257","56.234834000","0.6107","9837.18","160551.72"
"77.197.210.249","16676","41.177.26.176","80","20","12674","8","816","12","11858","65.969298000","0.6107","10689.60","155339.81"
"77.197.128.13","56352","41.177.26.176","80","21","12647","8","815","13","11832","189.419480000","0.6105","10679.70","155045.67"
"77.197.128.223","1205","41.177.26.176","80","21","12626","8","815","13","11811","171.850558000","0.6103","10682.69","154813.85"
"77.197.128.251","46094","41.177.26.176","80","20","12900","8","823","12","12077","30.193743000","0.6103","10788.90","158320.18"
"77.197.210.186","34770","41.177.26.176","80","19","12621","8","815","11","11806","62.342929000","0.6102","10684.92","154780.52"
"77.197.128.46","17421","41.177.26.176","80","23","14334","10","988","13","13346","113.553354000","0.6102","12953.92","174982.75"
"77.197.128.46","27173","41.177.26.176","80","20","12868","8","861","12","12007","143.423867000","0.6101","11290.51","157450.78"
"77.197.128.84","45798","41.177.26.176","80","21","12964","9","924","12","12040","208.847849000","0.6100","12118.61","157909.15"
"77.197.128.224","54986","41.177.26.176","80","19","12794","8","823","11","11971","153.368331000","0.6099","10794.61","157013.71"
"77.197.128.118","37126","41.177.26.176","80","21","12760","8","812","13","11948","139.350635000","0.6099","10651.71","156732.34"
"77.197.128.193","50176","41.177.26.176","80","20","12669","8","824","12","11845","224.840567000","0.6098","10810.56","155401.84"
"77.197.128.180","60684","41.177.26.176","80","20","13306","8","861","12","12445","53.814967000","0.6094","11302.68","163370.33"
"77.197.210.128","42058","41.177.26.176","80","19","12580","8","814","11","11766","66.275973000","0.6094","10686.39","154466.97"
"16.176.93.164","7094","244.3.160.239","80","12","2832","6","1671","6","1161","14.207325000","0.6094","21937.41","15241.97"
"77.197.128.251","38848","41.177.26.176","80","21","12900","9","879","12","12021","11.748652000","0.6092","11543.31","157863.63"
"77.197.128.223","25676","41.177.26.176","80","22","13447","9","924","13","12523","223.911766000","0.6089","12140.40","164539.25"
"77.197.128.13","62528","41.177.26.176","80","21","12782","9","890","12","11892","211.628971000","0.6088","11694.47","156259.08"
"77.197.210.159","32887","41.177.26.176","80","21","13021","8","823","13","12198","96.193105000","0.6088","10815.30","160297.78"
"15.186.110.142","45486","41.177.26.176","80","41","28329","19","1802","22","26527","125.896910000","0.6087","23683.69","348644.38"
"77.197.128.84","38967","41.177.26.176","80","20","12680","9","887","11","11793","180.010006000","0.6086","11659.64","155019.35"
"77.197.127.110","20345","41.177.26.176","80","19","12841","7","752","12","12089","126.286109000","0.6084","9888.83","158970.88"
"77.197.128.13","62254","41.177.26.176","80","21","12977","8","862","13","12115","210.479624000","0.6082","11337.78","159347.09"
"77.197.210.249","13658","41.177.26.176","80","19","13223","8","816","11","12407","54.382928000","0.6082","10733.24","163195.24"
"77.197.128.46","17688","41.177.26.176","80","19","12602","7","751","12","11851","114.374524000","0.6080","9881.03","155925.49"
"77.197.128.180","59253","41.177.26.176","80","21","13825","9","924","12","12901","49.656152000","0.6078","12161.74","169803.62"
"77.197.210.198","45252","41.177.26.176","80","23","12870","10","940","13","11930","55.150448000","0.6077","12374.16","157046.52"
"77.197.128.41","25694","41.177.26.176","80","23","13975","10","944","13","13031","231.845888000","0.6076","12429.39","171575.66"
"77.197.128.224","11954","41.177.26.176","80","19","12809","7","796","12","12013","176.703871000","0.6071","10489.59","158305.85"
"77.197.217.224","1417","41.177.26.176","80","20","13292","8","861","12","12431","93.606057000","0.6070","11347.69","163836.34"
"41.177.176.156","8512","244.3.160.239","80","10","1816","5","1207","5","609","103.199346000","0.6070","15908.77","8026.87"
"77.197.128.13","59339","41.177.26.176","80","20","12719","8","811","12","11908","198.259741000","0.6068","10692.38","156997.43"
"77.197.210.82","37433","41.177.26.176","80","22","12741","9","880","13","11861","132.543804000","0.6068","11602.63","156384.99"
"77.197.210.2","53493","41.177.26.176","80","22","13722","9","925","13","12797","88.898554000","0.6066","12199.12","168769.92"
"77.197.128.55","65160","41.177.26.176","80","21","12723","8","814","13","11909","114.620916000","0.6065","10737.14","157086.73"
"77.197.128.12","26136","41.177.26.176","80","20","12575","7","751","13","11824","9.867362000","0.6065","9906.80","155976.07"
"77.197.128.251","43142","41.177.26.176","80","20","12657","8","812","12","11845","19.900902000","0.6063","10713.94","156288.91"
"77.197.128.211","54146","41.177.26.91","80","26","21708","10","971","16","20737","44.029166000","0.6062","12814.17","273663.65"
"77.197.128.84","36377","41.177.26.176","80","20","12666","8","815","12","11851","171.056147000","0.6061","10757.82","156430.52"
"77.197.128.223","19918","41.177.26.176","80","21","12624","8","815","13","11809","212.151122000","0.6060","10759.34","155898.25"
"77.197.128.18","37283","41.177.26.176","80","20","12781","8","823","12","11958","211.967308000","0.6058","10868.11","157911.16"
"244.3.160.239","62637","30.222.71.108","80","10","2091","6","1391","4","700","209.326990000","0.6056","18373.71","9246.29"
"244.3.160.239","62638","30.222.71.108","80","10","2345","6","1395","4","950","209.327815000","0.6056","18427.82","12549.41"
"244.3.160.239","61307","128.71.90.164","80","14","5161","7","1330","7","3831","5.921899000","0.6054","17575.65","50625.80"
"77.197.128.18","32296","41.177.26.176","80","21","12861","8","811","13","12050","195.676039000","0.6053","10718.92","159263.82"
"77.197.128.224","45132","41.177.26.176","80","22","12740","9","880","13","11860","212.097920000","0.6053","11630.98","156753.90"
"77.197.128.139","59342","41.177.26.176","80","21","12913","9","887","12","12026","24.597643000","0.6053","11723.62","158949.50"
"77.197.128.47","11773","41.177.26.176","80","21","13188","8","815","13","12373","106.430873000","0.6053","10772.09","163537.47"
"77.197.128.41","53416","41.177.26.176","80","20","12867","7","751","13","12116","151.180693000","0.6051","9929.05","160186.95"
"77.197.210.123","52035","41.177.26.176","80","22","12694","9","879","13","11815","45.543855000","0.6049","11625.47","156262.66"
"77.197.128.18","33017","41.177.26.176","80","20","12701","8","812","12","11889","153.396274000","0.6047","10743.28","157299.10"
"77.197.128.41","59909","41.177.26.176","80","20","12286","9","879","11","11407","170.406811000","0.6044","11634.01","150977.36"
"77.197.128.224","41724","41.177.26.176","80","18","12443","7","759","11","11684","208.874241000","0.6039","10054.33","154775.72"
"77.197.210.123","54725","41.177.26.176","80","18","12559","7","762","11","11797","53.504351000","0.6038","10096.02","156302.89"
"77.197.217.218","62977","41.177.26.176","80","21","13157","8","811","13","12346","95.943509000","0.6035","10751.12","163666.25"
"77.197.128.225","12607","41.177.26.176","80","21","13181","9","887","12","12294","213.579189000","0.6033","11761.06","163010.67"
"77.197.128.224","35348","41.177.26.176","80","20","13233","8","815","12","12418","202.571535000","0.6032","10809.09","164696.05"
"77.197.128.223","26574","41.177.26.176","80","19","12634","8","823","11","11811","225.840721000","0.6031","10917.67","156681.19"
"77.197.128.139","56021","41.177.26.176","80","21","12749","9","887","12","11862","16.486093000","0.6029","11769.80","157399.50"
"77.197.128.46","18976","41.177.26.176","80","20","12767","8","815","12","11952","116.008677000","0.6029","10814.95","158601.62"
"244.3.160.239","61334","198.123.241.156","80","11","2654","6","1100","5","1554","8.781472000","0.6029","14597.31","20622.01"
"77.197.128.127","50124","41.177.26.176","80","18","12536","7","757","11","11779","34.486135000","0.6027","10047.45","156339.38"
"77.197.128.251","43378","41.177.26.176","80","22","12903","9","887","13","12016","20.508319000","0.6026","11776.44","159532.93"
"77.197.128.55","4605","41.177.26.176","80","19","13041","8","815","11","12226","124.759773000","0.6024","10822.53","162351.21"
"77.197.128.224","54524","41.177.26.176","80","21","13004","8","823","13","12181","152.765858000","0.6021","10935.61","161854.93"
"77.197.127.110","22386","41.177.26.176","80","20","13418","9","927","11","12491","131.155505000","0.6020","12319.02","165994.46"
"77.197.210.67","58547","41.177.26.176","80","19","13042","7","759","12","12283","5.039896000","0.6018","10089.68","163282.67"
"244.3.160.239","62623","30.222.71.108","80","10","2293","6","1388","4","905","203.751397000","0.6016","18456.65","12034.05"
"15.186.110.142","42541","41.177.26.176","80","26","13378","13","1390","13","11988","86.047183000","0.6015","18486.10","159432.65"
"77.197.128.223","12086","41.177.26.176","80","22","13658","9","879","13","12779","184.213808000","0.6015","11690.38","169956.11"
"77.197.128.13","44680","41.177.26.176","80","20","13133","8","823","12","12310","139.394743000","0.6014","10947.84","163752.06"
"77.197.128.167","55754","41.177.26.176","80","20","13121","8","815","12","12306","11.243174000","0.6013","10843.50","163730.16"
"77.197.128.223","11036","41.177.26.176","80","20","12676","9","888","11","11788","181.170974000","0.6012","11815.86","156852.83"
"77.197.217.224","64270","41.177.26.176","80","22","12724","9","889","13","11835","85.481217000","0.6011","11831.56","157510.18"
"77.197.128.92","17244","41.177.26.176","80","21","12784","9","889","12","11895","212.262466000","0.6011","11831.66","158310.03"
"41.177.230.253","44064","244.3.31.40","22","54","17359","27","5632","27","11727","190.901366000","0.6010","74962.40","156087.37"
"77.197.128.118","11807","41.177.26.176","80","20","12865","8","860","12","12005","209.114863000","0.6008","11450.60","159842.35"
"77.197.210.128","16849","41.177.26.176","80","22","13024","9","926","13","12098","0.698189000","0.6008","12330.33","161093.22"
"168.91.64.164","3149","244.3.210.255","80","17","14227","6","435","11","13792","104.085999000","0.6007","5793.65","183691.88"
"77.197.128.127","43837","41.177.26.176","80","20","12848","8","815","12","12033","22.301689000","0.6004","10858.65","160321.63"
"77.197.128.251","44276","41.177.26.176","80","20","12729","8","825","12","11904","23.016011000","0.6004","10992.01","158604.75"
"77.197.210.181","59315","41.177.26.176","80","23","12904","10","953","13","11951","67.146694000","0.6004","12698.24","159241.04"
"77.197.128.127","47207","41.177.26.176","80","19","12644","7","761","12","11883","26.855975000","0.6000","10146.45","158436.57"
"77.197.128.46","29261","41.177.26.176","80","20","12365","8","816","12","11549","150.796736000","0.5999","10882.36","154020.04"
"77.197.217.224","36080","41.177.26.176","80","18","12714","7","751","11","11963","18.655631000","0.5998","10016.29","159553.74"
"77.197.210.186","34403","41.177.26.176","80","19","13305","8","821","11","12484","61.521091000","0.5998","10949.93","166503.01"
"77.197.128.118","46379","41.177.26.176","80","21","13116","8","861","13","12255","156.012431000","0.5997","11485.17","163473.56"
"77.197.210.67","20154","41.177.26.176","80","21","12976","7","798","14","12178","66.892940000","0.5996","10647.44","162486.80"
"77.197.128.13","59124","41.177.26.176","80","22","12886","9","875","13","12011","197.414735000","0.5993","11681.25","160346.83"
"77.197.128.13","44002","41.177.26.176","80","21","12689","9","889","12","11800","137.117642000","0.5992","11868.78","157538.40"
"77.197.128.180","5810","41.177.26.176","80","20","12707","8","825","12","11882","83.338475000","0.5992","11014.47","158635.01"
"77.197.128.118","24054","41.177.26.176","80","21","12636","8","815","13","11821","120.598484000","0.5991","10882.17","157838.25"
"77.197.217.20","55310","41.177.26.176","80","21","13170","8","811","13","12359","69.583480000","0.5991","10829.52","165033.39"
"77.197.128.167","4993","41.177.26.176","80","21","12775","9","880","12","11895","33.640634000","0.5990","11753.71","158875.38"
"244.3.160.239","61805","43.106.84.231","80","16","6106","8","1355","8","4751","78.530110000","0.5989","18099.28","63461.00"
"77.197.128.223","25380","41.177.26.176","80","21","13072","9","879","12","12193","223.253990000","0.5988","11742.82","162889.88"
"77.197.210.128","16999","41.177.26.176","80","22","13352","9","888","13","12464","1.419831000","0.5988","11863.91","166522.21"
"77.197.210.128","41331","41.177.26.176","80","21","12796","9","879","12","11917","62.618766000","0.5987","11745.86","159243.94"
"77.197.128.180","61962","41.177.26.176","80","22","12845","9","890","13","11955","58.103429000","0.5986","11894.78","159777.61"
"77.197.210.67","19926","41.177.26.176","80","22","12875","9","879","13","11996","64.646559000","0.5984","11751.91","160382.10"
"77.197.210.48","6956","41.177.26.176","80","22","13798","9","924","13","12874","63.854935000","0.5983","12354.22","172130.13"
"77.197.128.251","42559","41.177.26.176","80","21","12762","8","812","13","11950","18.593106000","0.5983","10858.28","159798.61"
"253.160.251.79","2844","253.37.253.43","446","69","84309","0","0","69","84309","207.065914000","0.5979","N/A","1127987.12"
"77.197.217.224","42286","41.177.26.176","80","22","12833","9","889","13","11944","31.433100000","0.5977","11899.18","159869.36"
"89.160.185.98","46487","244.3.210.197","80","8","3189","5","1347","3","1842","138.507112000","0.5977","18030.32","24656.16"
"77.197.128.13","45502","41.177.26.176","80","22","12817","9","876","13","11941","142.700143000","0.5976","11727.73","159863.98"
"77.197.128.224","29348","41.177.26.176","80","22","12833","8","815","14","12018","194.874040000","0.5974","10913.32","160927.97"
"77.197.210.67","14077","41.177.26.176","80","20","13094","8","811","12","12283","46.583270000","0.5973","10861.56","164503.73"
"244.3.160.239","61212","85.241.98.37","80","70","62325","24","1536","46","60789","0.056242000","0.5970","20583.95","814633.90"
"77.197.128.18","48747","41.177.26.176","80","21","12814","9","924","12","11890","231.089257000","0.5968","12385.25","159372.96"
"77.197.128.225","3574","41.177.26.176","80","21","12895","9","879","12","12016","199.623514000","0.5967","11784.72","161098.03"
"77.197.217.152","13453","41.177.26.176","80","22","13214","9","924","13","12290","69.296726000","0.5967","12388.67","164780.10"
"77.197.128.167","3471","41.177.26.176","80","20","12914","8","815","12","12099","28.975214000","0.5966","10928.49","162237.72"
"244.3.160.239","62354","244.3.31.75","80","11","3157","6","1390","5","1767","158.912133000","0.5965","18642.92","23699.31"
"77.197.128.55","25947","41.177.26.176","80","19","13089","8","860","11","12229","183.760503000","0.5963","11538.65","164076.90"
"77.197.128.41","15398","41.177.26.176","80","21","12924","9","887","12","12037","204.298854000","0.5961","11903.52","161536.32"
"77.197.128.167","5685","41.177.26.176","80","21","12733","8","815","13","11918","37.133305000","0.5960","10939.95","159978.25"
"77.197.210.2","51059","41.177.26.176","80","19","12700","7","747","12","11953","83.177930000","0.5959","10028.88","160475.53"
"77.197.128.92","60789","41.177.26.176","80","20","12854","8","815","12","12039","126.085608000","0.5953","10951.58","161774.29"
"77.197.128.118","62078","41.177.26.176","80","21","12995","8","815","13","12180","189.279882000","0.5953","10951.82","163672.55"
"77.197.128.251","39764","41.177.26.176","80","19","12802","8","823","11","11979","13.197789000","0.5952","11062.16","161012.93"
"77.197.128.41","54595","41.177.26.176","80","22","13254","9","880","13","12374","153.673882000","0.5951","11830.72","166356.05"
"77.197.128.118","12664","41.177.26.176","80","21","12741","8","823","13","11918","213.146619000","0.5950","11065.56","160242.29"
"77.197.128.167","60904","41.177.26.176","80","23","12922","9","887","14","12035","20.725913000","0.5950","11926.69","161823.83"
"77.197.128.46","26788","41.177.26.176","80","19","12132","8","815","11","11317","142.010804000","0.5949","10959.35","152180.27"
"90.38.138.255","3008","244.3.160.239","80","12","2660","6","1074","6","1586","8.745693000","0.5949","14442.42","21327.45"
"77.197.128.118","5464","41.177.26.176","80","20","12895","8","863","12","12032","198.775111000","0.5946","11611.69","161890.97"
"77.197.128.251","40970","41.177.26.176","80","21","12892","9","875","12","12017","15.325437000","0.5943","11779.28","161773.22"
"77.197.128.139","28283","41.177.26.176","80","21","12865","8","816","13","12049","91.906567000","0.5939","10991.88","162305.33"
"77.197.128.224","47743","41.177.26.176","80","22","12715","9","877","13","11838","214.350536000","0.5939","11814.17","159471.12"
"77.197.210.159","29462","41.177.26.176","80","22","12713","9","880","13","11833","85.092051000","0.5933","11865.32","159548.04"
"77.197.210.181","39431","41.177.26.176","80","19","12534","7","744","12","11790","2.639078000","0.5931","10035.22","159025.88"
"77.197.128.46","17956","41.177.26.176","80","19","12213","8","821","11","11392","115.185184000","0.5926","11083.21","153788.00"
"77.197.210.231","49172","41.177.26.91","80","21","16304","8","877","13","15427","139.204219000","0.5924","11842.59","208318.85"
"77.197.128.118","7327","41.177.26.176","80","22","13729","8","815","14","12914","202.820233000","0.5924","11005.74","174390.38"
"77.197.128.118","38042","41.177.26.176","80","20","12640","9","887","11","11753","140.347380000","0.5922","11983.11","158779.53"
"41.177.223.45","11570","244.3.160.239","80","15","5078","7","1051","8","4027","5.502740000","0.5922","14198.82","54404.03"
"77.197.128.12","30541","41.177.26.176","80","20","12835","8","815","12","12020","20.025893000","0.5921","11010.82","162392.66"
"244.3.79.141","9960","244.3.160.239","80","52","32400","20","2491","32","29909","9.385912000","0.5921","33656.36","404106.05"
"77.197.210.82","45063","41.177.26.176","80","21","13175","9","879","12","12296","151.381469000","0.5920","11878.92","166169.74"
"77.197.210.67","19587","41.177.26.176","80","20","12670","8","811","12","11859","62.277784000","0.5919","10960.55","160272.73"
"77.197.128.13","62118","41.177.26.176","80","19","12630","8","822","11","11808","209.823265000","0.5915","11117.70","159705.42"
"77.197.128.139","54924","41.177.26.176","80","20","12707","8","825","12","11882","14.593557000","0.5911","11166.55","160825.38"
"77.197.210.122","34615","41.177.26.176","80","21","12738","8","823","13","11915","40.169550000","0.5909","11142.83","161320.62"
"41.177.199.139","15798","244.3.160.239","80","12","3261","6","1272","6","1989","63.914069000","0.5908","17224.51","26933.61"
"41.177.176.156","10248","244.3.160.239","80","25","14543","10","1680","15","12863","195.965254000","0.5906","22756.48","174236.07"
"16.176.93.164","15298","244.3.160.239","80","12","2421","6","1464","6","957","231.045547000","0.5902","19844.29","12971.98"
"77.197.128.251","58038","41.177.26.176","80","20","13406","8","815","12","12591","57.706144000","0.5902","11047.95","170680.58"
"77.197.210.128","38467","41.177.26.176","80","20","12444","8","860","12","11584","55.480783000","0.5900","11660.42","157063.20"
"77.197.217.152","21587","41.177.26.176","80","23","13862","9","879","14","12983","84.501637000","0.5899","11919.86","176058.58"
"15.186.110.142","43682","41.177.26.176","80","24","13128","12","1320","12","11808","101.025200000","0.5898","17903.52","160155.16"
"77.197.128.118","24778","41.177.26.176","80","21","12702","8","812","13","11890","121.956117000","0.5897","11016.24","161309.20"
"244.3.160.239","62539","30.222.71.108","80","10","2237","6","1638","4","599","197.143583000","0.5897","22222.94","8126.70"
"77.197.128.193","49289","41.177.26.176","80","22","12838","9","880","13","11958","223.358179000","0.5896","11939.61","162243.02"
"77.197.217.152","23581","41.177.26.176","80","22","12963","9","879","13","12084","92.289704000","0.5896","11927.46","163972.02"
"77.197.210.48","1823","41.177.26.176","80","21","12771","9","876","12","11895","55.614618000","0.5896","11886.77","161407.69"
"77.197.128.167","58378","41.177.26.176","80","22","12952","9","879","13","12073","15.532101000","0.5895","11928.04","163830.82"
"77.197.128.41","15920","41.177.26.176","80","19","13083","8","815","11","12268","206.128221000","0.5895","11060.45","166490.24"
"244.3.160.239","62578","30.222.71.108","80","10","2352","6","1397","4","955","201.733629000","0.5893","18965.84","12965.19"
"77.197.128.224","55857","41.177.26.176","80","19","13044","8","815","11","12229","154.598203000","0.5892","11065.85","166042.09"
"77.197.128.251","44468","41.177.26.176","80","21","13187","8","815","13","12372","23.626032000","0.5887","11075.16","168124.95"
"77.197.128.224","34805","41.177.26.176","80","20","12824","8","823","12","12001","201.946940000","0.5887","11184.19","163088.09"
"77.197.128.118","12266","41.177.26.176","80","21","12489","9","887","12","11602","211.079197000","0.5880","12068.03","157850.34"
"244.3.160.239","62634","30.222.71.108","80","10","2388","6","1411","4","977","208.975644000","0.5879","19199.53","13294.08"
"77.197.128.118","64001","41.177.26.176","80","22","12689","9","871","13","11818","191.256035000","0.5877","11857.08","160880.50"
"77.197.217.20","61822","41.177.26.176","80","21","12956","9","926","12","12030","92.460752000","0.5876","12607.56","163789.35"
"16.176.93.164","4555","244.3.160.239","80","12","3035","6","1751","6","1284","60.331496000","0.5874","23847.50","17487.26"
"77.197.128.46","29156","41.177.26.176","80","21","12960","8","862","13","12098","150.163502000","0.5867","11753.56","164958.86"
"244.3.160.239","62543","30.222.71.108","80","10","2076","6","1382","4","694","197.496331000","0.5866","18846.15","9463.99"
"77.197.128.12","33981","41.177.26.176","80","20","12717","8","825","12","11892","26.955596000","0.5866","11250.78","162174.88"
"244.3.160.239","61728","244.3.31.75","80","13","3235","7","1254","6","1981","63.916590000","0.5863","17111.16","27031.27"
"77.197.128.118","25690","41.177.26.176","80","22","13496","9","878","13","12618","124.027995000","0.5863","11980.56","172176.24"
"244.3.160.239","62300","92.188.204.180","80","13","3727","7","1085","6","2642","143.109823000","0.5861","14809.53","36061.55"
"77.197.128.72","21840","41.177.26.176","80","21","12758","8","816","13","11942","120.343604000","0.5856","11147.79","163145.70"
"244.3.160.239","62107","244.176.48.167","80","15","7320","8","1352","7","5968","113.580337000","0.5856","18470.70","81533.40"
"77.197.128.41","55231","41.177.26.176","80","20","12808","8","824","12","11984","156.532710000","0.5855","11257.98","163732.62"
"77.197.128.13","55726","41.177.26.176","80","23","13046","11","1015","12","12031","187.994836000","0.5854","13871.00","164415.76"
"41.177.176.156","6006","244.3.160.239","80","10","2348","5","1475","5","873","118.357918000","0.5853","20160.29","11932.16"
"244.3.160.239","62301","92.188.204.180","80","11","1703","6","1013","5","690","143.110402000","0.5848","13857.85","9439.21"
"244.3.213.210","2987","244.3.160.239","80","10","3356","5","1581","5","1775","26.957085000","0.5848","21628.31","24282.26"
"41.177.223.45","9730","244.3.160.239","80","9","1432","5","882","4","550","2.249499000","0.5846","12069.42","7526.28"
"77.197.217.218","56811","41.177.26.176","80","21","12656","8","826","13","11830","69.982003000","0.5846","11303.32","161886.53"
"41.177.98.98","43922","244.3.31.43","7030","11","1181","6","676","5","505","178.507036000","0.5839","9262.10","6919.17"
"77.197.128.18","36036","41.177.26.176","80","21","12684","9","890","12","11794","207.876097000","0.5838","12195.54","161611.46"
"77.197.217.152","23349","41.177.26.176","80","22","13053","9","878","13","12175","90.867842000","0.5838","12032.01","166844.82"
"77.197.128.223","11531","41.177.26.176","80","20","12853","8","861","12","11992","182.604253000","0.5826","11822.68","164666.18"
"77.197.210.81","18782","41.177.26.91","80","20","17246","7","752","13","16494","132.605478000","0.5820","10336.75","226721.26"
"77.197.128.46","20016","41.177.26.176","80","24","13402","11","1008","13","12394","118.430399000","0.5818","13861.53","170436.30"
"77.197.128.118","43468","41.177.26.176","80","20","12708","8","815","12","11893","147.737942000","0.5814","11213.62","163636.24"
"77.197.217.20","58478","41.177.26.176","80","22","12790","9","879","13","11911","75.750600000","0.5813","12096.36","163913.22"
"77.197.210.82","43550","41.177.26.176","80","21","12849","9","926","12","11923","145.065006000","0.5811","12747.69","164136.80"
"77.197.128.118","28516","41.177.26.176","80","21","12735","8","815","13","11920","128.904522000","0.5809","11224.54","164167.54"
"77.197.128.18","14118","41.177.26.176","80","22","12828","9","880","13","11948","168.956175000","0.5806","12126.12","164639.62"
"77.197.128.18","34469","41.177.26.176","80","20","12808","8","863","12","11945","201.559776000","0.5805","11892.77","164610.75"
"77.197.128.251","40166","41.177.26.176","80","22","12826","10","944","12","11882","13.883918000","0.5805","13010.57","163762.32"
"77.197.128.180","11991","41.177.26.176","80","18","12838","7","746","11","12092","95.576702000","0.5795","10298.57","166930.69"
"77.197.128.18","25829","41.177.26.176","80","21","12687","9","889","12","11798","185.776766000","0.5795","12272.97","162875.66"
"77.197.128.224","37659","41.177.26.176","80","21","12981","8","862","13","12119","205.022356000","0.5794","11902.81","167343.56"
"77.197.128.13","57563","41.177.26.176","80","21","13185","8","815","13","12370","192.534944000","0.5793","11255.58","170836.30"
"77.197.210.198","38501","41.177.26.176","80","21","12782","9","880","12","11902","40.991678000","0.5793","12153.27","164372.97"
"15.186.110.142","45005","41.177.26.176","80","16","5448","8","1024","8","4424","118.497557000","0.5792","14144.43","61108.35"
"77.197.128.12","32420","41.177.26.176","80","21","12919","8","815","13","12104","23.502727000","0.5792","11257.57","167192.13"
"77.197.217.20","36857","41.177.26.176","80","19","12521","7","747","12","11774","25.387951000","0.5789","10323.42","162714.77"
"244.3.160.239","61413","244.3.31.75","80","11","3302","6","1535","5","1767","26.962498000","0.5787","21220.12","24427.33"
"41.177.176.156","3705","244.3.160.239","80","12","2048","6","1316","6","732","111.277442000","0.5785","18200.30","10123.57"
"77.197.128.223","12726","41.177.26.176","80","21","12667","9","889","12","11778","186.433896000","0.5784","12296.82","162915.55"
"77.197.217.152","20572","41.177.26.176","80","22","12846","9","890","13","11956","81.678729000","0.5782","12313.91","165421.44"
"77.197.128.224","56825","41.177.26.176","80","18","12524","7","757","11","11767","155.816036000","0.5782","10473.94","162809.56"
"77.197.128.13","37458","41.177.26.176","80","22","13006","9","924","13","12082","114.590684000","0.5781","12787.45","167205.53"
"77.197.128.180","4653","41.177.26.176","80","21","12664","8","825","13","11839","80.187306000","0.5780","11418.88","163864.43"
"77.197.128.176","29317","41.177.26.176","80","22","12760","9","924","13","11836","32.967781000","0.5780","12789.57","163828.29"
"41.177.98.98","43927","244.3.31.33","10030","11","1181","6","676","5","505","186.117472000","0.5779","9358.70","6991.34"
"26.39.254.244","3502","41.177.26.91","80","13","7511","6","500","7","7011","228.267303000","0.5776","6925.05","97103.08"
"15.186.110.142","40366","41.177.26.176","80","39","25961","18","1747","21","24214","56.231426000","0.5776","24197.09","335379.77"
"77.197.128.139","59523","41.177.26.176","80","20","12588","8","816","12","11772","25.407440000","0.5774","11305.93","163104.70"
"244.3.160.239","62281","92.188.204.180","80","19","11075","9","1922","10","9153","139.792594000","0.5772","26639.50","126863.34"
"151.77.108.208","3943","244.3.160.239","80","12","3402","6","1511","6","1891","186.962501000","0.5771","20945.67","26213.28"
"244.3.153.102","2853","244.3.160.80","443","48","29894","19","2541","29","27353","198.550402000","0.5771","35227.14","379208.22"
"244.3.160.239","61250","128.71.90.164","80","24","14626","11","1553","13","13073","1.524549000","0.5769","21537.25","181298.44"
"79.108.222.84","58470","41.177.26.176","80","7","460","4","262","3","198","133.092899000","0.5761","3638.04","2749.36"
"77.197.128.94","35109","41.177.26.176","80","22","13001","9","925","13","12076","4.799145000","0.5760","12847.47","167725.43"
"77.197.128.223","59347","41.177.26.176","80","22","12793","9","876","13","11917","164.734767000","0.5758","12169.90","165557.87"
"77.197.210.123","54091","41.177.26.176","80","20","12699","7","761","13","11938","50.470465000","0.5757","10574.38","165883.03"
"244.3.213.210","15626","244.3.160.239","80","10","3342","5","1573","5","1769","25.630675000","0.5756","21861.76","24585.79"
"77.197.128.18","52246","41.177.26.176","80","21","12756","9","880","12","11876","129.030052000","0.5756","12230.80","165060.22"
"16.176.93.164","11718","244.3.160.239","80","10","2260","5","1473","5","787","219.656671000","0.5755","20475.29","10939.61"
"79.108.231.127","62139","41.177.26.176","80","7","460","4","262","3","198","203.664790000","0.5754","3642.90","2753.04"
"77.197.210.82","44783","41.177.26.176","80","22","12751","9","890","13","11861","149.377887000","0.5752","12377.81","164958.63"
"244.3.77.218","6079","244.3.160.239","80","12","2459","6","1260","6","1199","12.030549000","0.5747","17538.12","16689.05"
"77.197.217.20","39000","41.177.26.176","80","21","12764","9","887","12","11877","36.581559000","0.5743","12355.72","165444.04"
"41.177.3.224","38629","41.177.117.184","1606","91","37324","47","22437","44","14887","63.498270000","0.5742","312622.03","207425.42"
"77.197.128.12","32066","41.177.26.176","80","20","12803","8","862","12","11941","22.905796000","0.5741","12011.30","166388.56"
"77.197.128.31","1754","41.177.26.176","80","24","12991","9","889","15","12102","33.801361000","0.5740","12389.75","168662.23"
"77.197.217.152","24087","41.177.26.176","80","22","12746","9","880","13","11866","94.524229000","0.5740","12265.04","165382.96"
"77.197.210.80","37483","41.177.26.176","80","21","12312","9","876","12","11436","58.274760000","0.5738","12214.25","159454.54"
"77.197.128.224","24368","41.177.26.176","80","20","12581","8","823","12","11758","102.534050000","0.5737","11477.36","163974.26"
"77.197.128.118","18333","41.177.26.176","80","22","12928","8","862","14","12066","112.554078000","0.5730","12034.38","168453.38"
"244.3.160.239","62424","244.3.31.75","80","17","10756","8","1677","9","9079","164.400629000","0.5727","23425.84","126823.60"
"77.197.210.122","43679","41.177.26.176","80","23","12761","10","951","13","11810","54.157623000","0.5727","13284.81","164977.54"
"77.197.13.80","30282","41.177.26.176","80","22","13084","9","872","13","12212","206.042993000","0.5720","12196.59","170808.25"
"244.3.160.239","62607","30.222.71.108","80","10","2167","6","1398","4","769","203.010964000","0.5719","19556.28","10757.35"
"186.136.103.68","6886","244.3.160.239","80","15","2328","8","1484","7","844","80.773824000","0.5718","20761.96","11808.01"
"41.177.168.181","5798","244.3.160.239","80","14","5668","6","1128","8","4540","78.525704000","0.5715","15789.67","63550.61"
"77.197.210.181","40913","41.177.26.176","80","22","12718","9","889","13","11829","6.732664000","0.5715","12444.58","165587.04"
"77.197.210.80","34048","41.177.26.176","80","20","12792","7","798","13","11994","51.707015000","0.5711","11178.04","168006.72"
"244.3.160.239","61259","128.71.90.164","80","16","6746","8","1350","8","5396","1.863765000","0.5707","18922.54","75634.08"
"79.108.231.213","57328","41.177.26.176","80","7","460","4","262","3","198","63.101975000","0.5707","3672.80","2775.63"
"244.3.160.239","62504","244.3.31.75","80","11","3132","6","1365","5","1767","186.966161000","0.5704","19145.74","24784.26"
"77.197.128.223","26903","41.177.26.176","80","21","12555","9","889","12","11666","226.573136000","0.5703","12469.65","163634.29"
"15.186.110.142","45533","41.177.26.176","80","14","5307","7","953","7","4354","126.450415000","0.5703","13368.85","61078.66"
"26.39.254.244","3504","41.177.26.91","80","13","7511","6","500","7","7011","228.460935000","0.5701","7016.78","98389.30"
"77.197.210.48","42607","41.177.26.176","80","23","12876","10","953","13","11923","1.408248000","0.5698","13379.08","167385.87"
"41.177.176.106","9325","244.3.160.239","80","24","11168","10","1546","14","9622","67.045293000","0.5696","21712.19","135132.38"
"77.197.128.135","63639","41.177.26.176","80","20","12707","8","825","12","11882","19.229470000","0.5695","11588.42","166901.36"
"244.3.160.239","61405","244.3.31.75","80","11","3288","6","1527","5","1761","25.636078000","0.5695","21450.32","24737.40"
"77.197.128.31","1225","41.177.26.176","80","21","12822","9","924","12","11898","31.764742000","0.5692","12986.24","167218.89"
"77.197.210.181","56737","41.177.26.176","80","21","12949","9","924","12","12025","58.169344000","0.5687","12997.68","169152.67"
"18.132.77.186","10110","244.3.160.239","80","39","29490","15","1731","24","27759","101.335531000","0.5687","24352.03","390518.75"
"77.197.127.128","11817","41.177.26.176","80","22","14531","9","880","13","13651","177.884737000","0.5685","12382.53","192083.98"
"77.197.210.249","16461","41.177.26.176","80","21","12595","9","890","12","11705","64.548542000","0.5684","12525.62","164732.99"
"77.197.128.180","58904","41.177.26.176","80","22","12707","9","876","13","11831","48.436748000","0.5684","12329.24","166515.07"
"77.197.128.82","48157","41.177.26.91","80","27","23150","10","950","17","22200","169.308118000","0.5684","13371.76","312476.91"
"77.197.128.55","26084","41.177.26.176","80","21","12679","8","825","13","11854","184.634573000","0.5681","11617.82","166930.41"
"77.197.128.225","22815","41.177.26.176","80","20","12643","9","887","11","11756","229.259865000","0.5681","12491.15","165553.56"
"77.197.128.167","64387","41.177.26.176","80","21","12682","8","826","13","11856","26.751706000","0.5678","11637.45","167038.26"
"77.197.128.127","50457","41.177.26.176","80","20","12607","8","825","12","11782","36.717748000","0.5674","11632.78","166130.27"
"15.186.110.142","51533","41.177.26.176","80","16","5462","8","1038","8","4424","209.031993000","0.5670","14645.55","62419.97"
"15.186.110.41","33219","244.3.210.197","80","29","18513","14","1503","15","17010","13.348756000","0.5664","21228.29","240248.30"
"41.177.230.253","44046","244.3.31.40","22","47","8925","24","4432","23","4493","166.348494000","0.5663","62611.25","63473.00"
"41.177.3.224","39052","41.177.117.184","1606","91","37667","47","23061","44","14606","78.616493000","0.5657","326094.56","206536.46"
"77.197.210.128","17687","41.177.26.176","80","21","12780","9","880","12","11900","3.853254000","0.5657","12444.36","168281.72"
"77.197.128.180","63829","41.177.26.176","80","21","12668","8","816","13","11852","66.859974000","0.5657","11540.44","167619.24"
"77.197.128.225","13417","41.177.26.176","80","22","13016","9","924","13","12092","215.025389000","0.5654","13074.42","171099.39"
"77.197.210.82","59166","41.177.26.176","80","22","12722","9","876","13","11846","185.387032000","0.5653","12396.80","167639.88"
"77.197.128.46","17150","41.177.26.176","80","21","12687","9","890","12","11797","112.820363000","0.5653","12595.37","166952.36"
"77.197.128.225","3314","41.177.26.176","80","22","12827","9","880","13","11947","199.006374000","0.5650","12460.55","169166.15"
"244.3.160.239","62321","85.241.98.37","80","59","50127","22","2768","37","47359","152.783752000","0.5645","39226.38","671142.46"
"77.197.128.41","5375","41.177.26.176","80","22","12967","8","860","14","12107","189.856936000","0.5643","12192.31","171642.24"
"77.197.128.180","11835","41.177.26.176","80","17","12334","5","633","12","11701","94.691452000","0.5638","8981.22","166017.85"
"77.197.128.176","23215","41.177.26.176","80","22","12687","9","876","13","11811","20.150703000","0.5638","12429.26","167582.13"
"77.197.128.12","33058","41.177.26.176","80","22","12729","9","877","13","11852","25.001905000","0.5638","12443.82","168168.94"
"244.3.160.239","62304","92.188.204.180","80","11","2468","6","1012","5","1456","143.802002000","0.5638","14359.52","20659.55"
"77.197.210.80","27505","41.177.26.176","80","21","12660","9","877","12","11783","40.197268000","0.5638","12444.57","167199.97"
"77.197.217.224","37185","41.177.26.176","80","22","12827","9","879","13","11948","21.420806000","0.5635","12479.17","169625.86"
"77.197.210.198","48080","41.177.26.176","80","21","12764","9","881","12","11883","61.892615000","0.5633","12512.07","168763.85"
"77.197.128.41","16126","41.177.26.176","80","21","12933","9","924","12","12009","207.544119000","0.5631","13128.10","170622.68"
"77.197.128.180","3666","41.177.26.176","80","21","12670","8","825","13","11845","76.008132000","0.5630","11722.64","168308.72"
"244.3.160.239","61782","43.106.84.231","80","280","279046","96","6894","184","272152","77.190995000","0.5629","97986.51","3868178.73"
"244.3.160.239","62305","92.188.204.180","80","11","1763","6","1015","5","748","143.802598000","0.5627","14429.83","10634.01"
"41.177.176.156","7157","244.3.160.239","80","54","33537","20","2424","34","31113","106.206613000","0.5624","34482.08","442591.21"
"77.197.128.225","7720","41.177.26.176","80","21","12633","9","887","12","11746","209.277072000","0.5621","12624.04","167172.51"
"77.197.128.251","44845","41.177.26.176","80","22","12811","9","880","13","11931","24.875428000","0.5620","12526.58","169834.79"
"77.197.128.150","31547","41.177.26.176","80","21","12347","9","880","12","11467","165.900614000","0.5618","12531.08","163288.55"
"77.197.128.13","47284","41.177.26.176","80","20","12601","9","889","11","11712","150.693173000","0.5617","12661.61","166808.50"
"41.177.176.156","11374","244.3.160.239","80","28","15769","11","1859","17","13910","95.919433000","0.5615","26488.23","198198.62"
"77.197.127.128","12285","41.177.26.176","80","13","5025","6","667","7","4358","178.501278000","0.5614","9504.30","62098.57"
"77.197.128.55","45372","41.177.26.176","80","20","12586","8","816","12","11770","221.825761000","0.5607","11641.93","167923.36"
"77.197.127.128","10562","41.177.26.176","80","11","4868","5","624","6","4244","176.731918000","0.5606","8904.70","60563.36"
"77.197.217.224","36414","41.177.26.176","80","22","12775","9","879","13","11896","19.503902000","0.5603","12550.33","169850.65"
"244.3.153.102","2863","244.3.160.80","443","67","45895","26","3171","41","42724","202.506289000","0.5602","45286.58","610161.99"
"15.71.149.82","37527","41.177.26.91","80","28","17825","14","1264","14","16561","91.928086000","0.5601","18054.37","236549.39"
"77.197.128.180","63760","41.177.26.176","80","21","12792","9","890","12","11902","66.298843000","0.5600","12713.83","170022.50"
"244.3.160.239","62625","30.222.71.108","80","12","3364","7","1344","5","2020","204.123706000","0.5600","19201.47","28859.36"
"244.3.160.239","62635","30.222.71.108","80","10","2317","6","1406","4","911","209.003222000","0.5598","20093.32","13019.21"
"77.197.217.20","37047","41.177.26.176","80","21","12749","9","889","12","11860","25.981511000","0.5592","12719.26","169685.52"
"77.197.217.20","38917","41.177.26.176","80","21","12956","9","926","12","12030","35.982179000","0.5587","13259.71","172261.65"
"77.197.128.224","54085","41.177.26.176","80","21","12636","9","887","12","11749","152.207064000","0.5585","12706.14","168302.68"
"77.197.210.128","38198","41.177.26.176","80","22","12766","9","872","13","11894","54.873574000","0.5585","12491.29","170380.09"
"77.197.210.128","36051","41.177.26.176","80","22","12733","9","889","13","11844","50.656628000","0.5583","12739.54","169726.76"
"41.177.124.47","6580","244.3.160.239","80","160","148435","46","4214","114","144221","31.487517000","0.5581","60401.81","2067206.69"
"77.197.217.20","60187","41.177.26.176","80","20","12689","7","752","13","11937","81.236958000","0.5576","10789.52","171269.31"
"253.160.251.90","1487","253.37.253.43","446","84","106165","0","0","84","106165","109.252134000","0.5575","N/A","1523315.52"
"77.197.128.251","41955","41.177.26.176","80","22","12836","10","951","12","11885","17.314176000","0.5571","13657.61","170684.24"
"244.3.181.123","2488","244.3.160.239","80","106","103045","38","9117","68","93928","138.325211000","0.5567","131003.85","1349668.70"
"244.3.160.239","62581","30.222.71.108","80","12","4222","7","1455","5","2767","202.196725000","0.5564","20918.40","39780.90"
"77.197.128.41","12521","41.177.26.176","80","21","12725","9","875","12","11850","197.583960000","0.5564","12579.86","170367.24"
"77.197.210.186","3671","41.177.26.176","80","21","12498","9","890","12","11608","2.625282000","0.5562","12800.23","166949.52"
"77.197.128.18","60680","41.177.26.176","80","21","12768","9","890","12","11878","140.318241000","0.5560","12805.04","170896.95"
"77.197.128.18","38032","41.177.26.176","80","22","12794","9","924","13","11870","216.230711000","0.5560","13296.06","170805.50"
"77.197.128.150","41185","41.177.26.176","80","22","12715","9","889","13","11826","221.911815000","0.5556","12800.25","170276.49"
"77.197.128.47","12545","41.177.26.176","80","20","12717","8","825","12","11892","107.895192000","0.5555","11880.50","171252.06"
"77.197.128.41","57825","41.177.26.176","80","20","12792","8","862","12","11930","162.843538000","0.5554","12415.18","171824.96"
"77.197.128.13","62662","41.177.26.176","80","21","12656","9","889","12","11767","212.262085000","0.5550","12813.84","169606.77"
"77.197.210.181","59223","41.177.26.176","80","21","12783","9","889","12","11894","66.534414000","0.5548","12819.59","171514.27"
"165.0.138.176","50120","41.177.26.91","80","12","7737","5","944","7","6793","50.347374000","0.5546","13616.82","97986.33"
"244.3.160.239","62290","92.188.204.180","80","11","1689","6","1005","5","684","141.571128000","0.5542","14507.63","9873.85"
"244.3.160.239","62289","92.188.204.180","80","11","2081","6","1008","5","1073","141.240600000","0.5542","14550.99","15489.30"
"77.197.128.55","21041","41.177.26.176","80","21","12734","9","880","12","11854","161.755126000","0.5542","12704.10","171129.94"
"77.197.128.118","22743","41.177.26.176","80","20","12713","8","824","12","11889","118.636772000","0.5541","11897.39","171660.31"
"41.177.211.185","13597","244.3.160.239","80","22","11899","9","1829","13","10070","160.463039000","0.5540","26412.41","145419.89"
"244.3.160.239","62296","92.188.204.180","80","11","2169","6","1020","5","1149","142.501384000","0.5538","14735.09","16598.65"
"244.3.160.239","62291","92.188.204.180","80","11","1708","6","1020","5","688","141.571652000","0.5534","14744.07","9945.02"
"77.197.217.224","62263","41.177.26.176","80","19","12523","7","748","12","11775","79.540283000","0.5534","10812.47","170209.69"
"244.3.160.239","62297","92.188.204.180","80","11","2308","6","1020","5","1288","142.501939000","0.5533","14748.14","18623.15"
"77.197.128.92","3952","41.177.26.176","80","20","12799","8","862","12","11937","159.945916000","0.5532","12465.20","172618.49"
"15.186.110.142","51648","41.177.26.176","80","25","13217","12","1320","13","11897","210.297096000","0.5531","19090.97","172064.63"
"77.197.128.46","25579","41.177.26.176","80","22","12832","9","887","13","11945","137.952438000","0.5531","12829.14","172766.65"
"77.197.128.180","58758","41.177.26.176","80","21","12793","9","889","12","11904","47.881901000","0.5531","12859.53","172193.26"
"253.160.251.85","44674","253.37.253.43","446","414","576219","0","0","414","576219","40.205059000","0.5530","N/A","8335793.22"
"77.197.217.224","65216","41.177.26.176","80","21","12687","9","881","12","11806","89.746509000","0.5528","12749.38","170850.44"
"18.132.77.186","11566","244.3.160.239","80","12","1971","6","1114","6","857","212.571461000","0.5527","16124.89","12404.87"
"18.132.77.186","13301","244.3.160.239","80","50","40908","18","1875","32","39033","210.401759000","0.5524","27156.40","565331.05"
"77.197.210.198","47329","41.177.26.176","80","19","12584","7","759","12","11825","60.445982000","0.5523","10994.56","171292.10"
"77.197.128.13","63657","41.177.26.176","80","20","12683","8","815","12","11868","217.980205000","0.5520","11811.04","171991.90"
"77.197.210.198","46760","41.177.26.176","80","21","12760","9","887","12","11873","59.037032000","0.5518","12859.78","172135.46"
"244.3.160.239","61936","198.123.241.156","80","25","15816","11","1419","14","14397","100.782746000","0.5517","20577.11","208772.82"
"77.197.127.110","21805","41.177.26.176","80","13","4958","6","689","7","4269","130.436041000","0.5513","9997.32","61942.73"
"77.197.217.152","24427","41.177.26.176","80","21","12679","9","889","12","11790","96.758602000","0.5513","12900.37","171085.90"
"77.197.128.223","57485","41.177.26.176","80","20","12575","8","808","12","11767","162.411898000","0.5510","11732.25","170858.14"
"145.67.223.161","8639","244.3.160.239","80","14","4281","7","1483","7","2798","75.832807000","0.5506","21545.92","40651.03"
"77.197.210.198","46201","41.177.26.176","80","22","12684","9","879","13","11805","57.625046000","0.5506","12771.82","171526.03"
"224.47.38.154","4934","41.177.26.176","80","15","8195","8","1414","7","6781","215.956933000","0.5505","20549.53","98547.62"
"90.38.138.255","10977","244.3.160.239","80","27","15738","10","1329","17","14409","100.749377000","0.5503","19319.63","209463.20"
"77.197.128.223","10682","41.177.26.176","80","21","12793","9","880","12","11913","180.564254000","0.5502","12795.91","173224.57"
"244.3.160.239","61775","244.3.31.75","80","11","3143","6","1376","5","1767","76.419539000","0.5502","20008.32","25693.83"
"77.197.128.139","60530","41.177.26.176","80","20","12879","8","860","12","12019","30.551951000","0.5501","12507.32","174797.03"
"77.197.210.122","46831","41.177.26.176","80","22","12697","9","876","13","11821","63.796635000","0.5500","12742.44","171950.26"
"77.197.127.164","54822","41.177.26.176","80","12","4941","6","689","6","4252","146.603742000","0.5499","10023.80","61859.53"
"77.197.217.224","40117","41.177.26.176","80","21","12612","9","871","12","11741","27.163470000","0.5498","12673.24","170834.09"
"41.177.176.156","9733","244.3.160.239","80","10","2196","5","1518","5","678","129.026839000","0.5497","22090.44","9866.48"
"15.186.110.142","41339","41.177.26.176","80","24","13002","12","1327","12","11675","69.564665000","0.5497","19312.28","169910.24"
"77.197.128.13","35656","41.177.26.176","80","22","12848","10","944","12","11904","109.226810000","0.5494","13746.51","173345.76"
"77.197.128.13","57353","41.177.26.176","80","23","13087","9","924","14","12163","191.956655000","0.5488","13468.43","177290.61"
"244.3.160.239","62303","92.188.204.180","80","11","1703","6","1013","5","690","143.478008000","0.5485","14773.92","10063.19"
"77.197.128.55","22657","41.177.26.176","80","22","12697","9","876","13","11821","166.481278000","0.5485","12776.15","172405.12"
"18.132.77.186","15358","244.3.160.239","80","39","28278","15","1730","24","26548","101.334472000","0.5483","25240.55","387333.04"
"77.197.210.159","30963","41.177.26.176","80","21","12613","9","876","12","11737","91.320127000","0.5482","12783.84","171283.05"
"77.197.128.251","43592","41.177.26.176","80","23","13065","9","924","14","12141","21.112687000","0.5481","13485.63","177195.93"
"244.3.160.239","62302","92.188.204.180","80","11","1955","6","1027","5","928","143.477082000","0.5481","14989.91","13544.92"
"41.177.124.47","7756","244.3.160.239","80","126","88302","43","4002","83","84300","224.392216000","0.5481","58418.03","1230544.66"
"77.197.128.180","61779","41.177.26.176","80","22","12539","9","872","13","11667","57.553475000","0.5480","12730.51","170328.94"
"77.197.128.118","45000","41.177.26.176","80","20","12694","8","813","12","11881","150.733146000","0.5479","11870.06","173466.46"
"244.3.160.239","62654","177.124.75.164","80","109","95914","40","4226","69","91688","211.981913000","0.5471","61792.43","1340658.94"
"77.197.210.159","30221","41.177.26.176","80","21","12669","9","881","12","11788","88.278170000","0.5462","12903.23","172648.38"
"77.197.128.46","20242","41.177.26.176","80","20","12685","8","815","12","11870","119.242835000","0.5460","11941.15","173915.91"
"15.186.110.132","43575","41.177.26.91","80","34","23963","16","1602","18","22361","39.537375000","0.5457","23486.21","327824.63"
"77.197.128.108","52611","41.177.26.176","80","21","12943","9","926","12","12017","130.284735000","0.5456","13578.58","176213.65"
"77.197.128.224","31150","41.177.26.176","80","21","12647","9","879","12","11768","197.238291000","0.5455","12890.50","172577.26"
"77.197.210.82","37144","41.177.26.176","80","21","12683","9","889","12","11794","131.996771000","0.5455","13037.63","172964.89"
"77.197.210.2","47990","41.177.26.176","80","21","12757","9","879","12","11878","76.515797000","0.5455","12891.99","174210.52"
"41.177.199.139","14362","244.3.160.239","80","12","3588","6","1599","6","1989","56.745598000","0.5451","23467.25","29190.97"
"77.197.128.13","47844","41.177.26.176","80","22","12692","9","880","13","11812","153.566162000","0.5449","12918.88","173406.56"
"77.197.217.20","54668","41.177.26.176","80","22","12717","9","880","13","11837","68.943872000","0.5449","12919.35","173779.96"
"77.197.128.92","18945","41.177.26.176","80","21","12775","8","825","13","11950","216.639365000","0.5446","12119.68","175551.67"
"41.177.176.156","14678","244.3.160.239","80","12","2420","6","1557","6","863","116.753519000","0.5442","22888.06","12686.19"
"77.197.128.224","64296","41.177.26.176","80","20","12348","8","815","12","11533","165.657531000","0.5442","11981.90","169554.94"
"77.197.128.41","62864","41.177.26.176","80","20","12623","8","826","12","11797","178.060167000","0.5441","12145.79","173467.12"
"15.186.110.142","42198","41.177.26.176","80","26","13350","13","1390","13","11960","80.893726000","0.5439","20443.32","175900.78"
"244.3.160.239","62222","151.241.241.198","80","129","117927","46","4022","83","113905","127.974320000","0.5435","59197.22","1676494.24"
"41.116.229.239","9384","244.3.160.239","80","57","38695","21","2312","36","36383","31.562963000","0.5434","34035.54","535603.35"
"244.3.160.239","61975","198.123.241.156","80","16","6198","8","1165","8","5033","103.963113000","0.5434","17151.87","74099.02"
"77.197.210.241","45927","41.177.26.91","80","22","20155","7","824","15","19331","104.216440000","0.5430","12139.63","284795.08"
"77.197.128.18","29639","41.177.26.176","80","22","12971","9","926","13","12045","140.736612000","0.5429","13644.66","177483.73"
"77.197.210.128","38687","41.177.26.176","80","21","12603","8","811","13","11792","56.087718000","0.5426","11957.44","173862.08"
"77.197.128.167","56202","41.177.26.176","80","22","12496","9","889","13","11607","11.885619000","0.5424","13111.71","171189.64"
"77.197.128.176","29577","41.177.26.176","80","21","12766","8","825","13","11941","34.998323000","0.5424","12168.88","176131.66"
"77.197.128.18","35880","41.177.26.176","80","22","12814","9","880","13","11934","207.261147000","0.5423","12982.46","176059.90"
"244.3.160.239","62731","197.154.128.197","80","93","85578","34","3316","59","82262","224.396812000","0.5421","48937.61","1214024.55"
"244.3.160.239","62411","128.71.90.164","80","24","14787","11","1639","13","13148","162.698069000","0.5418","24202.69","194153.11"
"77.197.128.84","37956","41.177.26.176","80","21","12770","8","823","13","11947","175.980911000","0.5417","12154.98","176446.59"
"244.3.160.239","61312","128.71.90.164","80","14","5070","7","1327","7","3743","6.485701000","0.5416","19600.78","55286.91"
"168.91.64.164","1133","244.3.210.255","80","16","12709","6","435","10","12274","23.031225000","0.5415","6426.02","181317.26"
"77.197.210.80","39932","41.177.26.176","80","21","12934","9","924","12","12010","65.981723000","0.5415","13651.57","177440.92"
"244.3.164.46","11574","244.3.160.239","80","77","51679","27","3170","50","48509","152.779762000","0.5414","46841.52","716793.50"
"77.197.128.55","3617","41.177.26.176","80","20","12685","8","816","12","11869","120.690503000","0.5412","12062.82","175457.85"
"244.3.160.239","61918","188.68.193.91","80","54","47058","21","2392","33","44666","98.541092000","0.5411","35365.52","660383.08"
"77.197.217.20","37639","41.177.26.176","80","22","12772","9","874","13","11898","28.639326000","0.5410","12923.38","175929.47"
"168.117.3.145","6346","244.3.160.239","80","16","7433","7","1364","9","6069","45.007171000","0.5410","20169.50","89742.43"
"41.177.176.156","13318","244.3.160.239","80","12","2055","6","1308","6","747","112.727839000","0.5410","19341.60","11046.01"
"77.197.210.123","54449","41.177.26.176","80","21","12735","9","889","12","11846","52.081753000","0.5409","13148.87","175209.80"
"77.197.210.110","30998","41.177.26.91","80","24","20271","9","955","15","19316","101.726479000","0.5407","14130.96","285815.22"
"186.136.103.68","11827","244.3.160.239","80","13","1964","7","1376","6","588","78.626895000","0.5406","20361.88","8701.15"
"77.197.128.118","10798","41.177.26.176","80","20","12557","7","759","13","11798","100.608758000","0.5403","11239.10","174702.04"
"186.136.103.68","5012","244.3.160.239","80","13","1967","7","1379","6","588","78.627371000","0.5399","20434.09","8713.02"
"244.3.160.239","61621","244.3.31.75","80","13","3562","7","1581","6","1981","56.747959000","0.5394","23447.71","29380.09"
"77.197.128.18","33259","41.177.26.176","80","21","12961","8","861","13","12100","155.015370000","0.5392","12773.60","179512.90"
"77.197.128.224","40993","41.177.26.176","80","22","12682","9","876","13","11806","208.229353000","0.5391","13000.22","175206.10"
"77.197.128.224","34199","41.177.26.176","80","20","12702","8","823","12","11879","201.208991000","0.5390","12215.89","176321.50"
"244.3.160.239","61231","128.71.90.164","80","23","14540","10","1478","13","13062","0.537369000","0.5385","21959.04","194065.64"
"77.197.128.13","48124","41.177.26.176","80","21","12754","9","875","12","11879","154.897712000","0.5384","13000.45","176494.08"
"77.197.128.118","12399","41.177.26.176","80","20","12701","8","816","12","11885","211.772329000","0.5381","12131.82","176699.39"
"244.3.160.239","61241","128.71.90.164","80","24","14630","11","1555","13","13075","1.223112000","0.5378","23129.99","194485.25"
"77.197.128.46","23274","41.177.26.176","80","20","12596","8","815","12","11781","132.503719000","0.5378","12123.22","175243.72"
"77.197.210.198","39864","41.177.26.176","80","19","12527","7","751","12","11776","43.526656000","0.5378","11171.52","175174.23"
"244.3.160.239","61225","128.71.90.164","80","24","14612","11","1548","13","13064","0.180794000","0.5378","23028.30","194342.22"
"151.77.39.25","7728","244.3.160.239","80","196","130785","68","5610","128","125175","214.549684000","0.5375","83491.46","1862931.13"
"77.197.128.13","62384","41.177.26.176","80","20","12725","8","825","12","11900","211.089401000","0.5372","12286.29","177220.47"
"77.197.217.224","1545","41.177.26.176","80","22","12956","9","926","13","12030","94.215855000","0.5371","13791.33","179168.16"
"244.3.160.239","61353","177.124.75.164","80","138","125223","50","5405","88","119818","14.947914000","0.5364","80605.32","1786858.20"
"77.197.128.118","42843","41.177.26.176","80","20","12708","8","813","12","11895","147.004175000","0.5364","12125.46","177407.57"
"244.3.160.239","62285","92.188.204.180","80","21","11759","10","1263","11","10496","140.162679000","0.5356","18863.98","156766.69"
"77.197.210.2","52539","41.177.26.176","80","21","12643","8","815","13","11828","86.674058000","0.5351","12185.34","176844.48"
"77.197.217.224","42445","41.177.26.176","80","21","12916","9","924","12","11992","32.233753000","0.5350","13817.80","179332.36"
"77.197.128.13","41869","41.177.26.176","80","20","12569","8","823","12","11746","131.193276000","0.5349","12307.78","175658.85"
"77.197.128.55","5070","41.177.26.176","80","22","12711","9","879","13","11832","126.985439000","0.5349","13146.82","176966.13"
"77.197.128.18","31924","41.177.26.176","80","21","12655","9","887","12","11768","195.005416000","0.5347","13270.57","176063.23"
"77.197.128.139","25778","41.177.26.176","80","21","12654","8","815","13","11839","84.719964000","0.5340","12209.01","177352.67"
"244.3.160.239","62577","30.222.71.108","80","10","2340","6","1390","4","950","201.569169000","0.5339","20827.36","14234.53"
"77.197.128.31","64660","41.177.26.176","80","20","12597","8","825","12","11772","28.544645000","0.5337","12366.13","176453.39"
"41.177.168.181","2125","244.3.160.239","80","380","284869","115","8011","265","276858","77.188228000","0.5337","120084.02","4150071.30"
"77.197.128.167","4638","41.177.26.176","80","20","12859","8","860","12","11999","31.400194000","0.5335","12897.03","179943.61"
"16.176.93.164","2993","244.3.160.239","80","12","3546","6","1454","6","2092","233.752394000","0.5332","21813.74","31385.37"
"77.197.128.251","46248","41.177.26.176","80","21","12655","9","887","12","11768","30.814307000","0.5327","13321.17","176734.51"
"77.197.210.128","36283","41.177.26.91","80","22","17959","8","820","14","17139","51.217688000","0.5318","12334.63","257808.80"
"77.197.128.118","25067","41.177.26.176","80","25","13391","10","939","15","12452","122.548907000","0.5311","14144.02","187562.60"
"41.177.176.106","2275","244.3.160.239","80","39","20931","15","1866","24","19065","66.858817000","0.5308","28123.43","287338.24"
"151.77.192.83","2182","244.3.160.239","80","10","2467","5","906","5","1561","8.384680000","0.5306","13658.80","23533.54"
"41.177.223.45","9856","244.3.160.239","80","15","4620","7","1058","8","3562","5.920007000","0.5305","15953.74","53711.92"
"77.197.217.20","61893","41.177.26.176","80","19","12810","7","796","12","12014","93.250289000","0.5305","12004.47","181183.07"
"77.197.128.143","37936","41.177.26.91","80","22","17982","8","814","14","17168","139.918765000","0.5303","12280.00","258996.44"
"244.3.160.239","62610","30.222.71.108","80","10","2165","6","1399","4","766","203.126911000","0.5302","21108.50","11557.62"
"41.177.176.156","16228","244.3.160.239","80","27","14671","11","1744","16","12927","162.646672000","0.5302","26314.80","195052.40"
"77.197.128.223","29514","41.177.26.176","80","21","12643","9","875","12","11768","232.029654000","0.5295","13218.95","177783.49"
"77.197.210.198","44300","41.177.26.176","80","21","12727","9","880","12","11847","53.378965000","0.5291","13304.56","179112.60"
"77.197.128.193","51137","41.177.26.176","80","22","13022","9","924","13","12098","226.897453000","0.5291","13971.32","182927.47"
"77.197.210.249","13229","41.177.26.176","80","21","12727","8","811","13","11916","53.807497000","0.5284","12278.72","180410.83"
"68.33.110.176","16327","244.3.160.239","80","112","116850","28","2887","84","113963","127.961642000","0.5278","43761.32","1727458.07"
"77.197.127.128","11358","41.177.26.176","80","21","12682","9","889","12","11793","177.341408000","0.5270","13496.33","179035.14"
"68.33.110.176","16343","244.3.160.239","80","10","2296","5","1288","5","1008","121.023517000","0.5265","19569.15","15314.99"
"244.3.160.239","61933","177.124.75.164","80","66","54495","25","3224","41","51271","100.398774000","0.5254","49085.73","780606.26"
"77.197.217.152","14655","41.177.26.91","80","23","17926","9","899","14","17027","71.021235000","0.5251","13696.00","259401.24"
"77.197.128.12","36986","41.177.26.176","80","21","12581","9","876","12","11705","32.704979000","0.5250","13347.58","178348.66"
"215.13.66.186","13416","244.3.160.239","80","12","3273","6","1509","6","1764","210.735125000","0.5248","23002.22","26889.27"
"77.197.217.224","34029","41.177.26.176","80","21","12951","9","925","12","12026","14.395613000","0.5248","14100.56","183322.47"
"77.197.128.13","47755","41.177.26.176","80","20","12874","8","860","12","12014","153.033079000","0.5247","13112.18","183174.10"
"77.197.128.139","16590","41.177.26.176","80","22","12708","9","880","13","11828","70.376263000","0.5243","13426.89","180469.60"
"77.197.128.176","29403","41.177.26.176","80","22","12820","9","890","13","11930","33.574277000","0.5239","13591.13","182182.25"
"77.197.128.224","50263","41.177.26.176","80","22","12996","9","924","13","12072","216.583631000","0.5233","14124.44","184534.96"
"77.197.210.160","18216","41.177.26.15","80","22","16348","9","878","13","15470","225.737521000","0.5233","13423.46","236515.86"
"77.197.128.193","47264","41.177.26.176","80","21","12743","9","887","12","11856","221.098563000","0.5231","13564.82","181312.82"
"77.197.128.18","33316","41.177.26.176","80","21","12756","9","887","12","11869","197.921962000","0.5228","13574.18","181636.97"
"77.197.128.153","23802","41.177.26.91","80","23","18649","9","850","14","17799","71.314097000","0.5226","13010.74","272444.97"
"253.160.251.79","2873","253.37.253.43","446","57","69226","0","0","57","69226","210.045715000","0.5220","N/A","1061022.27"
"244.3.153.0","3559","41.177.24.241","993","26","4652","12","1292","14","3360","179.849974000","0.5218","19807.18","51510.93"
"77.197.128.41","4824","41.177.26.176","80","21","12638","9","879","12","11759","189.200151000","0.5215","13484.70","180394.26"
"77.197.128.12","35553","41.177.26.176","80","20","12891","8","860","12","12031","30.020733000","0.5214","13194.16","184580.10"
"77.197.128.47","13903","41.177.26.176","80","21","12737","8","823","13","11914","111.168031000","0.5211","12633.91","182892.41"
"244.3.160.239","61314","128.71.90.164","80","16","6673","8","1476","8","5197","6.584590000","0.5211","22660.67","79788.29"
"77.197.127.51","55369","41.177.26.176","80","19","12744","8","823","11","11921","91.969518000","0.5210","12636.90","183043.07"
"77.197.128.211","5279","41.177.26.91","80","23","19316","8","848","15","18468","63.314945000","0.5209","13023.64","283632.72"
"77.197.210.128","41025","41.177.26.176","80","20","12564","7","748","13","11816","62.010892000","0.5206","11493.81","181565.34"
"77.197.210.241","16185","41.177.26.15","80","23","18074","9","879","14","17195","190.648119000","0.5203","13514.89","264378.31"
"77.197.128.82","51045","41.177.26.91","80","23","18483","9","896","14","17587","174.263773000","0.5193","13803.04","270930.82"
"77.197.210.48","51388","41.177.26.91","80","23","18863","9","903","14","17960","163.680581000","0.5193","13911.73","276694.00"
"77.197.128.118","7604","41.177.26.176","80","20","12873","8","861","12","12012","203.648737000","0.5192","13265.31","185067.28"
"244.3.160.239","61816","188.68.214.108","80","27","17933","12","1706","15","16227","78.735784000","0.5179","26351.05","250643.91"
"244.3.160.239","61632","117.246.95.43","80","14","3611","8","2765","6","846","57.956313000","0.5178","42719.44","13070.76"
"15.186.110.142","51688","41.177.26.176","80","28","13533","14","1460","14","12073","210.900760000","0.5176","22563.94","186585.27"
"244.3.153.102","2852","244.3.160.80","443","34","19051","14","2243","20","16808","198.545560000","0.5175","34675.47","259841.85"
"77.197.128.18","58326","41.177.26.176","80","22","12799","9","887","13","11912","136.209228000","0.5170","13725.21","184323.17"
"77.197.217.224","30197","41.177.26.176","80","22","12785","9","870","13","11915","9.380295000","0.5168","13467.57","184443.80"
"41.177.176.106","16065","244.3.160.239","80","33","18085","13","1744","20","16341","66.811898000","0.5164","27017.87","253153.09"
"244.3.181.123","4173","244.3.160.239","80","25","13757","10","1898","15","11859","138.317347000","0.5163","29410.23","183759.68"
"77.197.128.41","6096","41.177.26.176","80","20","12667","8","823","12","11844","190.950044000","0.5154","12773.33","183824.20"
"244.3.160.239","61436","188.68.72.71","80","27","17756","12","1529","15","16227","30.053963000","0.5153","23737.67","251923.64"
"15.71.149.82","45918","41.177.26.91","80","28","17647","14","1239","14","16408","151.937957000","0.5152","19238.31","254771.73"
"77.197.128.46","27573","41.177.26.176","80","21","12730","9","887","12","11843","144.925928000","0.5151","13777.20","183949.64"
"77.197.128.167","58059","41.177.26.176","80","20","12671","8","816","12","11855","14.939394000","0.5147","12682.67","184256.23"
"244.3.160.239","62384","244.3.31.75","80","17","10872","8","1658","9","9214","160.466311000","0.5145","25777.96","143255.83"
"244.3.160.239","61777","188.68.214.108","80","31","22551","13","2000","18","20551","76.512274000","0.5140","31127.62","319851.83"
"244.3.160.239","61980","198.123.241.156","80","17","8432","8","1156","9","7276","104.271269000","0.5133","18017.21","113402.44"
"77.197.128.223","29742","41.177.26.176","80","19","12598","7","750","12","11848","232.684512000","0.5129","11697.48","184788.99"
"244.3.160.239","62218","94.2.202.203","80","21","10057","13","8982","8","1075","126.602624000","0.5128","140113.33","16769.30"
"77.197.128.55","62709","41.177.26.176","80","22","12818","9","879","13","11939","109.771922000","0.5113","13754.31","186817.61"
"77.197.210.128","30511","244.3.210.197","80","16","9667","7","737","9","8930","159.217618000","0.5112","11534.17","139755.90"
"239.152.156.75","14495","41.177.26.176","80","7","460","4","262","3","198","233.140813000","0.5111","4101.26","3099.42"
"244.3.153.0","3562","41.177.24.241","993","26","3836","12","1294","14","2542","181.681697000","0.5108","20268.11","39815.72"
"41.177.3.224","52710","41.177.230.224","25","93","71938","56","69149","37","2789","1.086530000","0.5103","1084116.25","43725.87"
"244.3.160.239","61427","188.68.72.71","80","28","19730","12","1522","16","18208","29.209239000","0.5100","23873.43","285602.81"
"244.3.160.239","62288","92.188.204.180","80","18","8878","9","1198","9","7680","140.847639000","0.5097","18805.03","120553.08"
"77.197.210.123","38216","41.177.26.176","80","20","12675","8","816","12","11859","4.828029000","0.5091","12821.44","186335.18"
"239.152.167.98","7254","41.177.26.176","80","3","204","2","134","1","70","95.175105000","0.5077","2111.45","N/A"
"244.3.160.239","61385","198.123.241.156","80","25","15852","11","1437","14","14415","22.937534000","0.5065","22697.07","227681.51"
"41.177.211.185","2247","244.3.160.239","80","16","7077","7","1569","9","5508","197.226582000","0.5061","24800.64","87063.04"
"244.3.160.239","61511","41.43.180.128","80","17","4878","9","2697","8","2181","44.233816000","0.5049","42730.84","34555.42"
"168.91.64.164","2345","244.3.210.255","80","16","12709","6","435","10","12274","197.539180000","0.5045","6897.39","194617.26"
"77.197.128.55","48047","41.177.26.91","80","22","18552","8","824","14","17728","225.483845000","0.5044","13068.97","281173.11"
"244.3.153.40","2344","41.177.3.117","80","4","262","2","132","2","130","173.946892000","0.5040","2095.07","2063.33"
"41.177.223.45","6376","244.3.160.239","80","24","13965","10","1217","14","12748","1.521829000","0.5035","19336.87","202552.56"
"239.152.13.68","13728","41.177.26.176","80","7","460","4","262","3","198","164.653093000","0.5035","4163.14","3146.19"
"77.197.217.20","30540","41.177.26.91","80","25","19777","10","945","15","18832","11.348214000","0.5030","15028.39","299486.33"
"77.197.128.47","27875","41.177.26.91","80","26","19921","11","1013","15","18908","138.311293000","0.5030","16110.21","300702.73"
"244.3.160.239","62138","244.176.48.167","80","10","2577","6","1219","4","1358","115.245180000","0.5029","19390.49","21601.54"
"41.177.176.156","15205","244.3.160.239","80","12","3268","6","1553","6","1715","116.247897000","0.5029","24705.40","27282.53"
"41.177.230.253","44049","244.3.31.40","22","52","17535","27","6826","25","10709","166.982077000","0.5028","108609.31","170392.19"
"244.3.160.239","62181","244.3.31.108","80","11","2244","6","1238","5","1006","121.036256000","0.5024","19713.61","16019.30"
"208.51.205.98","1359","41.177.26.176","80","7","1472","5","1320","2","152","76.954395000","0.5007","21091.44","2428.71"
"68.33.110.176","10296","244.3.160.239","80","18","9945","10","8819","8","1126","126.585507000","0.5006","140930.94","17993.90"
"77.197.128.176","25524","41.177.26.176","80","20","12648","8","814","12","11834","23.591242000","0.5000","13023.79","189340.97"
"41.177.98.197","1521","244.3.185.120","1221","201","38162","100","21044","101","17118","156.786128000","0.4994","337103.13","274212.67"
"244.3.160.239","62546","30.222.71.108","80","10","2379","6","1392","4","987","197.956463000","0.4991","22313.32","15821.30"
"77.197.127.110","18652","41.177.26.176","80","21","12749","8","816","13","11933","124.178292000","0.4989","13085.55","191360.09"
"244.3.155.77","13103","244.3.160.239","80","15","4155","8","3232","7","923","57.953648000","0.4983","51886.65","14817.88"
"244.3.160.239","61236","128.71.90.164","80","16","7246","8","1362","8","5884","0.911140000","0.4979","21882.86","94536.52"
"77.197.127.136","43232","41.177.26.176","80","20","12676","8","812","12","11864","56.978023000","0.4962","13091.05","191271.16"
"77.197.128.193","50863","41.177.26.176","80","20","12666","8","814","12","11852","226.292283000","0.4958","13135.47","191254.99"
"151.77.217.75","12350","244.3.160.239","80","19","6813","10","1654","9","5159","103.959117000","0.4955","26702.08","83286.58"
"122.155.141.12","10298","244.3.160.239","80","14","4295","7","1497","7","2798","158.358232000","0.4948","24206.07","45242.87"
"77.197.128.41","16684","41.177.26.176","80","16","9059","7","748","9","8311","211.195465000","0.4946","12097.49","134414.78"
"16.176.93.164","12023","244.3.160.239","80","11","3480","6","1453","5","2027","233.649490000","0.4940","23528.84","32823.78"
"41.177.223.45","10500","244.3.160.239","80","16","6085","7","1014","9","5071","1.861237000","0.4936","16432.99","82181.18"
"41.177.211.185","4026","244.3.160.239","80","14","2542","7","1824","7","718","208.589240000","0.4933","29579.84","11643.82"
"118.16.167.139","54997","244.3.210.197","80","10","1037","7","647","3","390","3.460606000","0.4933","10493.01","6325.00"
"16.176.93.164","9997","244.3.160.239","80","12","2468","6","1511","6","957","63.941377000","0.4928","24528.82","15535.46"
"244.3.160.239","61393","177.124.75.164","80","66","54644","25","3802","41","50842","24.552206000","0.4928","61724.66","825409.07"
"118.16.167.139","55467","244.3.210.197","80","10","1132","7","742","3","390","5.790512000","0.4927","12046.87","6331.91"
"68.159.161.215","49187","244.3.210.197","80","16","8158","8","804","8","7354","39.979271000","0.4924","13061.89","119474.03"
"244.3.160.239","62294","92.188.204.180","80","11","1812","6","1015","5","797","142.232776000","0.4921","16499.20","12955.53"
"244.3.160.239","62295","92.188.204.180","80","11","2277","6","1018","5","1259","142.233202000","0.4921","16549.35","20467.22"
"151.77.217.75","3177","244.3.160.239","80","20","9059","10","1645","10","7414","104.252273000","0.4916","26772.24","120662.23"
"244.3.160.239","61737","188.68.214.181","80","28","20231","12","1564","16","18667","66.881030000","0.4896","25553.62","304993.29"
"77.197.210.241","43483","41.177.26.91","80","26","20168","11","961","15","19207","100.553434000","0.4895","15705.66","313900.78"
"15.186.110.132","48072","41.177.26.91","80","29","18480","14","1468","15","17012","90.526837000","0.4893","23999.23","278116.44"
"90.218.72.197","15524","244.3.160.239","80","44","30477","13","1429","31","29048","11.443023000","0.4892","23369.10","475035.42"
"77.197.128.211","3918","41.177.26.91","80","23","18002","9","880","14","17122","61.753844000","0.4884","14413.12","280433.38"
"41.177.176.156","3404","244.3.160.239","80","12","3707","6","1533","6","2174","108.443110000","0.4880","25130.53","35638.47"
"16.176.93.164","12286","244.3.160.239","80","12","2407","6","1450","6","957","44.515615000","0.4875","23794.58","15704.42"
"244.3.160.239","61318","128.71.90.164","80","13","4452","7","1311","6","3141","6.947965000","0.4874","21516.14","51550.11"
"244.3.160.239","61848","188.68.214.108","80","11","2491","6","1326","5","1165","84.938759000","0.4846","21888.01","19230.41"
"18.132.77.186","13987","244.3.160.239","80","37","27936","14","1664","23","26272","211.430178000","0.4839","27510.90","434354.73"
"41.177.176.106","8684","244.3.160.239","80","27","14852","11","1610","16","13242","66.872335000","0.4838","26625.27","218988.69"
"16.176.93.164","9283","244.3.160.239","80","12","3542","6","1452","6","2090","233.472013000","0.4834","24031.38","34590.62"
"15.186.110.142","39349","41.177.26.176","80","24","12805","12","1319","12","11486","42.712647000","0.4832","21838.65","190173.43"
"41.177.176.156","9164","244.3.160.239","80","12","3056","6","2492","6","564","92.639863000","0.4827","41300.42","9347.29"
"244.3.153.0","3551","41.177.24.241","993","24","2954","11","1024","13","1930","175.561222000","0.4817","17008.17","32056.41"
"244.3.160.239","62641","30.222.71.108","80","10","2499","6","1395","4","1104","210.046611000","0.4814","23181.76","18345.99"
"244.3.160.239","62642","30.222.71.108","80","12","3783","7","1479","5","2304","210.047193000","0.4806","24617.59","38349.51"
"16.176.93.164","5319","244.3.160.239","80","10","1993","5","1431","5","562","116.933413000","0.4798","23860.04","9370.61"
"244.3.160.239","62253","40.248.176.156","80","30","17586","13","2338","17","15248","136.244917000","0.4797","38987.70","254270.53"
"197.48.26.167","2510","41.177.98.124","25","16","1205","7","516","9","689","37.012698000","0.4796","8606.49","11492.00"
"41.177.211.185","10722","244.3.160.239","80","12","2253","6","1498","6","755","209.323262000","0.4793","25002.29","12601.29"
"18.132.77.186","12550","244.3.160.239","80","22","13801","9","1347","13","12454","101.335216000","0.4779","22549.03","208482.25"
"41.177.211.185","15098","244.3.160.239","80","12","2506","6","1502","6","1004","209.325310000","0.4777","25156.23","16815.48"
"244.3.160.239","62099","244.176.48.167","80","10","2088","6","1217","4","871","112.657868000","0.4774","20395.68","14597.07"
"41.177.199.139","12460","244.3.160.239","80","30","16983","12","2081","18","14902","230.295610000","0.4767","34925.92","250103.85"
"68.157.168.82","57274","244.3.210.197","80","29","19300","15","1394","14","17906","90.222376000","0.4765","23404.77","300635.49"
"77.197.210.136","34969","41.177.26.91","80","21","14999","9","841","12","14158","109.114183000","0.4744","14181.56","238742.55"
"41.177.211.185","9503","244.3.160.239","80","12","2455","6","1495","6","960","203.748964000","0.4738","25244.37","16210.43"
"41.177.98.252","6713","244.3.160.239","80","82","54639","30","3174","52","51465","24.548681000","0.4731","53668.81","870215.84"
"244.3.160.239","61306","128.71.90.164","80","23","14582","10","1507","13","13075","5.869095000","0.4729","25494.89","221198.23"
"244.3.160.239","61320","128.71.90.164","80","16","6427","8","1365","8","5062","7.132349000","0.4713","23171.28","85928.96"
"244.3.160.239","62009","188.68.193.91","80","40","32700","16","2057","24","30643","106.262104000","0.4704","34983.89","521152.75"
"16.176.93.164","9277","244.3.160.239","80","10","2259","5","1472","5","787","219.199926000","0.4699","25058.30","13397.34"
"77.197.210.202","7496","41.177.26.91","80","19","15142","7","775","12","14367","159.479410000","0.4697","13200.03","244702.96"
"244.3.160.239","62072","244.176.48.167","80","10","1865","6","1227","4","638","111.378541000","0.4692","20921.47","10878.48"
"41.177.176.156","7013","244.3.160.239","80","12","3198","6","1412","6","1786","199.122529000","0.4684","24114.34","30501.56"
"16.176.93.164","13998","244.3.160.239","80","15","5871","7","1588","8","4283","62.128454000","0.4683","27128.72","73168.96"
"77.197.217.224","48130","41.177.26.91","80","24","18635","10","909","14","17726","193.873217000","0.4677","15547.56","303186.05"
"77.197.210.217","16153","41.177.26.91","80","24","16364","12","1071","12","15293","41.788499000","0.4667","18359.63","262160.47"
"15.186.110.142","39708","41.177.26.176","80","18","8104","9","1102","9","7002","47.418066000","0.4665","18897.93","120075.63"
"41.177.223.45","15348","244.3.160.239","80","15","4532","7","1058","8","3474","6.483921000","0.4660","18161.41","59633.98"
"244.3.164.46","8943","244.3.160.239","80","12","1804","6","1120","6","684","143.107787000","0.4660","19227.80","11742.69"
"244.3.160.239","61932","188.68.211.24","80","33","27866","11","1478","22","26388","100.242880000","0.4659","25379.87","453128.59"
"41.177.176.106","11366","244.3.160.239","80","19","9139","8","1418","11","7721","67.037532000","0.4658","24356.36","132620.22"
"244.3.164.46","6661","244.3.160.239","80","13","3763","6","1128","7","2635","143.107449000","0.4657","19375.99","45262.18"
"77.197.128.165","19390","41.177.26.15","80","22","16677","9","879","13","15798","220.718708000","0.4656","15102.22","271427.56"
"244.3.160.239","61289","128.71.90.164","80","16","6678","8","1363","8","5315","4.597626000","0.4652","23438.93","91399.78"
"244.3.160.239","61449","197.154.128.197","80","126","146687","23","2632","103","144055","31.491551000","0.4652","45266.14","2477513.11"
"16.176.93.164","8196","244.3.160.239","80","12","3540","6","1451","6","2089","233.305309000","0.4646","24985.69","35971.81"
"244.3.160.239","62762","40.248.176.156","80","27","17412","12","2276","15","15136","230.298269000","0.4645","39195.17","260658.23"
"41.177.223.45","3456","244.3.160.239","80","23","13905","9","1155","14","12750","1.220477000","0.4644","19894.54","219615.07"
"244.3.160.239","62124","244.176.48.167","80","12","3123","7","1287","5","1836","114.655094000","0.4644","22169.49","31626.41"
"77.197.210.108","34809","41.177.26.91","80","22","17135","9","882","13","16253","11.378653000","0.4632","15234.25","280728.12"
"41.177.211.185","7968","244.3.160.239","80","12","2399","6","1745","6","654","197.140773000","0.4621","30210.96","11322.62"
"41.177.176.156","8710","244.3.160.239","80","19","9546","8","1667","11","7879","95.995770000","0.4619","28871.18","136458.30"
"41.177.211.185","7044","244.3.160.239","80","12","2513","6","1504","6","1009","201.730950000","0.4618","26054.17","17479.16"
"197.48.26.167","1140","41.177.98.141","25","14","1118","6","421","8","697","50.210283000","0.4614","7299.57","12085.04"
"77.197.210.224","53356","41.177.26.91","80","23","19283","8","781","15","18502","162.680337000","0.4613","13544.33","320867.11"
"244.3.164.46","2676","244.3.160.239","80","24","12576","10","2068","14","10508","139.789977000","0.4613","35864.10","182234.01"
"244.3.160.239","62225","188.68.193.91","80","12","2291","7","1523","5","768","129.094893000","0.4608","26438.73","13332.20"
"16.176.93.164","15535","244.3.160.239","80","10","2261","5","1474","5","787","221.182482000","0.4608","25589.28","13662.66"
"168.91.64.164","2416","244.3.210.230","80","16","12709","6","435","10","12274","104.817052000","0.4603","7559.81","213308.31"
"244.3.160.239","62544","30.222.71.108","80","10","2098","6","1394","4","704","197.635432000","0.4599","24248.64","12246.09"
"41.177.211.185","7177","244.3.160.239","80","12","2549","6","1518","6","1031","208.973191000","0.4599","26408.27","17936.05"
"145.67.150.3","13792","244.3.160.239","80","26","15617","8","1054","18","14563","22.915974000","0.4598","18337.05","253361.00"
"41.177.211.185","11997","244.3.160.239","80","12","2238","6","1489","6","749","197.493322000","0.4595","25922.53","13039.61"
"16.176.93.164","2311","244.3.160.239","80","10","2258","5","1471","5","787","218.808922000","0.4593","25622.16","13708.11"
"244.3.160.239","61942","177.124.75.164","80","40","30550","16","2694","24","27856","101.414906000","0.4591","46941.98","485380.73"
"41.177.223.45","10587","244.3.160.239","80","24","13943","10","1206","14","12737","0.535077000","0.4590","21019.01","221989.36"
"77.197.128.211","4738","41.177.26.91","80","21","16912","8","788","13","16124","62.626619000","0.4589","13735.73","281059.55"
"41.177.223.45","3044","244.3.160.239","80","15","5957","7","1143","8","4814","6.566356000","0.4587","19935.90","83964.51"
"41.177.230.253","44040","244.3.31.40","22","302","223487","114","19658","188","203829","162.381131000","0.4586","342933.90","3555797.85"
"41.177.176.156","7724","244.3.160.239","80","10","2194","5","1510","5","684","123.716551000","0.4585","26347.76","11935.01"
"244.3.160.239","62070","244.176.48.167","80","10","2262","6","1228","4","1034","111.328687000","0.4584","21433.26","18047.23"
"244.3.153.0","3560","41.177.24.241","993","25","3015","11","1021","14","1994","180.368998000","0.4580","17834.84","34831.22"
"244.3.160.239","62594","30.222.71.108","80","10","2228","6","1387","4","841","202.516234000","0.4576","24247.19","14702.15"
"244.3.160.239","62687","41.43.180.128","80","50","52793","13","1927","37","50866","216.837907000","0.4576","33691.02","889324.04"
"244.3.160.239","61297","128.71.90.164","80","16","7221","8","1376","8","5845","5.194957000","0.4574","24066.94","102232.01"
"244.3.160.239","62063","188.68.193.91","80","33","24630","14","1958","19","22672","110.766947000","0.4573","34253.82","396630.60"
"244.3.160.239","62176","40.248.176.156","80","24","14354","11","2204","13","12150","120.622058000","0.4569","38592.19","212747.33"
"244.3.160.239","62100","244.176.48.167","80","10","1871","6","1219","4","652","112.773070000","0.4568","21346.88","11417.69"
"244.3.160.239","62579","30.222.71.108","80","10","2162","6","1393","4","769","201.868408000","0.4568","24394.25","13466.75"
"122.155.141.12","6227","244.3.160.239","80","53","39130","17","2323","36","36807","159.781215000","0.4568","40682.39","644596.08"
"244.3.160.239","62590","30.222.71.108","80","10","2224","6","1383","4","841","202.407335000","0.4567","24223.69","14730.38"
"77.197.210.136","36494","41.177.26.91","80","22","18543","8","769","14","17774","111.654990000","0.4567","13469.49","311322.08"
"15.186.110.132","50109","41.177.26.91","80","37","26929","17","1687","20","25242","114.563694000","0.4563","29579.56","442588.78"
"41.177.223.45","14479","244.3.160.239","80","24","13951","10","1212","14","12739","0.178918000","0.4560","21265.30","223513.78"
"68.33.110.176","9681","244.3.160.239","80","18","10625","7","1376","11","9249","127.795620000","0.4558","24148.77","162319.76"
"244.3.153.0","3553","41.177.24.241","993","25","3012","11","1018","14","1994","176.454153000","0.4546","17913.27","35087.49"
"186.136.103.68","15385","244.3.160.239","80","11","1818","6","1300","5","518","78.507469000","0.4545","22881.08","9117.23"
"77.197.210.231","48245","41.177.26.91","80","22","16615","9","876","13","15739","136.822775000","0.4545","15419.65","277043.25"
"244.3.160.239","62644","177.124.75.164","80","52","42032","20","2902","32","39130","210.468156000","0.4544","51094.92","688953.94"
"253.160.251.85","44685","253.37.253.43","446","21","24518","0","0","21","24518","42.530332000","0.4538","N/A","432191.36"
"244.3.160.239","62220","94.2.202.203","80","19","10258","9","1487","10","8771","127.813961000","0.4538","26215.00","154627.95"
"77.197.210.117","63424","41.177.26.91","80","21","17451","8","820","13","16631","231.893968000","0.4533","14472.20","293520.82"
"244.3.160.239","62029","188.68.72.71","80","11","1860","6","1157","5","703","107.865791000","0.4526","20449.96","12425.52"
"77.197.128.12","55117","41.177.26.91","80","24","18993","10","968","14","18025","83.554396000","0.4523","17122.10","318828.34"
"244.3.160.239","62030","188.68.72.71","80","11","1826","6","1126","5","700","107.866694000","0.4521","19924.00","12386.15"
"41.177.230.253","44036","244.3.31.40","22","52","16261","26","4832","26","11429","159.667795000","0.4519","85543.51","202333.77"
"244.3.160.239","62261","40.248.176.156","80","24","14290","11","2140","13","12150","138.321946000","0.4502","38025.69","215893.49"
"77.197.210.123","41064","41.177.26.91","80","21","17512","8","818","13","16694","10.641623000","0.4501","14537.96","296695.19"
"244.3.160.239","62092","244.176.48.167","80","10","2852","6","1217","4","1635","112.263712000","0.4498","21646.38","29081.21"
"244.3.160.239","62292","92.188.204.180","80","13","2957","7","1075","6","1882","141.903627000","0.4497","19125.52","33483.00"
"41.177.176.156","6668","244.3.160.239","80","25","13164","10","1805","15","11359","102.723521000","0.4496","32116.15","202109.35"
"16.176.93.164","4357","244.3.160.239","80","10","2257","5","1470","5","787","218.457391000","0.4496","26157.51","14004.06"
"244.3.160.239","61248","128.71.90.164","80","23","14576","10","1496","13","13080","1.517286000","0.4493","26639.48","232917.39"
"244.3.160.239","62293","92.188.204.180","80","11","2713","6","1017","5","1696","141.904616000","0.4491","18115.35","30210.05"
"244.3.160.239","62533","128.71.90.164","80","23","14717","10","1569","13","13148","196.001831000","0.4491","27948.80","234206.99"
"244.3.160.239","62580","30.222.71.108","80","10","2163","6","1394","4","769","202.085843000","0.4489","24844.83","13705.65"
"168.91.64.164","3058","244.3.210.230","80","16","12709","6","435","10","12274","198.179246000","0.4487","7755.43","218827.86"
"77.197.210.239","21037","41.177.26.91","80","24","18749","10","965","14","17784","60.071239000","0.4486","17208.75","317140.32"
"244.3.160.239","62079","244.176.48.167","80","10","2374","6","1213","4","1161","111.688721000","0.4484","21643.08","20715.27"
"244.3.160.239","62639","30.222.71.108","80","10","2353","6","1400","4","953","209.696194000","0.4480","25000.89","17018.46"
"244.3.160.239","61441","188.68.161.253","80","15","4820","8","1224","7","3596","30.752010000","0.4480","21857.92","64216.58"
"244.3.253.224","2502","244.3.160.239","80","95","55400","40","3580","55","51820","216.832899000","0.4480","63931.57","925400.52"
"77.197.210.247","50288","41.177.26.91","80","22","17263","9","882","13","16381","10.833193000","0.4475","15765.94","292813.94"
"168.91.64.164","3064","244.3.210.197","80","16","12708","6","434","10","12274","22.430483000","0.4475","7758.07","219406.79"
"253.37.253.43","2000","253.127.160.2","515","11","1683","11","1683","0","0","27.439272000","0.4470","30123.10","N/A"
"168.91.64.164","1138","244.3.210.197","80","16","12708","6","434","10","12274","196.957492000","0.4469","7769.27","219723.47"
"244.3.160.239","62640","30.222.71.108","80","10","2506","6","1396","4","1110","209.697420000","0.4468","24995.02","19874.26"
"77.197.210.81","24129","41.177.26.91","80","22","18194","8","815","14","17379","140.470412000","0.4466","14598.97","311307.26"
"244.3.160.239","61939","177.124.75.164","80","39","29280","16","2693","23","26587","101.403725000","0.4466","48241.66","476272.15"
"244.3.160.239","62109","244.176.48.167","80","10","2160","6","1222","4","938","113.629608000","0.4462","21907.84","16816.33"
"244.3.160.239","62135","244.176.48.167","80","10","2350","6","1226","4","1124","115.103869000","0.4460","21989.31","20159.85"
"244.3.164.46","8201","244.3.160.239","80","21","11794","9","1306","12","10488","140.131107000","0.4455","23451.51","188330.36"
"244.3.160.239","62171","244.176.48.167","80","12","4438","7","1291","5","3147","119.074526000","0.4451","23205.70","56567.27"
"18.132.77.186","12131","244.3.160.239","80","18","10370","8","1106","10","9264","54.252961000","0.4450","19883.68","166548.31"
"41.177.211.185","3205","244.3.160.239","80","12","2329","6","1505","6","824","203.007902000","0.4448","27070.23","14821.18"
"16.176.93.164","15586","244.3.160.239","80","10","2276","5","1469","5","807","218.233627000","0.4447","26424.49","14516.38"
"244.3.181.123","5520","244.3.160.239","80","33","18175","13","1717","20","16458","30.050196000","0.4446","30894.77","296136.35"
"68.33.110.176","13780","244.3.160.239","80","70","58727","15","1727","55","57000","197.153480000","0.4442","31106.05","1026661.68"
"244.3.160.248","48700","41.177.26.55","80","22","12092","10","971","12","11121","129.039487000","0.4439","17499.87","200428.49"
"244.3.160.239","62306","92.188.204.180","80","11","1708","6","1020","5","688","144.143234000","0.4437","18389.77","12404.08"
"244.3.164.46","10176","244.3.160.239","80","12","1864","6","1122","6","742","143.800117000","0.4434","20242.66","13386.86"
"244.3.164.46","15868","244.3.160.239","80","12","2568","6","1119","6","1449","143.799856000","0.4434","20189.35","26143.32"
"15.71.149.82","52373","41.177.26.91","80","26","15889","13","1126","13","14763","31.941579000","0.4431","20327.94","266519.83"
"77.197.210.224","34761","41.177.26.91","80","21","17160","8","818","13","16342","38.789113000","0.4426","14784.22","295359.15"
"41.177.3.224","9405","244.3.41.117","4433","67","46161","35","33841","32","12320","183.018792000","0.4422","612283.76","222905.23"
"244.3.160.239","62556","30.222.71.108","80","10","2084","6","1384","4","700","199.287977000","0.4412","25096.79","12693.46"
"77.197.210.2","65253","41.177.26.91","80","19","13804","8","831","11","12973","133.905692000","0.4409","15077.09","235373.09"
"16.176.93.164","2695","244.3.160.239","80","10","1985","5","1425","5","560","123.500801000","0.4409","25856.20","10161.03"
"41.177.176.156","9705","244.3.160.239","80","12","2712","6","1767","6","945","93.115758000","0.4403","32109.03","17172.06"
"16.176.93.164","8757","244.3.160.239","80","10","1983","5","1423","5","560","123.947093000","0.4398","25881.73","10185.36"
"90.218.72.197","5875","244.3.160.239","80","42","28059","14","1544","28","26515","15.775071000","0.4398","28083.90","482282.73"
"77.197.128.12","49656","41.177.26.91","80","23","19025","9","876","14","18149","74.325252000","0.4397","15939.05","330225.73"
"244.3.153.0","3565","41.177.24.241","993","27","4116","12","1296","15","2820","182.941125000","0.4395","23588.67","51327.20"
"41.177.176.156","5857","244.3.160.239","80","12","3656","6","1521","6","2135","107.954296000","0.4395","27685.25","38861.28"
"15.186.110.132","41619","41.177.26.91","80","31","20355","15","1536","16","18819","18.537711000","0.4394","27966.62","342645.68"
"244.3.181.123","16183","244.3.160.239","80","33","20090","13","1710","20","18380","29.205954000","0.4388","31172.74","335061.35"
"244.3.160.239","61354","177.124.75.164","80","88","77291","32","4053","56","73238","15.215754000","0.4388","73893.78","1335265.91"
"244.3.164.46","11796","244.3.160.239","80","12","2269","6","1127","6","1142","142.496479000","0.4369","20634.70","20909.34"
"77.197.128.82","43110","41.177.26.91","80","20","15016","8","833","12","14183","161.716575000","0.4369","15254.28","259725.63"
"244.3.160.239","61791","188.68.214.108","80","19","10880","9","1521","10","9359","77.842087000","0.4368","27857.97","171415.36"
"77.197.210.128","30649","41.177.26.91","80","21","17459","8","776","13","16683","41.311192000","0.4366","14219.36","305697.82"
"68.33.110.176","14783","244.3.160.239","80","74","58983","19","1983","55","57000","201.089403000","0.4362","36370.31","1045439.96"
"77.197.128.211","64154","41.177.26.91","80","23","18385","9","881","14","17504","58.649952000","0.4357","16174.82","321366.69"
"244.3.160.239","62125","244.176.48.167","80","10","2044","6","1225","4","819","114.676277000","0.4357","22491.46","15037.15"
"244.3.160.239","61774","244.3.31.75","80","13","3872","7","1331","6","2541","75.850373000","0.4357","24438.10","46654.56"
"244.3.160.239","61433","188.68.72.71","80","19","10703","9","1344","10","9359","29.783964000","0.4353","24699.07","171993.02"
"244.3.164.46","13427","244.3.160.239","80","12","2181","6","1115","6","1066","141.237952000","0.4352","20495.76","19595.05"
"77.197.128.13","3590","41.177.26.176","80","12","8558","4","559","8","7999","234.042749000","0.4350","10280.46","147108.05"
"244.3.164.46","2636","244.3.160.239","80","12","1790","6","1112","6","678","141.568461000","0.4347","20463.09","12476.59"
"168.223.67.89","2665","244.3.210.197","80","8","3477","5","1203","3","2274","17.511033000","0.4342","22163.11","41894.37"
"244.3.160.239","62555","30.222.71.108","80","10","2169","6","1399","4","770","199.174649000","0.4341","25779.76","14189.00"
"244.3.164.46","6947","244.3.160.239","80","12","1809","6","1127","6","682","141.569566000","0.4341","20770.84","12569.40"
"41.177.230.253","43998","244.3.31.40","22","52","16847","27","6314","25","10533","138.723797000","0.4340","116398.90","194176.37"
"244.3.164.46","12915","244.3.160.239","80","12","2408","6","1127","6","1281","142.499916000","0.4337","20790.00","23630.87"
"68.157.168.51","46351","41.177.26.176","80","27","13545","14","1352","13","12193","233.741981000","0.4336","24943.73","224954.80"
"41.116.229.239","14690","244.3.160.239","80","13","3808","6","1090","7","2718","27.511446000","0.4335","20114.23","50156.39"
"244.3.160.239","62177","188.68.193.91","80","12","2303","7","1527","5","776","120.668614000","0.4330","28209.73","14335.79"
"18.132.77.186","2258","244.3.160.239","80","24","14402","10","1370","14","13032","214.101119000","0.4330","25309.79","240757.08"
"41.116.229.239","8521","244.3.160.239","80","13","3971","6","1243","7","2728","29.794681000","0.4323","23002.38","50483.11"
"244.3.160.239","61736","188.68.214.181","80","25","17560","11","1506","14","16054","66.826461000","0.4323","27872.18","297118.16"
"215.203.31.218","49224","244.3.210.197","80","32","29336","11","2301","21","27035","42.862973000","0.4322","42593.27","500438.47"
"244.3.160.239","62545","30.222.71.108","80","10","2137","6","1391","4","746","197.845760000","0.4321","25751.27","13810.53"
"77.197.210.239","11146","41.177.26.91","80","18","13413","7","748","11","12665","44.687157000","0.4321","13848.52","234480.59"
"68.33.110.176","12874","244.3.160.239","80","74","58983","19","1983","55","57000","212.309776000","0.4320","36723.50","1055592.21"
"77.197.210.67","22806","41.177.26.91","80","20","17228","7","747","13","16481","71.957898000","0.4320","13834.10","305220.66"
"41.177.211.185","8767","244.3.160.239","80","12","2478","6","1513","6","965","209.000762000","0.4319","28025.40","17874.76"
"41.177.211.185","9950","244.3.160.239","80","13","3436","6","1362","7","2074","204.121050000","0.4315","25252.38","38453.34"
"244.3.160.239","61740","188.68.214.181","80","19","10828","9","1372","10","9456","67.117557000","0.4314","25440.21","175337.18"
"41.177.176.156","11333","244.3.160.239","80","13","4556","6","1316","7","3240","119.002318000","0.4313","24412.53","60103.79"
"244.3.160.239","61776","188.68.214.108","80","28","18931","12","1861","16","17070","76.507186000","0.4307","34566.58","317061.56"
"244.3.160.239","61242","128.71.90.164","80","23","14566","10","1491","13","13075","1.223973000","0.4307","27694.39","242859.90"
"90.218.193.20","13995","244.3.160.239","80","85","82986","24","2446","61","80540","105.235455000","0.4301","45496.40","1498070.22"
"244.3.160.239","61516","117.246.95.43","80","14","3641","8","2785","6","856","45.034136000","0.4293","51897.11","15951.14"
"41.177.211.185","2181","244.3.160.239","80","13","4319","6","1498","7","2821","202.193682000","0.4289","27940.01","52616.00"
"77.197.210.231","44905","41.177.26.91","80","21","18402","7","724","14","17678","131.433524000","0.4287","13512.16","329928.08"
"244.3.164.46","6179","244.3.160.239","80","12","2055","6","1134","6","921","143.474879000","0.4284","21178.45","17200.49"
"244.3.164.46","5184","244.3.160.239","80","12","1804","6","1120","6","684","143.475464000","0.4282","20924.90","12779.13"
"244.3.160.239","62316","81.67.210.26","80","13","3098","7","1947","6","1151","151.586747000","0.4270","36477.41","21564.20"
"244.3.160.239","62704","198.123.241.156","80","21","11961","10","1675","11","10286","218.701511000","0.4267","31400.41","192826.65"
"186.136.103.68","3512","244.3.160.239","80","18","5658","9","1473","9","4185","78.967370000","0.4263","27643.87","78540.11"
"244.3.160.239","62618","30.222.71.108","80","12","3425","7","1446","5","1979","203.456786000","0.4260","27152.51","37161.00"
"77.197.217.218","28843","41.177.26.91","80","22","17313","9","880","13","16433","160.209091000","0.4255","16545.24","308963.57"
"77.197.210.67","56882","41.177.26.91","80","23","18962","9","877","14","18085","103.213473000","0.4253","16498.34","340219.40"
"244.3.160.239","61381","198.123.241.156","80","21","12247","10","1679","11","10568","20.986470000","0.4252","31591.40","198843.31"
"77.197.128.241","40971","41.177.26.91","80","23","18684","9","898","14","17786","40.319922000","0.4250","16902.85","334781.90"
"244.3.153.0","3552","41.177.24.241","993","27","4122","12","1291","15","2831","176.039624000","0.4248","24311.87","53312.87"
"244.3.160.239","62537","30.222.71.108","80","10","2790","6","1209","4","1581","196.452424000","0.4246","22777.32","29785.72"
"18.132.77.186","7902","244.3.160.239","80","25","16478","10","1370","15","15108","211.916308000","0.4242","25835.83","284910.79"
"77.197.210.239","20311","41.177.26.91","80","21","17277","8","822","13","16455","58.455049000","0.4242","15503.62","310355.31"
"68.33.110.176","11291","244.3.160.239","80","72","58855","17","1855","55","57000","200.627409000","0.4241","34988.86","1075129.38"
"244.3.160.239","62051","188.68.72.71","80","11","2730","6","1159","5","1571","109.904446000","0.4238","21877.21","29654.10"
"244.3.160.239","61840","188.68.214.108","80","16","7224","8","1523","8","5701","81.368947000","0.4225","28840.60","107958.15"
"77.197.210.136","31082","41.177.26.91","80","24","17251","11","1007","13","16244","101.769905000","0.4224","19069.80","307616.56"
"68.33.110.176","13094","244.3.160.239","80","73","58919","18","1919","55","57000","208.809400000","0.4221","36371.05","1080328.08"
"244.3.160.239","61251","128.71.90.164","80","16","6918","8","1425","8","5493","1.534817000","0.4218","27025.04","104174.42"
"244.3.160.239","61977","198.123.241.156","80","29","21012","12","1428","17","19584","103.966543000","0.4216","27097.55","371623.48"
"15.186.51.17","46656","41.177.98.79","80","55","43449","24","2130","31","41319","60.324739000","0.4214","40440.00","784479.01"
"244.3.153.0","3563","41.177.24.241","993","29","6071","13","1353","16","4718","182.181376000","0.4212","25697.09","89607.45"
"244.3.160.239","61245","128.71.90.164","80","14","5562","7","1293","7","4269","1.233955000","0.4207","24588.53","81182.07"
"244.3.160.239","61842","188.68.214.108","80","11","2186","6","1320","5","866","82.247966000","0.4207","25103.05","16469.12"
"244.3.160.239","62548","30.222.71.108","80","10","2708","6","1397","4","1311","198.150502000","0.4197","26627.59","24988.38"
"77.197.210.181","35937","41.177.26.91","80","22","17596","9","892","13","16704","13.851449000","0.4193","17020.30","318729.96"
"16.176.93.164","6245","244.3.160.239","80","10","1897","5","1427","5","470","124.494175000","0.4193","27229.25","8968.29"
"193.71.15.176","59727","41.177.26.176","80","25","7470","13","1014","12","6456","26.234217000","0.4191","19356.36","123239.33"
"77.197.210.80","41526","41.177.26.15","80","14","9737","6","847","8","8890","69.372154000","0.4188","16180.99","169833.53"
"244.3.160.239","62566","30.222.71.108","80","10","2654","6","1402","4","1252","200.602905000","0.4184","26809.96","23941.56"
"244.3.160.239","62522","128.71.90.164","80","17","8119","8","1619","9","6500","191.769693000","0.4183","30961.20","124303.78"
"77.197.217.224","1713","41.177.26.176","80","9","4750","3","492","6","4258","94.825683000","0.4181","9413.93","81472.55"
"244.3.160.239","62170","244.176.48.167","80","10","2757","6","1216","4","1541","119.022312000","0.4181","23269.61","29488.87"
"244.3.160.239","61432","188.68.72.71","80","11","2387","6","1142","5","1245","29.541476000","0.4179","21861.01","23832.71"
"253.160.251.85","44646","253.37.253.43","446","42","44556","0","0","42","44556","11.755215000","0.4176","N/A","853577.53"
"244.3.160.239","62565","30.222.71.108","80","10","2484","6","1402","4","1082","200.437130000","0.4175","26864.41","20732.74"
"41.177.223.45","7197","244.3.160.239","80","16","6585","7","1026","9","5559","0.908977000","0.4172","19671.71","106583.84"
"244.3.160.239","62091","188.68.193.91","80","25","17250","11","1769","14","15481","112.251130000","0.4172","33918.21","296827.48"
"18.132.77.186","7683","244.3.160.239","80","12","2053","6","1237","6","816","50.149137000","0.4163","23770.41","15680.40"
"77.197.210.198","59064","41.177.26.91","80","22","17735","8","824","14","16911","104.392439000","0.4159","15849.77","325285.82"
"244.3.160.239","62060","188.68.72.71","80","16","6879","8","1275","8","5604","110.582652000","0.4158","24532.09","107825.74"
"77.197.128.167","41667","41.177.26.91","80","22","17311","9","885","13","16426","130.443147000","0.4157","17031.23","316107.26"
"244.3.160.239","62534","30.222.71.108","80","12","4462","7","1278","5","3184","196.161156000","0.4153","24620.48","61339.29"
"15.186.110.132","41920","41.177.26.91","80","26","16454","13","1395","13","15059","21.799807000","0.4151","26882.37","290194.68"
"244.3.160.248","47807","41.177.26.193","80","14","3355","7","2457","7","898","67.618235000","0.4148","47381.10","17317.14"
"244.3.160.239","62551","30.222.71.108","80","10","2472","6","1394","4","1078","198.607870000","0.4146","26896.27","20799.27"
"41.177.3.224","52721","244.3.41.117","8412","34","16960","17","11978","17","4982","200.058359000","0.4146","231130.66","96133.99"
"41.177.230.253","44039","244.3.31.40","22","185","138761","75","17040","110","121721","161.675336000","0.4144","328932.92","2349650.48"
"16.176.93.164","3680","244.3.160.239","80","10","1983","5","1423","5","560","122.071394000","0.4142","27482.25","10815.22"
"244.3.160.239","61258","128.71.90.164","80","16","6387","8","1364","8","5023","1.833189000","0.4139","26361.95","97079.22"
"41.177.57.211","51412","244.3.210.197","80","40","31911","17","2275","23","29636","65.715590000","0.4138","43985.05","572984.97"
"244.3.160.239","62628","246.220.26.95","80","15","5345","8","1668","7","3677","205.733846000","0.4135","32271.95","71141.47"
"77.197.210.80","23593","41.177.26.91","80","20","17580","7","753","13","16827","191.266980000","0.4134","14572.97","325656.56"
"16.176.93.164","14752","244.3.160.239","80","10","1996","5","1436","5","560","123.081961000","0.4134","27791.62","10837.96"
"244.3.56.90","6521","244.3.160.239","80","112","77657","39","3534","73","74123","15.213324000","0.4132","68429.86","1435264.90"
"15.186.110.132","42314","41.177.26.91","80","29","18918","14","1466","15","17452","26.295768000","0.4127","28414.64","338262.12"
"244.3.160.239","61920","40.248.176.156","80","11","2066","6","1328","5","738","98.976614000","0.4126","25749.47","14309.57"
"244.3.160.239","61518","197.154.128.43","80","17","7598","9","1564","8","6034","45.083823000","0.4124","30341.39","117058.79"
"18.132.77.186","10313","244.3.160.239","80","12","2020","6","1236","6","784","49.821902000","0.4123","23981.20","15211.38"
"244.3.160.239","62179","244.176.48.167","80","12","3635","7","1803","5","1832","120.735924000","0.4119","35021.27","35584.56"
"18.132.77.186","3054","244.3.160.239","80","12","2292","6","1114","6","1178","213.209583000","0.4111","21677.84","22923.25"
"244.3.160.239","61921","40.248.176.156","80","13","2330","7","1393","6","937","98.977546000","0.4110","27113.50","18237.87"
"244.3.160.239","61839","188.68.214.108","80","11","2196","6","1320","5","876","81.258329000","0.4104","25731.62","17076.44"
"244.3.155.77","2386","244.3.160.239","80","15","4185","8","3252","7","933","45.031280000","0.4101","63434.63","18199.42"
"244.3.160.239","61738","188.68.214.181","80","22","14512","10","1436","12","13076","66.888604000","0.4101","28015.55","255105.38"
"16.176.93.164","11436","244.3.160.239","80","10","1904","5","1434","5","470","124.485958000","0.4098","27995.03","9175.50"
"244.3.160.239","62559","30.222.71.108","80","10","2104","6","1400","4","704","199.595092000","0.4097","27335.21","13745.70"
"16.176.93.164","14278","244.3.160.239","80","10","1903","5","1433","5","470","124.915923000","0.4095","27991.77","9180.83"
"244.3.160.239","62554","30.222.71.108","80","10","2306","6","1392","4","914","199.005333000","0.4095","27191.95","17854.48"
"244.3.160.239","61742","188.68.214.181","80","19","11993","9","1364","10","10629","67.401828000","0.4092","26666.99","207803.13"
"77.197.210.218","39289","41.177.26.91","80","21","17145","8","816","13","16329","102.771950000","0.4090","15959.51","319366.31"
"41.177.223.45","8569","244.3.160.239","80","13","3794","6","978","7","2816","6.946106000","0.4089","19134.96","55096.18"
"41.177.176.156","7121","244.3.160.239","80","10","2270","5","1474","5","796","96.489063000","0.4089","28840.82","15574.82"
"244.3.160.239","62570","30.222.71.108","80","10","2479","6","1403","4","1076","200.895217000","0.4087","27459.60","21059.53"
"244.3.160.239","61337","198.123.241.156","80","11","1645","6","1201","5","444","9.297732000","0.4087","23510.64","8691.69"
"77.197.128.143","39295","41.177.26.91","80","20","16830","7","744","13","16086","142.372896000","0.4086","14565.14","314912.38"
"244.3.160.239","62552","30.222.71.108","80","10","2357","6","1393","4","964","198.723632000","0.4086","27275.42","18875.45"
"244.3.160.239","62562","30.222.71.108","80","10","2143","6","1397","4","746","200.040922000","0.4085","27356.62","14608.47"
"244.3.160.239","62569","30.222.71.108","80","10","2397","6","1401","4","996","200.726408000","0.4083","27450.94","19515.44"
"244.3.160.239","61352","177.124.75.164","80","59","46763","23","3677","36","43086","14.900415000","0.4082","72068.54","844477.87"
"244.3.153.102","2851","244.3.160.80","443","17","4646","8","1772","9","2874","198.103111000","0.4082","34730.97","56330.02"
"244.3.160.239","61294","128.71.90.164","80","16","6582","8","1374","8","5208","4.826223000","0.4081","26934.71","102093.12"
"90.38.138.255","4738","244.3.160.239","80","10","1551","5","1111","5","440","9.269436000","0.4081","21779.46","8625.53"
"244.3.160.239","62550","30.222.71.108","80","10","2464","6","1397","4","1067","198.443187000","0.4080","27389.54","20919.57"
"244.3.160.239","62602","30.222.71.108","80","10","2167","6","1399","4","768","202.846280000","0.4080","27432.78","15059.60"
"244.3.160.239","62549","30.222.71.108","80","10","2712","6","1400","4","1312","198.328575000","0.4077","27472.66","25745.81"
"18.132.77.186","12778","244.3.160.239","80","13","3559","6","1236","7","2323","49.414370000","0.4076","24259.91","45595.29"
"41.177.211.185","13394","244.3.160.239","80","12","2501","6","1497","6","1004","201.565086000","0.4075","29385.64","19708.20"
"244.3.160.239","62563","30.222.71.108","80","10","2527","6","1401","4","1126","200.156720000","0.4071","27530.10","22126.26"
"244.3.160.239","62558","30.222.71.108","80","10","2173","6","1404","4","769","199.481689000","0.4071","27591.22","15112.29"
"244.3.160.239","62553","30.222.71.108","80","10","2422","6","1394","4","1028","198.895055000","0.4071","27395.58","20202.76"
"244.3.160.239","62574","30.222.71.108","80","10","2163","6","1393","4","770","201.287551000","0.4068","27392.48","15141.57"
"244.3.160.239","62571","30.222.71.108","80","10","2175","6","1405","4","770","201.008715000","0.4066","27643.88","15150.02"
"66.163.119.41","3366","41.177.26.91","80","18","11669","9","913","9","10756","115.824038000","0.4062","17981.73","211841.75"
"244.3.160.239","62286","92.188.204.180","80","13","3564","7","1069","6","2495","140.162683000","0.4058","21071.88","49180.85"
"244.3.160.239","62561","30.222.71.108","80","10","2480","6","1404","4","1076","199.877804000","0.4057","27682.75","21215.56"
"244.3.160.239","62560","30.222.71.108","80","10","2139","6","1400","4","739","199.763208000","0.4056","27616.00","14577.30"
"244.3.160.239","62576","30.222.71.108","80","10","2165","6","1394","4","771","201.455770000","0.4055","27498.93","15209.24"
"244.3.160.239","62198","40.248.176.156","80","38","29028","15","2093","23","26935","122.331055000","0.4055","41288.26","531342.24"
"41.177.3.224","52715","244.3.176.149","8752","30","13605","15","9046","15","4559","85.722703000","0.4052","178578.83","90000.10"
"244.3.160.239","62564","30.222.71.108","80","10","2523","6","1402","4","1121","200.325986000","0.4052","27682.82","22134.41"
"244.3.160.239","61847","188.68.214.108","80","11","2110","6","1403","5","707","84.164380000","0.4047","27732.96","13975.20"
"244.3.160.248","49698","41.177.26.55","80","11","1469","6","797","5","672","198.808778000","0.4046","15758.54","13287.00"
"77.197.128.241","46165","41.177.26.91","80","19","14513","8","741","11","13772","48.957609000","0.4043","14663.72","272535.45"
"68.33.110.176","15596","244.3.160.239","80","73","58919","18","1919","55","57000","204.959518000","0.4039","38004.99","1128860.96"
"244.3.160.239","62191","40.248.176.156","80","37","28389","15","2114","22","26275","121.976540000","0.4038","41878.28","520507.04"
"244.3.160.239","61844","188.68.214.108","80","11","2264","6","1323","5","941","82.704873000","0.4038","26210.54","18642.57"
"244.3.160.239","61919","40.248.176.156","80","38","28824","15","1890","23","26934","98.622348000","0.4035","37469.89","533975.67"
"244.3.160.239","62599","30.222.71.108","80","10","2167","6","1398","4","769","202.736342000","0.4035","27717.95","15246.86"
"244.3.160.239","62573","30.222.71.108","80","10","2080","6","1386","4","694","201.176354000","0.4034","27483.78","13761.72"
"244.3.160.239","61262","128.71.90.164","80","16","6832","8","1357","8","5475","1.891972000","0.4032","26924.60","108630.95"
"41.177.211.185","5947","244.3.160.239","80","12","2327","6","1506","6","821","203.124299000","0.4023","29948.99","16326.77"
"244.3.160.239","62715","117.246.95.43","80","10","1570","6","1093","4","477","220.688931000","0.4023","21736.97","9486.31"
"68.33.110.176","14112","244.3.160.239","80","56","46868","12","1535","44","45333","204.527393000","0.4020","30544.60","902070.72"
"244.3.160.239","62524","30.222.71.108","80","10","2358","6","1323","4","1035","192.299618000","0.4017","26349.33","20613.42"
"77.197.210.239","18287","41.177.26.91","80","21","17108","8","817","13","16291","55.268415000","0.4015","16279.12","324605.97"
"244.3.160.239","61263","128.71.90.164","80","16","7391","8","1365","8","6026","1.922887000","0.4014","27206.61","120107.73"
"41.177.230.253","44003","244.3.31.40","22","54","16831","27","4880","27","11951","140.916087000","0.4010","97355.39","238420.97"
"244.3.160.239","61897","40.248.176.156","80","37","28186","15","1911","22","26275","96.845470000","0.4007","38152.57","524572.82"
"186.136.103.68","9055","244.3.160.239","80","11","1816","6","1298","5","518","78.635210000","0.4004","25935.30","10350.14"
"41.177.230.253","44055","244.3.31.40","22","46","9069","24","4480","22","4589","170.263887000","0.4003","89529.94","91708.24"
"18.132.77.186","5976","244.3.160.239","80","12","2296","6","1236","6","1060","49.834502000","0.4002","24709.68","21191.15"
"68.33.110.176","15827","244.3.160.239","80","64","52037","15","1727","49","50310","208.365555000","0.4001","34530.42","1005920.86"
"244.3.160.239","61254","128.71.90.164","80","13","5668","7","1304","6","4364","1.596052000","0.3999","26087.04","87303.57"
"41.177.176.156","8463","244.3.160.239","80","12","2444","6","1317","6","1127","111.264223000","0.3998","26350.14","22548.68"
"244.3.160.239","62540","244.3.31.75","80","62","56443","23","2150","39","54293","197.165375000","0.3997","43027.32","1086549.96"
"41.177.230.253","43999","244.3.31.40","22","46","10263","25","5866","21","4397","139.208136000","0.3992","117565.42","88123.96"
"244.3.153.30","1150","41.177.24.241","993","9","959","4","368","5","591","196.342442000","0.3991","7376.89","11847.13"
"244.3.160.239","62567","244.3.31.75","80","62","56443","23","2150","39","54293","200.639331000","0.3983","43188.30","1090615.08"
"90.108.47.67","16685","244.3.210.197","80","24","18437","10","2047","14","16390","127.265898000","0.3981","41139.53","329397.58"
"41.177.230.253","44067","244.3.31.40","22","46","9853","24","5392","22","4461","191.977741000","0.3980","108372.38","89660.46"
"244.3.160.239","61442","188.68.194.244","80","13","3165","7","1160","6","2005","30.801596000","0.3978","23328.25","40321.67"
"41.177.176.156","3075","244.3.160.239","80","15","4763","7","1643","8","3120","150.250555000","0.3978","33045.05","62751.41"
"41.177.223.45","7118","244.3.160.239","80","24","13985","10","1235","14","12750","5.867024000","0.3976","24851.66","256565.69"
"15.186.110.132","55302","41.177.26.91","80","28","18146","14","1475","14","16671","173.587950000","0.3971","29717.61","335879.48"
"244.3.160.239","62287","92.188.204.180","80","11","2442","6","1010","5","1432","140.567235000","0.3968","20363.26","28871.48"
"41.177.230.253","44015","244.3.31.40","22","46","9853","24","5392","22","4461","150.630689000","0.3962","108862.49","90065.94"
"41.177.176.156","4830","244.3.160.239","80","16","7397","7","1603","9","5794","96.466497000","0.3960","32381.22","117041.05"
"244.3.160.239","62401","128.71.90.164","80","17","8118","8","1616","9","6502","161.518527000","0.3955","32689.80","131527.91"
"41.177.230.253","44012","244.3.31.40","22","46","9837","24","5376","22","4461","149.281525000","0.3954","108762.34","90250.89"
"244.3.160.239","62048","188.68.72.71","80","28","19646","12","1538","16","18108","109.578930000","0.3951","31138.88","366620.86"
"41.177.223.45","4894","244.3.160.239","80","16","5769","7","1032","9","4737","7.130597000","0.3944","20933.59","96087.63"
"244.3.160.239","61443","188.68.194.102","80","13","4426","7","1160","6","3266","30.805540000","0.3942","23544.10","66288.81"
"41.177.135.193","3422","244.3.160.239","80","14","3224","7","2002","7","1222","151.582254000","0.3940","40649.23","24811.87"
"18.132.77.186","8510","244.3.160.239","80","13","4027","6","1236","7","2791","49.441684000","0.3929","25168.69","56833.19"
"77.197.210.37","63903","41.177.26.91","80","17","12677","7","746","10","11931","221.381305000","0.3926","15200.29","243102.82"
"244.3.160.239","62661","244.3.31.75","80","62","56443","23","2150","39","54293","212.327686000","0.3926","43812.28","1106372.14"
"244.3.160.239","61437","188.68.72.71","80","13","3735","7","1212","6","2523","30.396998000","0.3922","24722.84","51465.11"
"41.177.230.253","44011","244.3.31.40","22","46","9821","24","5360","22","4461","148.844778000","0.3921","109346.47","91006.46"
"244.3.160.239","62298","92.188.204.180","80","11","2052","6","1020","5","1032","142.832164000","0.3920","20817.02","21061.92"
"244.3.160.239","62299","92.188.204.180","80","11","2172","6","1018","5","1154","142.832785000","0.3915","20803.27","23582.48"
"244.3.160.239","61244","128.71.90.164","80","16","6329","8","1368","8","4961","1.225077000","0.3912","27973.03","101443.13"
"244.3.160.239","62626","244.3.31.75","80","62","56443","23","2150","39","54293","204.539410000","0.3912","43964.25","1110209.67"
"18.132.77.186","16270","244.3.160.239","80","12","2219","6","1237","6","982","49.492948000","0.3912","25298.14","20083.08"
"41.177.230.253","44037","244.3.31.40","22","55","18803","31","14214","24","4589","161.168711000","0.3908","290961.94","93937.27"
"18.132.77.186","4150","244.3.160.239","80","12","2148","6","1237","6","911","49.492746000","0.3906","25334.54","18657.85"
"41.116.229.239","8768","244.3.160.239","80","10","3046","5","1271","5","1775","30.358785000","0.3905","26040.41","36366.43"
"41.177.176.106","12981","244.3.160.239","80","25","12389","10","1538","15","10851","67.386469000","0.3903","31526.65","222428.92"
"244.3.160.239","62056","188.68.72.71","80","11","2345","6","1148","5","1197","110.368514000","0.3903","23532.49","24536.92"
"244.3.160.239","62057","188.68.72.71","80","11","2347","6","1147","5","1200","110.369245000","0.3902","23514.40","24600.94"
"244.3.160.239","61914","40.248.176.156","80","11","1972","6","1325","5","647","98.178856000","0.3902","27165.90","13265.16"
"77.197.128.223","30194","41.177.26.176","80","8","4690","3","496","5","4194","234.063384000","0.3902","10170.26","85996.15"
"15.186.110.132","46983","41.177.26.91","80","24","14288","12","1325","12","12963","77.743138000","0.3898","27190.99","266020.24"
"244.3.164.46","14824","244.3.160.239","80","18","8913","8","1241","10","7672","140.845742000","0.3897","25477.84","157506.83"
"244.3.160.239","61916","40.248.176.156","80","13","3036","7","1393","6","1643","98.399698000","0.3897","28599.51","33732.23"
"41.116.229.239","5882","244.3.160.239","80","10","3032","5","1263","5","1769","28.693786000","0.3896","25935.62","36326.30"
"244.3.181.123","4361","244.3.160.239","80","12","3166","6","1220","6","1946","30.735425000","0.3895","25058.28","39970.01"
"244.3.160.239","61913","40.248.176.156","80","13","2896","7","1396","6","1500","98.069329000","0.3894","28682.30","30819.09"
"41.177.223.45","13402","244.3.160.239","80","16","6027","7","1037","9","4990","4.595727000","0.3893","21307.74","102531.96"
"244.3.160.239","61915","40.248.176.156","80","13","2338","7","1392","6","946","98.290007000","0.3884","28668.74","19483.21"
"244.3.160.239","61890","188.68.193.91","80","24","15536","11","1748","13","13788","96.020613000","0.3881","36027.59","284180.99"
"41.177.230.253","44062","244.3.31.40","22","46","10045","24","5440","22","4605","190.059442000","0.3880","112151.94","94937.44"
"41.177.230.253","44044","244.3.31.40","22","46","8861","24","4384","22","4477","165.926861000","0.3878","90432.77","92351.17"
"77.197.210.48","47835","41.177.26.91","80","22","16351","9","883","13","15468","159.781452000","0.3877","18222.20","319208.38"
"244.3.241.204","3654","244.3.160.239","80","10","1484","5","975","5","509","220.683818000","0.3872","20144.84","10516.64"
"244.3.160.239","61444","188.68.161.141","80","13","3965","7","1160","6","2805","30.813190000","0.3872","23968.92","57959.34"
"77.197.128.211","5758","41.177.26.91","80","20","16223","7","755","13","15468","63.972843000","0.3871","15604.65","319699.07"
"244.3.160.239","61243","128.71.90.164","80","16","6875","8","1366","8","5509","1.224080000","0.3868","28250.57","113932.95"
"41.177.230.253","44035","244.3.31.40","22","43","8643","23","4294","20","4349","159.148078000","0.3866","88857.62","89995.76"
"77.197.128.251","4906","41.177.26.46","80","8","989","5","632","3","357","77.531051000","0.3863","13088.51","7393.35"
"244.3.160.239","61910","40.248.176.156","80","11","2167","6","1331","5","836","97.854118000","0.3861","27579.85","17322.88"
"244.3.160.239","62052","188.68.72.71","80","11","2845","6","1161","5","1684","109.942803000","0.3859","24071.53","34915.12"
"244.3.181.123","14811","244.3.160.239","80","13","4485","6","1220","7","3265","30.739363000","0.3858","25295.85","67697.51"
"15.186.110.132","45546","41.177.26.91","80","26","15695","13","1431","13","14264","61.432370000","0.3857","29680.10","295846.91"
"244.3.160.239","62572","244.3.31.75","80","62","56443","23","2150","39","54293","201.101626000","0.3857","44598.75","1126232.62"
"41.177.230.253","44033","244.3.31.40","22","54","18441","30","13852","24","4589","158.284419000","0.3851","287766.50","95333.56"
"244.3.160.239","61924","40.248.176.156","80","13","3392","7","1394","6","1998","99.224442000","0.3848","28984.45","41543.00"
"106.37.77.3","58347","41.177.26.46","80","9","1135","5","683","4","452","210.415001000","0.3847","14204.64","9400.44"
"15.186.110.132","48428","41.177.26.91","80","29","19406","14","1436","15","17970","94.225057000","0.3846","29868.60","373773.46"
"244.3.160.239","61959","188.68.193.91","80","21","12931","10","1694","11","11237","102.797216000","0.3844","35250.45","233830.76"
"244.3.181.123","9790","244.3.160.239","80","12","1950","6","1250","6","700","107.860216000","0.3843","26021.20","14571.87"
"41.177.230.253","44008","244.3.31.40","22","46","10013","24","5408","22","4605","147.303981000","0.3839","112690.73","95957.99"
"244.3.181.123","7370","244.3.160.239","80","12","1984","6","1281","6","703","107.860156000","0.3838","26702.31","14653.96"
"41.177.230.253","44066","244.3.31.40","22","46","9853","24","5392","22","4461","191.552092000","0.3837","112427.32","93015.25"
"41.177.211.185","3897","244.3.160.239","80","12","2660","6","1502","6","1158","210.013626000","0.3835","31335.90","24159.10"
"244.3.160.239","61321","128.71.90.164","80","13","4691","7","1327","6","3364","7.159331000","0.3835","27685.41","70183.67"
"252.66.75.111","49232","244.3.210.197","80","6","1310","4","832","2","478","227.691108000","0.3834","17361.50","9974.52"
"41.177.211.185","13081","244.3.160.239","80","13","3880","6","1522","7","2358","210.014711000","0.3827","31812.30","49286.08"
"15.186.110.132","46789","41.177.26.91","80","28","18359","14","1477","14","16882","75.600132000","0.3825","30890.70","353078.35"
"41.177.230.253","43997","244.3.31.40","22","46","8861","24","4384","22","4477","138.272778000","0.3824","91724.12","93669.91"
"90.218.241.186","39825","244.3.210.197","80","58","51526","22","3507","36","48019","73.131244000","0.3823","73381.25","1004760.26"
"41.177.230.253","44042","244.3.31.40","22","46","8893","24","4400","22","4493","165.502128000","0.3823","92072.12","94018.19"
"41.177.223.45","7415","244.3.160.239","80","16","6563","7","1043","9","5520","5.192719000","0.3821","21835.22","115561.25"
"244.3.160.239","61946","188.68.193.91","80","22","14465","10","1681","12","12784","101.653714000","0.3817","35229.64","267921.33"
"244.3.160.239","62633","244.3.31.75","80","62","56443","23","2150","39","54293","208.823361000","0.3817","45064.52","1137994.37"
"244.3.160.239","61394","117.246.95.43","80","14","3691","8","2898","6","793","24.691270000","0.3816","60759.81","16626.13"
"244.3.160.239","62169","244.3.31.75","80","11","3297","6","1530","5","1767","118.874675000","0.3815","32080.35","37049.66"
"193.71.15.176","59728","41.177.26.176","80","25","7470","13","1014","12","6456","26.608251000","0.3814","21267.50","135407.30"
"18.132.77.186","2755","244.3.160.239","80","12","2156","6","1116","6","1040","71.373683000","0.3813","23413.04","21818.60"
"244.3.160.239","62719","198.123.241.156","80","14","2523","7","1951","7","572","221.540013000","0.3810","40966.63","12010.72"
"244.3.160.239","62664","177.124.75.164","80","13","3037","7","2077","6","960","212.711787000","0.3808","43638.69","20170.03"
"151.77.217.75","10400","244.3.160.239","80","41","25369","18","2281","23","23088","103.961905000","0.3806","47951.27","485356.84"
"244.3.160.239","62631","244.3.31.75","80","62","56443","23","2150","39","54293","208.377516000","0.3803","45228.64","1142138.89"
"15.186.110.132","50002","41.177.26.91","80","28","18204","14","1472","14","16732","113.112549000","0.3792","31053.13","352976.23"
"244.3.181.123","9031","244.3.160.239","80","15","4879","7","1284","8","3595","30.746303000","0.3792","27090.54","75849.28"
"41.177.168.181","15864","244.3.160.239","80","62","41398","21","2006","41","39392","76.802781000","0.3792","42324.47","831129.37"
"41.177.230.253","44070","244.3.31.40","22","46","9869","24","5408","22","4461","193.306659000","0.3792","114106.37","94125.09"
"244.3.160.239","62271","40.248.176.156","80","11","2173","6","1476","5","697","139.008541000","0.3790","31158.39","14713.68"
"41.177.230.253","44030","244.3.31.40","22","46","9629","24","4368","22","5261","156.226788000","0.3783","92367.23","111250.91"
"244.3.181.123","14182","244.3.160.239","80","13","4024","6","1220","7","2804","30.748261000","0.3775","25851.29","59415.59"
"41.177.230.253","44032","244.3.31.40","22","54","18441","30","13852","24","4589","157.862186000","0.3775","293543.76","97247.50"
"41.177.230.253","44050","244.3.31.40","22","46","11095","25","6698","21","4397","168.549451000","0.3775","141940.99","93179.24"
"244.3.160.239","61841","188.68.214.108","80","11","2343","6","1324","5","1019","81.961561000","0.3773","28071.81","21605.12"
"41.177.230.253","44034","244.3.31.40","22","43","8643","23","4294","20","4349","158.727545000","0.3769","91136.29","92303.61"
"244.3.160.248","48201","41.177.26.193","80","13","3291","7","2457","6","834","102.541470000","0.3766","52196.36","17717.44"
"41.177.230.253","44004","244.3.31.40","22","46","10567","25","6170","21","4397","142.371350000","0.3763","131178.21","93483.08"
"15.186.110.132","48410","41.177.26.91","80","29","18812","14","1466","15","17346","93.997460000","0.3761","31185.52","368993.17"
"244.3.160.239","62307","92.188.204.180","80","11","2399","6","859","5","1540","144.487800000","0.3758","18288.51","32787.32"
"15.186.110.132","50055","41.177.26.91","80","28","18313","14","1467","14","16846","113.876516000","0.3757","31235.36","358685.01"
"40.193.23.224","49880","41.177.98.176","80","35","24332","12","2096","23","22236","203.702209000","0.3756","44640.98","473586.27"
"244.3.160.239","62646","244.193.156.82","80","10","3107","6","1395","4","1712","210.897837000","0.3755","29721.24","36475.10"
"168.91.64.164","3096","244.3.210.230","80","16","12709","6","435","10","12274","23.732169000","0.3755","9268.24","261513.39"
"244.3.160.239","62269","40.248.176.156","80","14","6369","7","1493","7","4876","138.904265000","0.3753","31828.51","103948.98"
"244.3.160.239","61269","128.71.90.164","80","13","5964","7","1296","6","4668","2.172739000","0.3752","27630.76","99521.90"
"41.151.113.41","65379","244.3.210.197","80","19","13784","9","3542","10","10242","108.222968000","0.3750","75561.66","218493.09"
"40.193.23.224","49881","41.177.98.176","80","19","9885","8","1167","11","8718","203.703372000","0.3750","24896.33","185986.48"
"244.3.160.239","61316","128.71.90.164","80","14","4937","7","1327","7","3610","6.886310000","0.3748","28324.52","77054.63"
"41.177.223.45","13198","244.3.160.239","80","23","13915","9","1160","14","12755","1.514571000","0.3747","24767.93","272340.52"
"18.132.77.186","9770","244.3.160.239","80","12","2454","6","1236","6","1218","49.860694000","0.3745","26406.24","26021.68"
"40.193.23.224","49876","41.177.98.176","80","25","15804","9","1589","16","14215","203.699445000","0.3742","33974.86","303934.96"
"244.3.160.239","61252","128.71.90.164","80","14","5941","7","1292","7","4649","1.546144000","0.3739","27647.38","99483.48"
"168.117.3.145","6758","244.3.160.239","80","16","6194","7","1520","9","4674","149.937796000","0.3738","32534.77","100044.41"
"244.3.160.239","61285","198.123.241.156","80","11","1940","6","1496","5","444","3.625492000","0.3736","32033.58","9507.29"
"15.186.110.132","54284","41.177.26.91","80","29","18531","14","1476","15","17055","161.871915000","0.3730","31654.88","365768.33"
"244.3.164.46","3817","244.3.160.239","80","12","2377","6","1125","6","1252","142.230791000","0.3729","24134.44","26858.96"
"244.3.31.98","48317","41.177.98.220","7000","12","2305","6","1190","6","1115","122.625828000","0.3729","25529.56","23920.56"
"15.186.110.132","53357","41.177.26.91","80","28","17981","14","1469","14","16512","152.073302000","0.3729","31518.70","354279.65"
"244.3.164.46","7649","244.3.160.239","80","12","1913","6","1122","6","791","142.230476000","0.3728","24076.54","16973.75"
"244.3.160.239","61832","188.68.214.108","80","13","3912","7","1389","6","2523","79.966283000","0.3725","29834.16","54191.20"
"41.177.176.156","14243","244.3.160.239","80","10","2289","5","1466","5","823","95.539709000","0.3725","31488.71","17677.49"
"244.3.210.98","2804","77.197.64.211","80","6","1314","4","346","2","968","202.488309000","0.3724","7432.67","20794.29"
"244.3.160.204","51529","244.3.160.89","443","13","3841","5","362","8","3479","170.221092000","0.3721","7783.04","74798.91"
"41.177.211.185","6520","244.3.160.239","80","11","2476","5","1435","6","1041","197.953718000","0.3721","30854.66","22383.07"
"244.3.160.239","62650","177.124.75.164","80","37","28938","15","2627","22","26311","211.511044000","0.3721","56486.27","565744.31"
"41.177.93.84","1213","244.3.41.84","23","5","2549","2","149","3","2400","54.377132000","0.3719","3205.04","51624.84"
"244.3.153.102","2845","244.3.160.80","443","17","4045","8","1315","9","2730","197.006417000","0.3718","28292.04","58735.57"
"40.193.23.224","49879","41.177.98.176","80","35","30468","11","1033","24","29435","203.701686000","0.3710","22274.33","634699.87"
"41.177.230.253","44024","244.3.31.40","22","55","19443","31","14246","24","5197","154.283336000","0.3708","307334.69","112116.97"
"244.3.160.239","61357","177.124.75.164","80","30","21487","13","2838","17","18649","15.667150000","0.3706","61256.54","402527.53"
"90.218.72.197","15339","244.3.160.239","80","10","1445","5","878","5","567","3.454858000","0.3705","18957.04","12242.19"
"244.3.160.239","61883","198.123.241.156","80","11","2058","6","938","5","1120","93.231929000","0.3701","20276.92","24211.24"
"15.186.110.132","55527","41.177.26.91","80","28","18000","14","1426","14","16574","175.941724000","0.3700","30833.18","358365.47"
"244.3.160.239","61878","128.71.90.164","80","16","7668","8","1395","8","6273","92.059101000","0.3693","30218.84","135887.31"
"244.3.160.239","61752","188.68.214.181","80","13","3371","7","1165","6","2206","68.505054000","0.3691","25248.42","47809.46"
"18.132.77.186","11083","244.3.160.239","80","18","10233","8","1240","10","8993","211.430536000","0.3686","26915.49","195202.42"
"168.91.64.164","63537","244.3.210.98","80","17","14227","6","435","11","13792","105.357650000","0.3685","9444.59","299447.71"
"40.193.23.224","49882","41.177.98.176","80","23","13918","10","1319","13","12599","203.704386000","0.3681","28664.02","273796.81"
"244.3.160.239","62314","128.71.90.164","80","13","4869","7","1532","6","3337","150.321568000","0.3681","33295.57","72524.36"
"41.177.230.253","43996","244.3.31.40","22","46","10727","25","6186","21","4541","137.861557000","0.3679","134513.35","98743.15"
"168.117.3.145","12560","244.3.160.239","80","13","4258","6","1408","7","2850","90.008784000","0.3679","30620.18","61979.76"
"244.3.160.239","62047","188.68.72.71","80","11","2672","6","1148","5","1524","109.452020000","0.3678","24968.46","33146.29"
"15.186.110.132","57565","41.177.26.91","80","22","12188","11","1184","11","11004","199.072833000","0.3678","25753.27","239348.77"
"244.3.160.239","61309","128.71.90.164","80","13","4827","7","1330","6","3497","6.091920000","0.3676","28945.76","76107.77"
"244.3.160.239","61240","128.71.90.164","80","13","5583","7","1294","6","4289","1.219720000","0.3673","28187.19","93427.25"
"15.186.110.132","56334","41.177.26.91","80","28","18036","14","1465","14","16571","185.203402000","0.3670","31935.30","361228.58"
"244.3.160.239","61440","188.68.72.71","80","11","1885","6","1146","5","739","30.722430000","0.3668","24995.16","16118.17"
"244.3.160.239","62090","188.68.193.91","80","13","6229","7","1500","6","4729","112.097901000","0.3665","32746.35","103238.34"
"15.186.110.132","45795","41.177.26.91","80","29","18480","14","1468","15","17012","64.005207000","0.3663","32062.03","371552.59"
"244.3.160.239","61292","128.71.90.164","80","13","4640","7","1320","6","3320","4.667224000","0.3662","28839.30","72535.21"
"244.3.160.239","61833","188.68.214.108","80","15","5552","8","1446","7","4106","80.623827000","0.3653","31669.90","89928.49"
"244.3.160.239","61302","128.71.90.164","80","13","4925","7","1330","6","3595","5.356420000","0.3653","29129.54","78737.36"
"15.186.110.132","59744","41.177.26.91","80","29","18834","14","1471","15","17363","224.953572000","0.3651","32230.41","380432.79"
"244.3.160.239","62031","188.68.72.71","80","11","1850","6","1145","5","705","108.140771000","0.3651","25092.25","15449.81"
"244.3.181.123","9690","244.3.160.239","80","22","10942","9","1468","13","9474","29.780416000","0.3645","32217.62","207922.18"
"90.218.193.20","16103","244.3.160.239","80","13","4188","6","1456","7","2732","101.821476000","0.3642","31979.88","60006.20"
"18.132.77.186","8738","244.3.160.239","80","12","3072","6","1106","6","1966","210.095578000","0.3640","24306.89","43207.37"
"244.3.160.239","61253","128.71.90.164","80","13","5822","7","1289","6","4533","1.592809000","0.3639","28339.48","99660.87"
"244.3.160.239","62032","188.68.72.71","80","11","1883","6","1184","5","699","108.142192000","0.3637","26046.88","15377.34"
"244.3.160.239","61849","188.68.214.108","80","11","2619","6","1397","5","1222","85.876123000","0.3632","30769.65","26915.19"
"244.3.160.239","61749","188.68.214.181","80","12","1960","7","1185","5","775","68.478868000","0.3628","26132.98","17091.19"
"186.136.103.68","12680","244.3.160.239","80","13","1957","7","1368","6","589","78.883171000","0.3626","30183.02","12995.47"
"244.3.160.239","61426","188.68.72.71","80","11","1892","6","1141","5","751","29.027312000","0.3620","25217.49","16598.01"
"244.3.160.239","62043","188.68.72.71","80","11","2518","6","1142","5","1376","109.004740000","0.3618","25253.27","30427.75"
"168.117.3.145","15421","244.3.160.239","80","16","6195","7","1520","9","4675","60.087019000","0.3617","33621.81","103409.19"
"244.3.155.77","2777","244.3.160.239","80","15","4190","8","3365","7","825","24.688740000","0.3616","74442.58","18251.15"
"41.151.113.41","65378","244.3.210.197","80","16","11053","8","3457","8","7596","108.222963000","0.3613","76551.95","168206.14"
"18.132.77.186","11161","244.3.160.239","80","11","2246","5","1049","6","1197","100.597732000","0.3613","23229.94","26507.37"
"244.3.160.239","61911","40.248.176.156","80","13","2405","7","1396","6","1009","97.988921000","0.3609","30946.58","22367.55"
"18.132.77.186","15667","244.3.160.239","80","14","5026","6","1113","8","3913","100.597561000","0.3605","24700.13","86838.81"
"244.3.160.239","61267","85.241.98.37","80","14","5020","8","1599","6","3421","2.141228000","0.3595","35581.37","76124.99"
"15.186.110.132","55646","41.177.26.91","80","28","17747","14","1465","14","16282","177.304066000","0.3594","32608.54","362411.14"
"41.177.223.45","8671","244.3.160.239","80","23","13905","9","1155","14","12750","1.220819000","0.3590","25736.44","284103.57"
"244.3.160.239","61328","128.71.90.164","80","13","4746","7","1327","6","3419","7.624407000","0.3586","29600.05","76264.19"
"168.117.3.145","7117","244.3.160.239","80","10","1977","5","1331","5","646","193.687818000","0.3584","29708.58","14419.04"
"244.3.153.0","3557","41.177.24.241","993","25","3019","11","1025","14","1994","178.781413000","0.3584","22881.76","44513.40"
"41.177.98.220","7010","244.3.3.249","1075","7","1959","4","1601","3","358","188.983942000","0.3581","35767.44","7997.97"
"244.3.160.239","61347","128.71.90.164","80","10","2100","6","1189","4","911","12.103712000","0.3577","26595.69","20377.35"
"15.186.110.132","55886","41.177.26.91","80","28","17258","14","1464","14","15794","180.293817000","0.3570","32809.57","353957.91"
"244.3.160.204","51539","244.3.160.239","443","7","448","4","256","3","192","170.223715000","0.3569","5738.17","4303.63"
"253.160.251.90","1706","253.37.253.43","446","99","126067","0","0","99","126067","175.558387000","0.3569","N/A","2825759.02"
"41.177.230.253","44000","244.3.31.40","22","46","10279","25","5882","21","4397","139.650445000","0.3569","131854.58","98565.90"
"41.177.230.253","44051","244.3.31.40","22","46","11095","25","6698","21","4397","168.969992000","0.3569","150157.91","98573.35"
"41.177.223.45","9084","244.3.160.239","80","14","4901","6","957","8","3944","1.221687000","0.3567","21460.65","88443.88"
"244.3.160.239","61310","128.71.90.164","80","13","5010","7","1327","6","3683","6.321326000","0.3563","29799.21","82705.73"
"41.177.124.47","13092","244.3.160.239","80","34","24696","13","2069","21","22627","225.297061000","0.3562","46462.15","508119.37"
"41.177.230.253","44056","244.3.31.40","22","46","11063","25","6666","21","4397","170.721156000","0.3559","149831.84","98831.48"
"68.33.110.176","10061","244.3.160.239","80","10","2226","5","1172","5","1054","121.719862000","0.3559","26346.03","23693.45"
"244.3.160.239","61293","128.71.90.164","80","13","5055","7","1327","6","3728","4.825396000","0.3557","29841.35","83834.62"
"18.132.77.186","13812","244.3.160.239","80","12","2057","6","1236","6","821","49.879644000","0.3557","27800.50","18466.19"
"41.177.230.253","44014","244.3.31.40","22","43","8659","23","4310","20","4349","150.129268000","0.3556","96949.52","97826.79"
"244.3.160.239","62742","197.154.128.197","80","33","24534","14","2023","19","22511","225.300857000","0.3556","45508.61","506398.59"
"41.177.176.106","11044","244.3.160.239","80","16","6579","7","1354","9","5225","67.053124000","0.3556","30459.22","117540.20"
"145.67.223.161","13327","244.3.160.239","80","54","39186","17","2309","37","36877","77.167167000","0.3555","51957.55","829813.15"
"244.3.160.239","61326","128.71.90.164","80","14","4712","7","1327","7","3385","7.441626000","0.3550","29902.62","76277.61"
"41.177.180.176","4677","41.177.230.197","2967","10","1610","10","1610","0","0","62.462659000","0.3548","36300.20","N/A"
"244.3.160.239","61325","128.71.90.164","80","13","4842","7","1327","6","3515","7.422601000","0.3543","29966.01","79374.94"
"244.3.160.239","62627","244.3.31.75","80","62","56443","23","2150","39","54293","204.972881000","0.3541","48570.69","1226534.28"
"244.3.181.123","14881","244.3.160.239","80","12","2853","6","1283","6","1570","109.900448000","0.3535","29034.05","35528.80"
"151.77.39.25","8300","244.3.160.239","80","17","5595","8","1772","9","3823","205.730167000","0.3534","40116.02","86548.28"
"41.177.176.156","12526","244.3.160.239","80","12","2939","6","1305","6","1634","118.988228000","0.3532","29558.66","37010.61"
"41.177.230.253","44054","244.3.31.40","22","43","8659","23","4310","20","4349","169.792199000","0.3522","97896.70","98782.54"
"18.132.77.186","5238","244.3.160.239","80","13","3788","6","1114","7","2674","210.714348000","0.3515","25356.43","60864.54"
"244.3.160.239","61324","128.71.90.164","80","13","4878","7","1327","6","3551","7.347833000","0.3515","30205.34","80828.31"
"41.177.176.156","3671","244.3.160.239","80","13","4355","6","1539","7","2816","102.027479000","0.3513","35044.57","64123.15"
"41.177.230.253","44013","244.3.31.40","22","43","8659","23","4310","20","4349","149.733899000","0.3510","98229.14","99117.99"
"41.177.230.253","44041","244.3.31.40","22","46","11495","25","6698","21","4797","165.107632000","0.3510","152676.19","109344.24"
"18.132.77.186","5392","244.3.160.239","80","16","8399","7","1220","9","7179","211.429353000","0.3504","27856.82","163921.42"
"41.177.83.247","15434","244.3.160.239","80","22","11763","9","1896","13","9867","55.121661000","0.3502","43310.17","225391.04"
"242.161.82.241","61683","244.3.210.197","80","47","41946","18","1742","29","40204","158.527412000","0.3502","39799.97","918552.28"
"244.3.160.239","61315","128.71.90.164","80","13","4735","7","1327","6","3408","6.805452000","0.3500","30329.35","77891.80"
"244.3.153.0","3564","41.177.24.241","993","27","4566","12","1295","15","3271","182.605788000","0.3499","29610.32","74791.78"
"41.177.199.139","7228","244.3.160.239","80","12","1914","6","1147","6","767","98.974014000","0.3498","26234.76","17543.21"
"18.132.77.186","7833","244.3.160.239","80","15","5349","7","1219","8","4130","101.334477000","0.3495","27901.20","94529.91"
"244.3.160.239","62210","188.68.193.91","80","12","2289","7","1515","5","774","123.848058000","0.3491","34715.96","17736.07"
"18.132.77.186","8306","244.3.160.239","80","12","2381","6","1237","6","1144","50.706411000","0.3491","28346.53","26215.38"
"244.3.160.239","61773","188.68.214.108","80","13","4524","7","1456","6","3068","75.779960000","0.3491","33370.48","70316.37"
"41.177.199.139","12782","244.3.160.239","80","12","2055","6","1148","6","907","98.975285000","0.3490","26313.53","20789.52"
"18.132.77.186","14093","244.3.160.239","80","12","2367","6","1237","6","1130","50.707760000","0.3489","28359.61","25906.51"
"244.3.181.123","5148","244.3.160.239","80","62","40135","23","2790","39","37345","133.177803000","0.3488","63995.05","856593.18"
"244.3.160.239","61288","128.71.90.164","80","13","4844","7","1330","6","3514","4.566018000","0.3487","30511.06","80613.43"
"242.161.82.241","56558","244.3.210.197","80","42","37622","16","1529","26","36093","72.308500000","0.3487","35076.65","828006.26"
"168.91.64.164","4005","244.3.210.98","80","16","12709","6","435","10","12274","198.711355000","0.3487","9980.35","281606.61"
"244.3.160.239","61305","128.71.90.164","80","13","4863","7","1330","6","3533","5.839872000","0.3485","30529.44","81098.14"
"90.218.193.20","5305","244.3.160.239","80","10","3265","5","1486","5","1779","102.563442000","0.3485","34113.57","40839.87"
"244.3.160.239","61304","128.71.90.164","80","13","4710","7","1327","6","3383","5.531165000","0.3484","30468.27","77674.58"
"244.3.160.239","61846","188.68.214.108","80","11","2143","6","1403","5","740","83.420675000","0.3483","32223.34","16995.91"
"41.177.223.45","9932","244.3.160.239","80","16","6257","7","1089","9","5168","1.531396000","0.3482","25020.10","118736.36"
"244.3.160.239","61319","128.71.90.164","80","13","4988","7","1327","6","3661","7.000414000","0.3481","30501.10","84148.10"
"244.3.160.239","62049","188.68.72.71","80","17","8807","8","1281","9","7526","109.698909000","0.3480","29446.75","173002.55"
"244.3.160.204","31139","244.3.160.89","443","13","3841","5","362","8","3479","48.204512000","0.3477","8328.30","80039.11"
"244.3.160.239","61332","117.246.95.43","80","10","2439","6","897","4","1542","8.388186000","0.3476","20643.23","35487.03"
"41.177.230.253","44053","244.3.31.40","22","43","8659","23","4310","20","4349","169.387099000","0.3474","99265.87","100164.10"
"15.186.110.132","46358","41.177.26.91","80","28","17005","14","1467","14","15538","70.769964000","0.3470","33818.30","358192.78"
"244.3.160.239","62034","188.68.72.71","80","13","4369","7","1203","6","3166","108.360844000","0.3468","27749.50","73029.87"
"244.3.160.239","62035","188.68.72.71","80","11","2412","6","1159","5","1253","108.361805000","0.3467","26741.50","28910.35"
"15.186.110.132","57749","41.177.26.91","80","28","17126","14","1471","14","15655","201.104207000","0.3467","33947.49","361283.47"
"244.3.181.123","9783","244.3.160.239","80","12","2510","6","1266","6","1244","29.538300000","0.3466","29219.23","28711.47"
"41.177.230.253","44025","244.3.31.40","22","43","8755","23","4294","20","4461","154.698715000","0.3461","99255.41","103115.60"
"41.177.230.253","44069","244.3.31.40","22","43","8659","23","4310","20","4349","192.818472000","0.3454","99827.73","100731.05"
"244.3.181.123","12231","244.3.160.239","80","16","6937","7","1335","9","5602","110.579108000","0.3451","30944.14","129849.51"
"244.3.160.239","62224","188.68.193.91","80","10","2035","6","1449","4","586","128.715006000","0.3451","33591.43","13584.94"
"41.177.230.253","44002","244.3.31.40","22","43","8659","23","4310","20","4349","140.450029000","0.3450","99951.88","100856.32"
"168.117.3.145","4354","244.3.160.239","80","16","6195","7","1520","9","4675","189.769753000","0.3446","35284.63","108523.44"
"168.117.3.145","11471","244.3.160.239","80","13","4258","6","1408","7","2850","189.398806000","0.3445","32693.81","66177.11"
"244.3.160.239","62044","188.68.72.71","80","11","2455","6","1143","5","1312","109.175966000","0.3445","26541.20","30465.49"
"244.3.181.123","9586","244.3.160.239","80","49","29452","18","2101","31","27351","122.327688000","0.3444","48798.47","635262.76"
"90.218.193.20","7330","244.3.160.239","80","167","137235","40","3460","127","133775","103.699779000","0.3442","80420.00","3109302.05"
"168.117.3.145","7209","244.3.160.239","80","18","7392","8","2654","10","4738","90.400433000","0.3441","61702.10","110152.42"
"168.117.3.145","16233","244.3.160.239","80","13","4258","6","1408","7","2850","59.719802000","0.3436","32786.60","66364.92"
"244.3.160.239","61614","41.177.230.67","80","21","11105","9","1786","12","9319","55.125729000","0.3432","41626.12","217197.00"
"41.177.230.253","44009","244.3.31.40","22","43","9123","23","4278","20","4845","147.731890000","0.3431","99739.46","112958.79"
"244.3.181.123","4736","244.3.160.239","80","49","28871","18","2122","31","26749","121.973381000","0.3431","49476.70","623681.55"
"41.177.230.253","44063","244.3.31.40","22","43","9123","23","4278","20","4845","190.491473000","0.3426","99888.80","113127.92"
"244.3.160.239","61322","128.71.90.164","80","13","4839","7","1327","6","3512","7.230012000","0.3422","31024.52","82108.59"
"41.177.192.117","6610","244.3.160.239","80","67","45286","24","2473","43","42813","163.343853000","0.3419","57868.09","1001822.27"
"244.3.160.239","61380","94.2.202.197","80","12","3800","7","1698","5","2102","20.792943000","0.3411","39824.10","49299.33"
"41.177.199.139","6479","244.3.160.239","80","47","29130","17","1837","30","27293","98.620239000","0.3410","43094.25","640267.43"
"41.177.230.253","44001","244.3.31.40","22","43","8659","23","4310","20","4349","140.064114000","0.3410","101129.20","102044.29"
"244.3.160.239","62676","177.124.75.164","80","24","15404","11","2333","13","13071","214.167888000","0.3409","54752.89","306761.68"
"41.177.230.253","44068","244.3.31.40","22","43","8659","23","4310","20","4349","192.433252000","0.3407","101193.31","102108.98"
"244.3.47.24","3140","244.3.41.84","23","4","256","2","128","2","128","153.455103000","0.3407","3005.85","3005.85"
"244.3.56.90","3676","244.3.160.239","80","34","20651","13","1871","21","18780","15.665008000","0.3406","43942.11","441065.09"
"244.3.160.239","61751","188.68.214.181","80","12","1947","7","1173","5","774","68.501568000","0.3403","27576.56","18196.30"
"244.3.160.239","61928","40.248.176.156","80","11","2058","6","1329","5","729","99.614024000","0.3398","31289.45","17163.29"
"244.3.160.239","62317","81.67.210.26","80","19","8062","10","2310","9","5752","151.982172000","0.3394","54442.13","135563.26"
"168.117.3.145","8461","244.3.160.239","80","10","1973","5","1336","5","637","190.643813000","0.3390","31529.51","15033.16"
"41.177.199.139","2884","244.3.160.239","80","46","28491","17","1858","29","26633","96.843206000","0.3387","43889.85","629127.22"
"41.177.223.45","3599","244.3.160.239","80","14","5071","6","968","8","4103","1.581080000","0.3383","22890.52","97024.59"
"244.3.160.239","62479","40.248.176.156","80","13","3051","7","1580","6","1471","177.048910000","0.3381","37390.37","34810.90"
"77.197.106.167","16052","244.3.210.197","80","14","8919","7","853","7","8066","208.553726000","0.3380","20187.56","190894.30"
"244.3.160.239","62229","244.3.31.108","80","46","38400","18","2340","28","36060","133.181563000","0.3377","55441.86","854373.30"
"41.177.223.45","11276","244.3.160.239","80","15","5668","7","1028","8","4640","1.831419000","0.3376","24358.10","109943.16"
"41.177.230.253","44029","244.3.31.40","22","43","8643","23","4294","20","4349","155.847142000","0.3375","101786.72","103090.46"
"41.177.230.253","44026","244.3.31.40","22","43","8675","23","4310","20","4365","155.087481000","0.3372","102246.27","103551.04"
"168.117.3.145","6526","244.3.160.239","80","10","1959","5","1322","5","637","193.678093000","0.3372","31362.69","15111.98"
"18.132.77.186","9777","244.3.160.239","80","12","2015","6","1114","6","901","212.229628000","0.3370","26444.63","21388.34"
"41.177.230.253","44027","244.3.31.40","22","43","8643","23","4294","20","4349","155.468137000","0.3365","102081.93","103389.46"
"168.223.67.89","2666","244.3.210.197","80","9","3544","6","1274","3","2270","17.576799000","0.3362","30315.47","54015.79"
"244.3.41.252","50578","41.177.3.224","5666","16","3770","9","1904","7","1866","210.270628000","0.3358","45367.09","44461.65"
"90.218.72.197","15874","244.3.160.239","80","9","1422","4","855","5","567","11.709216000","0.3340","20480.21","13581.61"
"253.160.251.79","2863","253.37.253.43","446","85","107073","0","0","85","107073","208.064708000","0.3330","N/A","2572648.80"
"41.177.223.45","9788","244.3.160.239","80","16","5924","7","1041","9","4883","4.823606000","0.3329","25013.37","117329.75"
"244.3.160.239","62338","85.241.98.37","80","30","21520","13","1611","17","19909","154.846320000","0.3321","38812.03","479645.37"
"41.177.211.185","2329","244.3.160.239","80","12","2260","6","1501","6","759","197.632699000","0.3317","36204.99","18307.52"
"244.3.153.0","3556","41.177.24.241","993","26","4157","12","1294","14","2863","178.451451000","0.3316","31217.58","69069.50"
"41.177.176.156","10036","244.3.160.239","80","3","204","2","134","1","70","115.605005000","0.3311","3237.53","N/A"
"41.177.176.106","10006","244.3.160.239","80","12","3356","6","1245","6","2111","68.491533000","0.3307","30119.57","51070.21"
"244.3.160.239","61739","188.68.214.181","80","16","8927","8","1308","8","7619","67.046701000","0.3297","31739.48","184880.07"
"41.177.211.185","8569","244.3.160.239","80","12","2390","6","1494","6","896","202.513783000","0.3297","36254.00","21742.69"
"244.3.164.46","8797","244.3.160.239","80","12","2813","6","1124","6","1689","141.901551000","0.3294","27295.30","41015.80"
"41.177.176.156","4158","244.3.160.239","80","10","2225","5","1477","5","748","106.841929000","0.3294","35870.19","18165.81"
"244.3.164.46","11892","244.3.160.239","80","12","2935","6","1118","6","1817","141.901184000","0.3294","27151.66","44127.51"
"41.177.211.185","10644","244.3.160.239","80","12","2386","6","1490","6","896","202.404144000","0.3294","36189.31","21762.16"
"18.132.77.186","10177","244.3.160.239","80","19","10056","8","1241","11","8815","111.764064000","0.3293","30153.38","214183.75"
"18.132.77.186","6594","244.3.160.239","80","12","2357","6","1237","6","1120","50.727647000","0.3291","30073.09","27228.66"
"41.177.211.185","12365","244.3.160.239","80","12","2324","6","1500","6","824","201.865725000","0.3290","36469.29","20033.79"
"244.3.160.204","51541","244.3.160.239","80","7","448","4","256","3","192","170.224212000","0.3288","6228.86","4671.65"
"244.3.213.210","8214","244.3.160.239","443","22","8635","9","2174","13","6461","26.216624000","0.3288","52900.36","157216.77"
"244.3.181.123","6743","244.3.160.239","80","13","4936","6","1470","7","3466","2.137422000","0.3284","35810.31","84434.39"
"41.177.223.45","9116","244.3.160.239","80","16","6171","7","1021","9","5150","1.890196000","0.3282","24888.55","125539.71"
"244.3.160.204","51536","244.3.160.254","80","7","448","4","256","3","192","170.222882000","0.3276","6252.37","4689.27"
"41.177.223.45","13069","244.3.160.239","80","17","6794","8","1093","9","5701","1.921046000","0.3272","26720.78","139373.42"
"244.3.160.239","62186","94.2.202.203","80","11","2222","6","1219","5","1003","121.776682000","0.3272","29807.13","24525.48"
"244.3.160.239","61430","188.68.72.71","80","19","9369","9","1330","10","8039","29.418676000","0.3271","32524.60","196590.42"
"41.177.199.139","8080","244.3.160.239","80","12","1820","6","1144","6","676","98.176816000","0.3271","27977.76","16532.31"
"41.177.199.139","9036","244.3.160.239","80","12","2622","6","1151","6","1471","98.067296000","0.3267","28183.41","36018.94"
"244.3.153.117","49380","41.177.24.241","993","8","850","4","369","4","481","116.577748000","0.3262","9049.05","11795.65"
"41.177.199.139","4797","244.3.160.239","80","12","2761","6","1148","6","1613","98.397716000","0.3260","28171.78","39582.82"
"244.3.160.239","61771","188.68.214.108","80","11","2267","6","1374","5","893","74.910584000","0.3257","33743.98","21931.13"
"41.177.199.139","7066","244.3.160.239","80","12","2063","6","1147","6","916","98.288088000","0.3257","28176.63","22502.00"
"244.3.160.204","51535","244.3.160.254","443","7","448","4","256","3","192","170.222646000","0.3254","6294.45","4720.84"
"145.95.176.246","8546","244.3.160.239","80","12","4053","5","1321","7","2732","112.772962000","0.3253","32490.73","67195.06"
"41.177.176.156","2770","244.3.160.239","80","5","344","3","204","2","140","225.897157000","0.3248","5024.34","3448.07"
"244.3.160.239","61741","188.68.214.181","80","15","6482","8","1308","7","5174","67.118513000","0.3248","32215.96","127435.28"
"244.3.160.239","61270","128.71.90.164","80","15","6699","8","1354","7","5345","2.222274000","0.3247","33355.20","131671.73"
"244.3.181.123","7981","244.3.160.239","80","33","20006","13","1726","20","18280","109.575552000","0.3242","42590.60","451075.41"
"244.3.164.46","15908","244.3.160.239","80","12","1809","6","1127","6","682","144.141037000","0.3241","27820.12","16835.25"
"253.160.251.90","1736","253.37.253.43","446","46","50822","0","0","46","50822","183.342788000","0.3230","N/A","1258605.05"
"15.186.110.132","54150","41.177.26.91","80","22","12742","11","1185","11","11557","160.308355000","0.3230","29352.21","286264.53"
"244.3.160.248","48166","41.177.26.55","80","22","12109","10","983","12","11126","93.912089000","0.3230","24349.69","275599.84"
"244.3.160.204","51528","244.3.160.89","80","7","448","4","256","3","192","170.220827000","0.3226","6348.36","4761.27"
"242.13.197.91","35696","41.177.26.91","80","24","14399","12","1202","12","13197","133.551305000","0.3225","29820.01","327399.93"
"244.3.160.239","62413","41.177.254.197","80","56","43596","21","2397","35","41199","163.347678000","0.3222","59521.56","1023040.70"
"41.177.199.139","8518","244.3.160.239","80","12","2016","6","1150","6","866","97.851806000","0.3221","28565.22","21510.85"
"15.186.110.132","58659","41.177.26.91","80","24","14439","12","1255","12","13184","211.882115000","0.3219","31194.37","327702.40"
"41.177.199.139","3416","244.3.160.239","80","12","3117","6","1149","6","1968","99.222236000","0.3215","28591.25","48970.91"
"244.3.181.123","9629","244.3.160.239","80","13","3796","6","1272","7","2524","30.393650000","0.3213","31673.60","62849.19"
"41.177.211.185","5811","244.3.160.239","80","12","2325","6","1501","6","824","202.083410000","0.3211","37395.17","20528.73"
"253.160.251.79","2854","253.37.253.43","446","26","24289","0","0","26","24289","207.495939000","0.3204","N/A","606391.21"
"41.177.211.185","16236","244.3.160.239","80","12","2514","6","1507","6","1007","209.693209000","0.3204","37626.44","25142.55"
"244.3.41.252","50541","41.177.3.203","5666","16","3770","9","1904","7","1866","207.468292000","0.3196","47665.54","46714.23"
"244.3.181.123","2123","244.3.160.239","80","12","2470","6","1271","6","1199","110.365485000","0.3192","31855.04","30050.50"
"244.3.181.123","4166","244.3.160.239","80","12","2468","6","1272","6","1196","110.365250000","0.3192","31882.00","29977.10"
"41.177.211.185","4700","244.3.160.239","80","12","2667","6","1503","6","1164","209.694715000","0.3191","37684.64","29184.91"
"244.3.160.239","61812","43.106.84.231","80","13","1879","7","1104","6","775","78.648754000","0.3187","27715.28","19455.92"
"41.177.230.253","44020","244.3.31.40","22","50","15003","25","5504","25","9499","151.681295000","0.3183","138323.17","238723.07"
"244.3.160.239","61917","40.248.176.156","80","11","2092","6","1336","5","756","98.509947000","0.3180","33605.10","19016.06"
"41.177.176.106","2882","244.3.160.239","80","12","2004","6","1265","6","739","68.469391000","0.3180","31819.30","18588.51"
"244.3.160.239","61814","43.106.84.231","80","13","2003","7","1108","6","895","78.649919000","0.3180","27872.46","22514.31"
"244.3.160.239","61813","43.106.84.231","80","13","1831","7","1101","6","730","78.649610000","0.3179","27707.00","18370.67"
"253.37.253.43","2000","253.116.185.84","515","11","1744","11","1744","0","0","125.283768000","0.3178","43898.37","N/A"
"41.177.223.45","7036","244.3.160.239","80","16","5668","7","1032","9","4636","1.221237000","0.3178","25978.19","116700.49"
"168.117.3.145","7493","244.3.160.239","80","10","1991","5","1345","5","646","190.657990000","0.3177","33871.31","16268.30"
"244.3.160.239","61815","43.106.84.231","80","13","2446","7","1109","6","1337","78.650787000","0.3176","27937.15","33680.76"
"244.3.56.90","14638","244.3.160.239","80","84","61220","29","3125","55","58095","14.945186000","0.3171","78834.26","1465560.46"
"244.3.47.26","2047","244.3.41.84","23","4","256","2","128","2","128","153.482995000","0.3171","3229.55","3229.55"
"41.177.199.139","5073","244.3.160.239","80","12","2001","6","1275","6","726","139.006478000","0.3168","32196.87","18333.28"
"68.33.186.67","8051","244.3.160.239","80","16","7301","6","1311","10","5990","92.046534000","0.3165","33135.03","151395.00"
"15.186.110.132","50882","41.177.26.91","80","22","12364","11","1184","11","11180","123.247674000","0.3165","29926.48","282582.80"
"244.3.160.239","62065","188.68.72.71","80","11","2628","6","1158","5","1470","110.952186000","0.3162","29301.16","37195.77"
"145.95.176.246","11892","244.3.160.239","80","12","4040","5","1318","7","2722","111.611777000","0.3160","33364.55","68906.16"
"18.132.77.186","6142","244.3.160.239","80","16","6144","7","1220","9","4924","211.429716000","0.3160","30889.50","124672.04"
"41.177.168.181","8714","244.3.160.239","80","34","20446","12","1433","22","19013","76.802913000","0.3156","36322.62","481927.41"
"244.3.160.239","62036","188.68.193.91","80","12","3679","7","1486","5","2193","108.461397000","0.3154","37696.36","55631.31"
"41.177.230.253","44016","244.3.31.40","22","47","12071","24","5360","23","6711","151.121991000","0.3150","136133.47","170446.21"
"244.3.181.123","11649","244.3.160.239","80","12","2968","6","1285","6","1683","109.939536000","0.3149","32648.81","42761.05"
"244.3.160.239","62667","177.124.75.164","80","13","3358","7","2077","6","1281","213.276143000","0.3149","52773.33","32548.21"
"253.37.253.43","2000","253.77.108.145","515","11","1767","11","1767","0","0","125.301823000","0.3140","45019.97","N/A"
"244.3.160.239","61829","43.106.84.231","80","18","6721","9","1160","9","5561","79.112858000","0.3137","29582.97","141819.74"
"15.186.110.132","56945","41.177.26.91","80","22","13366","11","1195","11","12171","192.324919000","0.3136","30480.90","310446.09"
"244.3.153.0","3550","41.177.24.241","993","24","2944","11","1014","13","1930","175.262056000","0.3135","25873.12","49245.69"
"244.3.153.0","3566","41.177.24.241","993","24","2946","11","1016","13","1930","183.363063000","0.3135","25929.36","49255.58"
"41.177.230.253","44072","244.3.31.40","22","50","14747","25","5536","25","9211","194.465498000","0.3131","141471.70","235385.81"
"168.117.3.145","11072","244.3.160.239","80","13","4258","6","1408","7","2850","149.605857000","0.3130","35985.15","72839.26"
"41.177.82.121","2179","244.3.41.84","23","2","128","2","128","0","0","32.463572000","0.3128","3273.69","N/A"
"41.177.176.156","10708","244.3.160.239","80","10","2354","5","1467","5","887","103.813134000","0.3128","37524.70","22688.76"
"244.3.181.123","16275","244.3.160.239","80","15","6194","7","1284","8","4910","138.900981000","0.3127","32850.22","125618.82"
"253.160.251.90","1384","253.37.253.43","446","33","32558","0","0","33","32558","48.101548000","0.3120","N/A","834812.49"
"253.160.251.90","1426","253.37.253.43","446","25","22107","0","0","25","22107","60.647527000","0.3119","N/A","567027.89"
"168.117.3.145","5669","244.3.160.239","80","10","1977","5","1331","5","646","37.449380000","0.3116","34177.39","16587.97"
"244.3.160.239","61275","128.71.90.164","80","10","2000","6","1232","4","768","2.296944000","0.3113","31657.32","19734.43"
"244.3.160.204","31151","244.3.160.239","443","7","448","4","256","3","192","48.208444000","0.3111","6582.90","4937.18"
"168.117.3.145","3267","244.3.160.239","80","10","1977","5","1331","5","646","45.015660000","0.3110","34238.27","16617.52"
"244.3.160.239","61450","244.3.31.75","80","43","35710","17","1946","26","33764","31.626550000","0.3109","50076.72","868854.20"
"41.177.176.106","13174","244.3.160.239","80","12","1991","6","1253","6","738","68.484268000","0.3096","32376.32","19069.21"
"41.177.230.253","44071","244.3.31.40","22","47","12359","24","5392","23","6967","193.836551000","0.3096","139329.52","180027.58"
"77.194.20.202","38184","244.3.210.197","80","6","1491","4","1153","2","338","190.271007000","0.3092","29832.79","8745.43"
"244.3.164.46","13990","244.3.160.239","80","13","3600","6","1112","7","2488","140.137473000","0.3091","28779.40","64391.32"
"244.3.160.239","61976","198.123.241.156","80","14","5603","7","1107","7","4496","103.964998000","0.3088","28675.13","116461.98"
"68.33.110.176","10075","244.3.160.239","80","46","35129","13","1599","33","33530","121.227530000","0.3088","41430.91","868779.45"
"41.177.223.45","12797","244.3.160.239","80","15","4217","7","1058","8","3159","7.157473000","0.3087","27414.39","81854.49"
"41.177.223.45","9841","244.3.160.239","80","16","6214","7","1030","9","5184","1.221066000","0.3086","26700.54","134384.07"
"77.197.128.211","30833","41.177.26.15","80","7","1028","4","636","3","392","135.124932000","0.3086","16487.84","10162.32"
"244.3.160.239","61927","188.68.193.91","80","16","7549","8","1562","8","5987","99.501507000","0.3085","40501.34","155237.85"
"244.3.160.239","61418","244.3.31.75","80","13","3600","7","1069","6","2531","27.573763000","0.3082","27744.79","65689.50"
"18.132.77.186","15845","244.3.160.239","80","12","2307","6","1236","6","1071","50.147946000","0.3082","32081.19","27798.51"
"151.77.217.75","3675","244.3.160.239","80","14","2661","8","1490","6","1171","93.227974000","0.3082","38675.93","30395.65"
"15.186.110.142","40948","41.177.26.176","80","34","17953","16","1548","18","16405","64.425291000","0.3080","40201.79","426040.27"
"68.33.110.176","9899","244.3.160.239","80","44","35001","11","1471","33","33530","117.909688000","0.3080","38210.15","870962.82"
"41.177.135.193","11106","244.3.160.239","80","20","8918","9","2301","11","6617","151.977515000","0.3072","59918.17","172307.05"
"244.3.160.239","61894","188.68.193.91","80","16","7407","8","1556","8","5851","96.488915000","0.3069","40562.56","152526.69"
"41.177.211.185","16212","244.3.160.239","80","11","2182","5","1427","6","755","199.285473000","0.3067","37217.67","19691.20"
"18.132.77.186","8025","244.3.160.239","80","12","2030","6","1237","6","793","50.150063000","0.3066","32276.48","20691.39"
"244.3.160.239","61892","188.68.193.91","80","18","9492","9","1620","9","7872","96.043893000","0.3065","42285.64","205476.90"
"244.3.160.239","61981","198.123.241.156","80","19","9371","9","1234","10","8137","104.271939000","0.3065","32213.85","212418.26"
"177.202.57.176","34902","244.3.210.197","80","7","2311","4","465","3","1846","208.600028000","0.3064","12140.64","48197.02"
"244.3.160.239","61978","198.123.241.156","80","11","1763","6","1040","5","723","103.967475000","0.3064","27156.97","18879.32"
"41.177.211.185","4957","244.3.160.239","80","11","2267","5","1442","6","825","199.172189000","0.3063","37660.58","21546.45"
"244.3.160.239","61876","48.151.224.205","80","37","34404","12","2118","25","32286","90.627811000","0.3062","55331.50","843452.73"
"41.177.98.220","7010","244.3.185.141","1413","5","1724","2","1383","3","341","10.284372000","0.3051","36259.36","8940.31"
"244.3.213.252","11620","244.3.160.239","80","13","3616","6","1376","7","2240","20.790442000","0.3046","36139.08","58831.06"
"244.3.210.98","2803","122.136.142.116","80","58","48308","24","1624","34","46684","202.199626000","0.3046","42653.64","1226134.55"
"41.177.211.185","14730","244.3.160.239","80","11","2235","5","1434","6","801","197.843274000","0.3043","37702.36","21059.69"
"244.3.160.239","61898","188.68.193.91","80","13","4012","7","1500","6","2512","96.892050000","0.3042","39447.21","66060.93"
"244.3.160.239","61951","188.68.193.91","80","13","4358","7","1492","6","2866","102.061885000","0.3030","39387.54","75659.98"
"244.3.160.239","61903","188.68.193.91","80","13","3964","7","1482","6","2482","97.187047000","0.3026","39174.74","65608.44"
"194.66.204.4","4405","244.3.41.84","23","5","320","2","128","3","192","153.455910000","0.3024","3386.30","5079.45"
"244.3.160.204","31153","244.3.160.239","80","7","448","4","256","3","192","48.209103000","0.3024","6773.43","5080.07"
"18.132.77.186","10588","244.3.160.239","80","13","4422","6","1114","7","3308","211.922485000","0.3021","29496.16","87588.25"
"47.3.161.224","1122","244.3.41.84","23","5","320","2","128","3","192","32.448671000","0.3018","3393.32","5089.99"
"244.3.160.239","61454","177.124.75.164","80","13","3112","7","2182","6","930","32.553364000","0.3014","57920.43","24686.52"
"41.177.223.45","7208","244.3.160.239","80","15","5289","7","1017","8","4272","1.580653000","0.3011","27022.72","113511.36"
"41.177.223.45","3991","244.3.160.239","80","15","4399","7","1058","8","3341","6.884294000","0.3006","28157.30","88916.39"
"184.75.224.164","1279","244.3.41.84","23","3","192","1","64","2","128","32.450170000","0.3006","N/A","3406.69"
"244.3.160.204","31149","244.3.160.254","4000","7","448","4","256","3","192","48.207781000","0.3002","6822.14","5116.61"
"41.177.223.45","14683","244.3.160.239","80","15","5344","7","1020","8","4324","1.540359000","0.2999","27211.43","115355.12"
"41.177.211.185","7041","244.3.160.239","80","12","4176","5","1392","7","2784","158.375181000","0.2997","37157.03","74314.07"
"244.176.48.13","6833","244.3.160.239","80","10","1686","5","700","5","986","122.869111000","0.2991","18723.52","26373.42"
"168.117.3.145","10436","244.3.160.239","80","10","1977","5","1331","5","646","194.256700000","0.2991","35603.94","17280.35"
"244.3.160.204","31146","244.3.160.254","80","7","448","4","256","3","192","48.206814000","0.2989","6852.20","5139.15"
"168.117.3.145","15586","244.3.160.239","80","12","2103","6","1402","6","701","41.613377000","0.2987","37552.27","18776.14"
"244.3.164.46","15615","244.3.160.239","80","31","21541","12","1529","19","20012","154.844527000","0.2987","40954.90","536029.73"
"244.3.160.204","31145","244.3.160.254","443","7","448","4","256","3","192","48.206474000","0.2987","6857.25","5142.94"
"168.117.3.145","15345","244.3.160.239","80","10","1991","5","1345","5","646","191.190846000","0.2986","36034.59","17307.32"
"168.117.3.145","15939","244.3.160.239","80","10","1991","5","1345","5","646","41.627344000","0.2986","36038.81","17309.35"
"168.117.3.145","12623","244.3.160.239","80","10","1991","5","1345","5","646","33.965451000","0.2985","36049.20","17314.33"
"253.160.251.90","1420","253.37.253.43","446","15","14429","0","0","15","14429","58.164426000","0.2984","N/A","386881.84"
"194.66.220.177","1679","244.3.41.84","23","5","320","2","128","3","192","153.460733000","0.2978","3438.26","5157.39"
"184.4.145.199","3649","244.3.41.84","23","5","320","2","128","3","192","32.451677000","0.2977","3439.66","5159.49"
"41.177.199.139","12349","244.3.160.239","80","12","2131","6","1151","6","980","97.986585000","0.2972","30981.46","26378.65"
"41.177.211.185","14896","244.3.160.239","80","11","2887","5","1252","6","1635","196.450112000","0.2972","33704.39","44014.91"
"244.3.181.123","15869","244.3.160.239","80","12","2796","6","1272","6","1524","109.448630000","0.2968","34287.10","41079.83"
"41.177.223.45","10240","244.3.160.239","80","14","4986","6","958","8","4028","1.217598000","0.2966","25836.29","108631.09"
"244.3.160.239","62442","94.2.202.197","80","14","5747","8","1439","6","4308","166.384108000","0.2966","38809.42","116185.54"
"41.177.98.220","7080","41.177.75.223","1351","3","318","1","129","2","189","32.500095000","0.2966","N/A","5098.43"
"224.143.111.145","1216","244.3.41.84","23","5","320","2","128","3","192","32.453681000","0.2964","3454.22","5181.33"
"41.177.132.22","4530","244.3.160.239","80","12","3953","5","1225","7","2728","212.718244000","0.2962","33083.30","73674.47"
"244.3.181.123","3631","244.3.160.239","80","12","2009","6","1270","6","739","30.718870000","0.2960","34322.93","19972.16"
"244.3.160.239","61295","128.71.90.164","80","10","2341","6","1224","4","1117","4.875777000","0.2959","33090.02","30197.35"
"68.33.110.176","16288","244.3.160.239","80","45","35225","12","1695","33","33530","106.765757000","0.2958","45836.36","906721.65"
"41.177.211.185","5139","244.3.160.239","80","12","3464","6","1489","6","1975","203.454360000","0.2957","40280.94","53428.38"
"244.3.160.239","61498","41.43.180.128","80","13","3394","7","1955","6","1439","40.322968000","0.2956","52902.54","38939.51"
"244.3.160.239","61266","128.71.90.164","80","15","7031","8","1360","7","5671","2.139021000","0.2955","36819.32","153531.17"
"122.155.141.12","9248","244.3.160.239","80","48","40159","18","2157","30","38002","160.340427000","0.2954","58419.47","1029233.43"
"244.3.153.55","2859","41.177.24.241","443","21","6445","10","2354","11","4091","106.603900000","0.2953","63773.73","110831.92"
"194.66.220.4","3840","244.3.41.84","23","5","320","2","128","3","192","32.455112000","0.2951","3469.52","5204.27"
"244.3.153.117","49376","41.177.24.241","993","7","827","4","367","3","460","116.577922000","0.2949","9957.40","12480.67"
"168.117.3.145","15165","244.3.160.239","80","10","1991","5","1345","5","646","34.474927000","0.2948","36505.39","17533.44"
"18.132.77.186","12977","244.3.160.239","80","12","2346","6","1114","6","1232","211.090511000","0.2947","30245.23","33448.95"
"244.3.153.0","3548","41.177.24.241","993","24","2954","11","1024","13","1930","174.710967000","0.2946","27811.63","52418.41"
"244.3.160.239","62350","244.3.31.75","80","13","4035","7","1438","6","2597","158.377517000","0.2944","39072.90","70564.90"
"168.91.64.164","63574","244.3.210.98","80","16","12709","6","435","10","12274","24.192816000","0.2942","11828.21","333745.73"
"244.176.48.13","7801","244.3.160.239","80","10","1694","5","704","5","990","121.428408000","0.2942","19144.22","26921.56"
"68.33.110.176","10979","244.3.160.239","80","46","35129","13","1599","33","33530","114.297546000","0.2941","43490.97","911977.70"
"203.22.116.244","1158","244.3.41.84","23","5","320","2","128","3","192","153.463288000","0.2941","3482.00","5223.00"
"68.33.110.176","2077","244.3.160.239","80","46","35289","13","1759","33","33530","107.107607000","0.2941","47853.37","912179.28"
"41.177.132.22","6530","244.3.160.239","80","12","3940","5","1222","7","2718","211.956383000","0.2940","33254.30","73964.97"
"244.3.160.239","62681","246.220.26.95","80","16","6844","8","1639","8","5205","215.087946000","0.2939","44610.78","141671.20"
"244.3.181.123","7932","244.3.160.239","80","12","1974","6","1269","6","705","108.137461000","0.2938","34551.18","19195.10"
"244.3.181.123","10696","244.3.160.239","80","12","2008","6","1308","6","700","108.137949000","0.2936","35642.75","19074.87"
"244.3.181.123","3453","244.3.160.239","80","12","2641","6","1266","6","1375","108.999456000","0.2927","34596.43","37575.11"
"194.66.204.151","1237","244.3.41.84","23","5","320","2","128","3","192","153.465167000","0.2927","3498.51","5247.77"
"41.177.176.156","4955","244.3.160.239","80","13","3961","6","1529","7","2432","97.160689000","0.2927","41796.80","66481.24"
"41.177.223.45","6723","244.3.160.239","80","15","4350","7","1058","8","3292","6.090012000","0.2925","28934.38","90030.22"
"244.3.106.12","2297","244.3.41.84","23","3","192","1","64","2","128","153.466048000","0.2924","N/A","3502.24"
"244.3.160.239","62073","188.68.72.71","80","11","1882","6","1146","5","736","111.428113000","0.2923","31361.50","20141.41"
"244.3.160.239","62101","244.3.31.75","80","13","3904","7","1363","6","2541","112.778383000","0.2922","37319.33","69573.31"
"41.177.211.185","2599","244.3.160.239","80","11","2805","5","1440","6","1365","198.147895000","0.2921","39436.25","37382.28"
"68.33.110.176","10778","244.3.160.239","80","52","37973","17","2054","35","35919","71.093533000","0.2919","56285.35","984281.07"
"194.66.204.46","1451","244.3.41.84","23","5","362","2","146","3","216","153.466418000","0.2917","4004.07","5923.83"
"186.181.192.154","1270","244.3.41.84","23","5","320","2","128","3","192","32.458179000","0.2916","3511.18","5266.77"
"244.3.181.123","13483","244.3.160.239","80","12","2016","6","1265","6","751","29.023492000","0.2916","34708.77","20605.76"
"244.3.160.239","61296","128.71.90.164","80","10","1967","6","1229","4","738","4.880280000","0.2915","33733.73","20256.71"
"168.117.3.145","2739","244.3.160.239","80","10","1959","5","1322","5","637","37.439514000","0.2914","36297.12","17489.61"
"41.177.98.220","7030","41.177.92.145","1897","14","2885","7","1874","7","1011","88.893149000","0.2911","51494.66","27780.74"
"168.117.3.145","12791","244.3.160.239","80","12","2101","6","1400","6","701","33.955692000","0.2911","38477.79","19266.38"
"168.117.3.145","13986","244.3.160.239","80","10","1959","5","1322","5","637","44.997283000","0.2910","36339.65","17510.10"
"41.177.211.185","12225","244.3.160.239","80","11","2581","5","1445","6","1136","200.433056000","0.2906","39780.18","31273.55"
"145.95.176.246","14346","244.3.160.239","80","10","3194","5","1415","5","1779","113.194312000","0.2902","39011.48","49046.94"
"244.3.160.239","61340","48.151.224.205","80","39","29235","16","1617","23","27618","11.456831000","0.2901","44595.82","761686.75"
"41.177.124.47","8205","244.3.160.239","80","12","2422","6","1706","6","716","25.905366000","0.2901","47052.82","19747.84"
"41.177.223.45","9787","244.3.160.239","80","14","4109","6","994","8","3115","4.665386000","0.2900","27420.41","85930.15"
"244.176.48.13","3437","244.3.160.239","80","10","1543","5","670","5","873","121.094285000","0.2900","18482.95","24083.01"
"244.3.160.239","61386","198.123.241.156","80","14","2547","7","1975","7","572","23.173634000","0.2900","54485.95","15780.24"
"168.117.3.145","10477","244.3.160.239","80","10","1991","5","1345","5","646","42.089866000","0.2898","37128.54","17832.74"
"41.177.223.45","15017","244.3.160.239","80","14","4384","6","994","8","3390","5.354421000","0.2898","27443.50","93595.02"
"244.3.160.239","61873","122.248.218.117","80","13","4564","7","1544","6","3020","90.085078000","0.2897","42631.32","83385.10"
"244.3.160.239","61783","244.3.31.75","80","43","35861","17","2097","26","33764","77.204297000","0.2896","57925.58","932665.32"
"94.145.155.254","3499","244.3.41.84","23","5","320","2","128","3","192","32.459996000","0.2896","3536.30","5304.45"
"41.177.211.185","9954","244.3.160.239","80","11","2751","5","1445","6","1306","200.600090000","0.2892","39966.26","36121.75"
"18.132.77.186","11123","244.3.160.239","80","12","2557","6","1237","6","1320","51.267082000","0.2892","34224.10","36520.46"
"41.177.34.163","45737","41.177.98.176","80","24","9705","13","3174","11","6531","233.110447000","0.2891","87841.53","180747.65"
"244.3.160.239","61834","188.68.214.108","80","11","2011","6","1312","5","699","80.722668000","0.2889","36333.43","19357.52"
"41.177.211.185","11935","244.3.160.239","80","13","4559","6","1321","7","3238","196.158543000","0.2889","36586.34","89679.45"
"41.177.199.139","2748","244.3.160.239","80","46","29171","17","2174","29","26997","69.107020000","0.2888","60216.60","747777.19"
"244.176.48.13","10047","244.3.160.239","80","10","1551","5","674","5","877","122.372311000","0.2888","18671.01","24294.47"
"41.177.168.181","6366","244.3.160.239","80","12","1826","6","945","6","881","78.646579000","0.2887","26184.90","24411.53"
"244.176.48.13","13602","244.3.160.239","80","10","1702","5","708","5","994","122.662409000","0.2886","19625.85","27553.80"
"41.177.168.181","11681","244.3.160.239","80","12","1701","6","941","6","760","78.645965000","0.2886","26085.18","21067.73"
"18.132.77.186","11006","244.3.160.239","80","12","1988","6","1237","6","751","51.268256000","0.2885","34301.32","20824.81"
"18.132.77.186","3578","244.3.160.239","80","12","2192","6","1237","6","955","52.277302000","0.2885","34302.99","26482.90"
"244.3.160.239","61376","41.43.180.128","80","17","4966","9","2741","8","2225","19.800445000","0.2884","76028.01","61715.55"
"41.177.168.181","15014","244.3.160.239","80","12","1654","6","938","6","716","78.646552000","0.2884","26020.77","19862.34"
"18.132.77.186","2674","244.3.160.239","80","12","1981","6","1237","6","744","51.268913000","0.2882","34332.98","20649.75"
"18.132.77.186","7793","244.3.160.239","80","12","2024","6","1237","6","787","50.437430000","0.2881","34352.52","21855.65"
"68.33.110.176","11305","244.3.160.239","80","45","35065","12","1535","33","33530","110.413643000","0.2880","42634.30","931288.65"
"41.177.230.253","44005","244.3.31.40","22","50","16213","26","6202","24","10011","142.841313000","0.2880","172306.50","278129.69"
"18.132.77.186","11538","244.3.160.239","80","12","2144","6","1237","6","907","50.437984000","0.2879","34373.05","25203.20"
"244.3.160.239","61279","85.241.98.37","80","12","3521","7","1526","5","1995","2.553415000","0.2876","42449.62","55496.06"
"203.22.57.0","1203","244.3.41.84","23","5","320","2","128","3","192","153.469740000","0.2874","3562.42","5343.63"
"41.177.168.181","13567","244.3.160.239","80","12","2267","6","946","6","1321","78.648198000","0.2874","26329.34","36766.45"
"194.66.164.108","2267","244.3.41.84","23","5","320","2","128","3","192","32.462370000","0.2873","3564.68","5347.02"
"168.117.3.145","10684","244.3.160.239","80","10","1977","5","1331","5","646","37.966325000","0.2871","37093.03","18003.08"
"244.3.160.239","61962","198.123.241.156","80","14","5843","7","1108","7","4735","103.189904000","0.2871","30878.78","131959.39"
"151.77.217.75","5274","244.3.160.239","80","24","10156","12","1799","12","8357","104.252736000","0.2867","50202.32","233207.76"
"90.218.193.20","10215","244.3.160.239","80","46","39592","16","1938","30","37654","105.262872000","0.2867","54084.22","1050819.08"
"194.66.143.80","1222","244.3.41.84","23","5","320","2","128","3","192","153.470983000","0.2866","3573.27","5359.91"
"41.177.3.203","58761","41.177.230.224","25","40","18919","21","17286","19","1633","1.036590000","0.2864","482882.88","45617.71"
"41.177.211.185","7506","244.3.160.239","80","11","2569","5","1437","6","1132","198.605399000","0.2863","40149.76","31628.06"
"18.132.77.186","15291","244.3.160.239","80","12","2557","6","1237","6","1320","51.539161000","0.2863","34566.11","36885.42"
"168.117.3.145","12509","244.3.160.239","80","10","1977","5","1331","5","646","45.522386000","0.2862","37200.46","18055.22"
"244.3.160.239","62714","41.43.180.128","80","11","3203","6","1832","5","1371","220.640564000","0.2859","51259.99","38361.05"
"244.3.160.239","61483","177.124.75.164","80","60","48976","23","3251","37","45725","38.534639000","0.2859","90971.42","1279504.15"
"145.95.31.210","12928","244.3.160.239","80","13","3980","6","1248","7","2732","87.453587000","0.2857","34942.45","76492.60"
"244.3.160.239","61407","197.154.128.197","80","10","2273","6","1596","4","677","25.911051000","0.2856","44711.67","18966.04"
"244.3.160.239","62103","188.68.193.91","80","10","2480","6","1445","4","1035","112.992668000","0.2855","40484.13","28997.28"
"244.3.213.210","13316","244.3.160.239","80","12","4217","5","1489","7","2728","26.660535000","0.2855","41719.35","76434.10"
"16.176.93.164","8062","244.3.160.239","80","8","3292","3","1263","5","2029","234.048662000","0.2852","35430.13","56918.24"
"244.3.160.239","61575","177.124.75.164","80","13","3133","7","2366","6","767","49.889885000","0.2850","66425.22","21533.45"
"41.177.71.0","1893","253.37.253.43","623","3","238","0","0","3","238","121.196523000","0.2849","N/A","6682.11"
"244.3.160.239","62653","244.3.31.75","80","13","3782","7","1251","6","2531","211.961486000","0.2847","35147.36","71109.49"
"244.3.160.239","62055","188.68.72.71","80","11","2616","6","1154","5","1462","110.152661000","0.2847","32423.93","41077.80"
"41.177.199.139","12169","244.3.160.239","80","47","29235","18","2238","29","26997","64.609145000","0.2847","62889.68","758638.37"
"244.3.160.239","62076","244.3.31.75","80","13","3891","7","1360","6","2531","111.616988000","0.2847","38219.42","71127.47"
"244.3.160.239","61762","177.124.75.164","80","13","3111","7","2054","6","1057","71.440083000","0.2845","57748.54","29717.72"
"244.3.160.239","62665","244.3.31.75","80","13","3795","7","1254","6","2541","212.723755000","0.2845","35265.95","71459.96"
"41.177.132.22","8598","244.3.160.239","80","11","3141","5","1314","6","1827","212.294496000","0.2844","36965.01","51396.56"
"244.3.160.239","62249","188.68.72.71","80","11","1882","6","1146","5","736","135.333799000","0.2844","32241.62","20706.66"
"244.3.160.239","62359","244.3.31.75","80","43","35875","17","2111","26","33764","159.825851000","0.2842","59419.81","950379.11"
"41.177.199.139","11474","244.3.160.239","80","11","1976","5","1218","6","758","111.981286000","0.2840","34312.64","21353.84"
"41.177.168.181","15187","244.3.160.239","80","16","6453","7","908","9","5545","79.110671000","0.2839","25583.23","156232.39"
"68.33.110.176","8529","244.3.160.239","80","46","35129","13","1599","33","33530","114.009624000","0.2837","45086.71","945439.17"
"94.145.155.118","1857","244.3.41.84","23","5","320","2","128","3","192","32.465373000","0.2837","3609.93","5414.90"
"41.177.211.185","4527","244.3.160.239","80","11","2576","5","1446","6","1130","200.889801000","0.2836","40787.69","31874.20"
"244.3.160.239","61843","198.123.241.156","80","11","1937","6","1493","5","444","82.612366000","0.2834","42147.46","12534.14"
"244.3.160.239","62054","188.68.72.71","80","11","2664","6","1154","5","1510","110.152342000","0.2833","32589.20","42642.72"
"186.136.103.68","5021","244.3.160.239","80","16","6217","8","1403","8","4814","78.928178000","0.2831","39640.47","136015.12"
"244.3.160.239","62312","122.248.218.117","80","14","5920","7","1592","7","4328","150.016404000","0.2830","45008.15","122358.83"
"41.177.223.45","5129","244.3.160.239","80","12","1940","6","917","6","1023","12.101978000","0.2829","25929.87","28927.21"
"244.3.153.142","57213","244.3.31.24","1522","2","132","1","64","1","68","100.240662000","0.2829","N/A","N/A"
"41.177.211.185","2103","244.3.160.239","80","11","2403","5","1435","6","968","199.002814000","0.2823","40659.04","27427.15"
"145.95.176.246","6488","244.3.160.239","80","61","39005","24","2554","37","36451","113.650319000","0.2823","72366.65","1032825.67"
"244.3.160.239","61395","117.246.95.43","80","14","3686","8","2893","6","793","24.792639000","0.2822","82008.40","22479.32"
"244.3.160.239","62351","244.3.31.75","80","13","3886","7","1345","6","2541","158.404056000","0.2822","38132.09","72039.89"
"244.3.160.239","62190","40.248.176.156","80","14","6369","7","1493","7","4876","121.925140000","0.2821","42334.04","138259.07"
"151.77.12.31","57706","41.177.98.176","80","69","47472","33","4223","36","43249","226.087684000","0.2821","119777.63","1226678.39"
"151.77.108.208","5240","244.3.160.239","80","14","4270","7","1472","7","2798","186.616105000","0.2820","41757.09","79372.51"
"68.33.110.176","12613","244.3.160.239","80","15","5843","7","1392","8","4451","166.369615000","0.2818","39512.62","126343.88"
"41.177.223.45","3941","244.3.160.239","80","15","4272","7","1058","8","3214","7.622500000","0.2818","30033.46","91235.86"
"41.177.211.185","6921","244.3.160.239","80","11","2202","5","1443","6","759","199.592613000","0.2817","40980.93","21555.46"
"244.3.160.239","61859","244.3.31.75","80","13","3751","7","1210","6","2541","87.455972000","0.2817","34367.80","72172.38"
"41.177.211.185","3896","244.3.160.239","80","11","2494","5","1444","6","1050","200.724045000","0.2816","41015.88","29824.57"
"68.33.110.176","15096","244.3.160.239","80","46","35129","13","1599","33","33530","117.623989000","0.2814","45460.36","953274.48"
"41.177.211.185","7130","244.3.160.239","80","11","2454","5","1436","6","1018","198.721225000","0.2813","40837.07","28949.96"
"41.177.211.185","10650","244.3.160.239","80","11","2241","5","1440","6","801","200.038421000","0.2813","40958.98","22783.43"
"184.75.224.75","1326","244.3.41.84","23","3","192","1","64","2","128","32.469623000","0.2810","N/A","3644.05"
"41.177.199.139","2843","244.3.160.239","80","12","1906","6","1148","6","758","99.607238000","0.2809","32693.40","21586.75"
"41.177.223.45","11032","244.3.160.239","80","15","4368","7","1058","8","3310","7.418831000","0.2809","30132.36","94270.44"
"244.3.160.239","62115","85.224.40.142","80","13","5114","7","872","6","4242","114.067521000","0.2809","24838.17","120829.74"
"244.3.160.239","61947","244.3.31.75","80","13","3975","7","1434","6","2541","101.853677000","0.2808","40854.26","72392.39"
"244.3.160.239","61188","128.71.90.164","80","11","5377","5","320","6","5057","1.128340000","0.2807","9119.02","144108.97"
"244.3.160.239","61581","177.124.75.164","80","13","3166","7","2367","6","799","50.255784000","0.2807","67464.01","22773.02"
"244.3.160.239","61412","244.3.31.75","80","13","4048","7","1507","6","2541","26.664594000","0.2807","42955.74","72429.02"
"244.3.160.239","62335","85.241.98.37","80","17","7492","9","1352","8","6140","154.698382000","0.2806","38549.27","175068.43"
"41.177.211.185","14852","244.3.160.239","80","11","2561","5","1440","6","1121","198.440408000","0.2806","41058.54","31962.93"
"244.3.160.239","62106","188.68.193.91","80","10","2686","6","1440","4","1246","113.237743000","0.2806","41062.20","35530.21"
"41.177.211.185","9199","244.3.160.239","80","11","2261","5","1436","6","825","201.284884000","0.2805","40956.60","23530.08"
"41.177.223.45","10906","244.3.160.239","80","15","4174","7","1058","8","3116","7.439832000","0.2804","30182.54","88893.01"
"244.3.153.142","55558","41.177.4.98","1526","2","132","1","64","1","68","68.695255000","0.2803","N/A","N/A"
"68.33.110.176","2664","244.3.160.239","80","44","33715","11","1670","33","32045","73.459439000","0.2803","47663.39","914594.77"
"41.177.211.185","6935","244.3.160.239","80","11","2273","5","1448","6","825","201.004236000","0.2803","41331.57","23548.72"
"151.77.217.75","5428","244.3.160.239","80","18","6270","9","1590","9","4680","103.959644000","0.2802","45390.64","133602.63"
"41.177.211.185","2469","244.3.160.239","80","12","2329","6","1506","6","823","202.843651000","0.2802","43004.92","23501.36"
"41.177.223.45","15187","244.3.160.239","80","15","4581","7","1058","8","3523","4.822782000","0.2802","30212.28","100602.89"
"41.177.211.185","2588","244.3.160.239","80","11","2263","5","1437","6","826","201.450405000","0.2801","41040.29","23590.31"
"41.177.211.185","2139","244.3.160.239","80","11","2577","5","1447","6","1130","199.873533000","0.2801","41329.28","32275.11"
"68.33.110.176","9940","244.3.160.239","80","46","36343","12","1734","34","34609","70.803496000","0.2801","49533.66","988644.97"
"41.177.211.185","8329","244.3.160.239","80","11","2519","5","1437","6","1082","198.891918000","0.2800","41063.74","30919.25"
"244.3.160.239","61377","41.43.180.128","80","11","2498","6","1510","5","988","20.338846000","0.2799","43151.80","28234.42"
"68.33.110.176","15674","244.3.160.239","80","46","35129","13","1599","33","33530","110.711810000","0.2798","45721.64","958753.31"
"41.177.211.185","14789","244.3.160.239","80","11","2624","5","1444","6","1180","200.153997000","0.2797","41300.36","33749.60"
"244.3.160.239","61520","117.246.95.43","80","76","68670","28","2544","48","66126","45.446287000","0.2796","72777.73","1891705.94"
"41.177.211.185","4889","244.3.160.239","80","11","2620","5","1445","6","1175","200.320083000","0.2796","41343.45","33618.37"
"41.177.211.185","13352","244.3.160.239","80","11","2237","5","1443","6","794","199.758800000","0.2795","41306.32","22728.49"
"244.3.160.239","61434","244.3.31.75","80","13","3738","7","1197","6","2541","29.858228000","0.2795","34266.82","72741.85"
"41.177.211.185","13098","244.3.160.239","80","11","2271","5","1447","6","824","199.479085000","0.2795","41423.78","23588.94"
"41.177.211.185","10278","244.3.160.239","80","11","2809","5","1443","6","1366","198.326098000","0.2790","41378.57","39170.56"
"41.177.230.253","44006","244.3.31.40","22","56","21213","28","6410","28","14803","143.441963000","0.2789","183881.67","424649.04"
"41.177.230.253","44058","244.3.31.40","22","67","31955","32","7098","35","24857","171.193070000","0.2787","203716.73","713410.35"
"41.177.199.139","3354","244.3.160.239","80","13","4424","6","1436","7","2988","56.375569000","0.2787","41215.81","85761.03"
"194.66.143.56","1130","244.3.41.84","23","5","320","2","128","3","192","32.470565000","0.2786","3675.16","5512.75"
"41.177.132.22","14573","244.3.160.239","80","11","3152","5","1319","6","1833","213.048087000","0.2786","37877.54","52638.00"
"244.3.160.239","62066","188.68.72.71","80","11","2425","6","1159","5","1266","110.990146000","0.2785","33290.49","36363.90"
"244.3.160.239","62087","40.248.176.156","80","11","2211","6","1483","5","728","112.051136000","0.2782","42647.57","20935.56"
"244.3.160.239","61086","128.71.90.164","80","11","6197","5","320","6","5877","1.130835000","0.2781","9204.76","169051.15"
"151.77.217.75","11366","244.3.160.239","80","15","2400","8","1517","7","883","103.962895000","0.2778","43690.82","25431.11"
"41.177.223.45","8586","244.3.160.239","80","15","4536","7","1058","8","3478","6.319426000","0.2774","30506.73","100285.82"
"194.66.204.159","1405","244.3.41.84","23","5","320","2","128","3","192","153.480308000","0.2774","3691.74","5537.61"
"244.3.160.239","61718","122.248.218.117","80","14","5921","7","1592","7","4329","60.161129000","0.2773","45935.22","124908.03"
"94.145.155.113","2723","244.3.41.84","23","5","320","2","128","3","192","153.479617000","0.2772","3694.23","5541.35"
"244.3.160.239","61986","198.123.241.156","80","11","1792","6","1032","5","760","104.507469000","0.2771","29794.41","21941.62"
"244.3.160.239","62088","40.248.176.156","80","13","3110","7","1540","6","1570","112.052723000","0.2770","44471.40","45337.72"
"41.177.223.45","8727","244.3.160.239","80","15","4404","7","1058","8","3346","7.345530000","0.2769","30565.34","96665.04"
"253.160.251.79","2906","253.37.253.43","446","22","17000","0","0","22","17000","225.144480000","0.2769","N/A","491143.17"
"244.3.181.123","14787","244.3.160.239","80","18","8929","8","1405","10","7524","109.695288000","0.2768","40604.74","217444.86"
"244.3.160.239","61402","177.124.75.164","80","13","2962","7","2188","6","774","25.298825000","0.2766","63277.91","22384.42"
"244.3.160.239","61084","128.71.90.164","80","10","4978","5","320","5","4658","1.122992000","0.2766","9254.64","134712.85"
"244.3.160.239","61122","128.71.90.164","80","11","5700","5","320","6","5380","1.132612000","0.2765","9260.06","155684.81"
"244.3.164.46","10676","244.3.160.239","80","12","2542","6","1117","6","1425","140.565060000","0.2763","32339.55","41256.81"
"244.3.160.239","62503","244.3.31.75","80","13","3861","7","1320","6","2541","186.619480000","0.2763","38224.58","73582.32"
"41.177.211.185","14951","244.3.160.239","80","11","2178","5","1429","6","749","201.173730000","0.2763","41382.21","21690.18"
"244.3.153.0","3549","41.177.24.241","993","26","3757","12","1289","14","2468","174.984380000","0.2762","37337.70","71489.09"
"41.177.199.139","8801","244.3.160.239","80","12","2756","6","1315","6","1441","177.046626000","0.2762","38095.24","41745.43"
"194.66.13.193","1933","244.3.41.84","23","5","362","2","146","3","216","153.480874000","0.2761","4229.97","6258.04"
"145.95.176.246","2370","244.3.160.239","80","10","3183","5","1410","5","1773","112.084231000","0.2761","40859.05","51378.09"
"244.3.160.239","61362","177.124.75.164","80","15","4533","8","2521","7","2012","16.270069000","0.2758","73123.07","58359.23"
"244.3.160.239","61403","177.124.75.164","80","13","2883","7","2185","6","698","25.300092000","0.2758","63389.14","20249.71"
"68.33.110.176","4639","244.3.160.239","80","46","34835","13","1599","33","33236","121.536289000","0.2756","46417.45","964809.53"
"244.3.181.123","6470","244.3.160.239","80","13","4428","6","1263","7","3165","108.357385000","0.2755","36669.41","91891.28"
"244.3.181.123","13721","244.3.160.239","80","12","2535","6","1283","6","1252","108.358565000","0.2753","37281.88","36381.07"
"244.3.160.239","61923","40.248.176.156","80","11","2090","6","1334","5","756","99.223603000","0.2752","38783.58","21979.30"
"41.177.211.185","16087","244.3.160.239","80","12","2329","6","1505","6","824","202.733879000","0.2751","43762.72","23960.45"
"244.3.160.239","62075","40.248.176.156","80","13","2870","7","1549","6","1321","111.517459000","0.2750","45054.94","38423.22"
"244.3.160.239","62757","41.43.180.128","80","13","3357","7","1976","6","1381","227.601599000","0.2750","57493.25","40181.27"
"41.177.98.252","3535","244.3.160.239","80","12","2030","6","1203","6","827","32.550291000","0.2748","35026.93","24079.20"
"41.177.223.45","4225","244.3.160.239","80","15","4386","7","1058","8","3328","5.838095000","0.2747","30816.62","96935.45"
"41.177.223.45","7846","244.3.160.239","80","15","4367","7","1058","8","3309","4.564090000","0.2743","30859.43","96515.92"
"41.177.211.185","3910","244.3.160.239","80","10","2414","5","1341","5","1073","192.296922000","0.2741","39141.71","31319.21"
"244.3.160.239","62165","188.68.193.91","80","10","2614","6","1441","4","1173","118.111836000","0.2740","42075.91","34250.55"
"244.3.160.239","61360","177.124.75.164","80","22","14161","10","2649","12","11512","15.982595000","0.2738","77386.00","336303.35"
"244.3.181.123","5770","244.3.160.239","80","12","2578","6","1267","6","1311","109.172164000","0.2737","37032.84","38318.91"
"244.3.164.46","5136","244.3.160.239","80","12","2272","6","1125","6","1147","142.830446000","0.2737","32885.48","33528.58"
"244.3.160.239","62659","244.3.31.75","80","11","3040","6","1279","5","1761","212.299602000","0.2736","37399.30","51493.49"
"244.3.160.239","62077","188.68.72.71","80","11","2549","6","1160","5","1389","111.641461000","0.2734","33939.84","40640.03"
"244.3.160.239","62683","246.220.26.95","80","15","5798","8","1553","7","4245","215.324636000","0.2732","45478.01","124310.45"
"41.177.223.45","10873","244.3.160.239","80","15","4261","7","1058","8","3203","6.803442000","0.2731","30990.49","93820.94"
"244.3.41.84","2653","244.3.31.67","1592","7","3033","4","1619","3","1414","126.460232000","0.2731","47423.25","41418.45"
"41.177.223.45","9338","244.3.160.239","80","15","4613","7","1058","8","3555","5.274522000","0.2731","30992.31","104137.68"
"244.3.160.239","61618","244.3.31.75","80","13","4219","7","1418","6","2801","56.377765000","0.2729","41561.33","82096.83"
"41.177.223.45","7020","244.3.160.239","80","15","4514","7","1058","8","3456","6.998573000","0.2729","31010.93","101298.47"
"224.143.111.111","1094","244.3.41.84","23","5","320","2","128","3","192","153.483825000","0.2729","3752.80","5629.20"
"244.3.160.239","61576","177.124.75.164","80","13","3409","7","2366","6","1043","49.903836000","0.2727","69418.01","30601.43"
"244.3.160.239","62078","188.68.72.71","80","11","1935","6","1151","5","784","111.642301000","0.2726","33778.80","23008.32"
"41.177.223.45","10980","244.3.160.239","80","15","4236","7","1058","8","3178","5.529317000","0.2721","31110.10","93447.91"
"244.3.160.239","62074","188.68.72.71","80","11","1941","6","1139","5","802","111.449385000","0.2719","33510.35","23595.52"
"253.160.251.79","2869","253.37.253.43","446","33","34864","0","0","33","34864","209.754271000","0.2717","N/A","1026698.91"
"244.3.160.239","62720","41.43.180.128","80","11","2619","6","1540","5","1079","221.544984000","0.2714","45401.95","31810.84"
"244.3.160.239","61372","41.43.180.128","80","11","2721","6","1447","5","1274","18.607513000","0.2711","42695.23","37590.68"
"244.3.164.46","2579","244.3.160.239","80","12","2152","6","1127","6","1025","142.830243000","0.2711","33258.82","30248.70"
"244.3.160.239","61062","128.71.90.164","80","10","4997","5","320","5","4677","1.129091000","0.2705","9465.57","138345.15"
"244.3.160.239","61965","244.3.31.75","80","43","35855","17","2091","26","33764","103.403639000","0.2696","62043.34","1001832.22"
"244.3.160.239","62344","85.241.98.37","80","12","3367","7","1338","5","2029","155.808444000","0.2694","39729.35","60247.27"
"41.177.176.156","8119","244.3.160.239","80","13","4009","6","1547","7","2462","96.870025000","0.2694","45943.56","73117.67"
"244.3.160.239","62512","122.248.218.117","80","13","4564","7","1544","6","3020","189.472834000","0.2694","45854.97","89690.43"
"244.3.160.239","62040","188.68.72.71","80","11","1849","6","1142","5","707","108.801703000","0.2690","33959.67","21024.07"
"244.3.160.239","61299","198.123.241.156","80","11","1880","6","1120","5","760","5.268058000","0.2690","33311.03","22603.91"
"244.3.160.239","61438","244.3.31.75","80","11","2992","6","1225","5","1767","30.421956000","0.2689","36439.90","52562.69"
"244.176.48.13","3627","244.3.160.239","80","10","1535","5","666","5","869","122.556138000","0.2687","19830.50","25874.94"
"18.132.77.186","12604","244.3.160.239","80","12","2153","6","1237","6","916","52.046926000","0.2686","36841.38","27281.09"
"244.3.160.239","62041","188.68.72.71","80","11","2434","6","1143","5","1291","108.802369000","0.2686","34046.48","38454.95"
"244.3.160.239","62105","244.3.31.75","80","11","3160","6","1393","5","1767","113.199258000","0.2684","41517.64","52664.52"
"244.3.160.204","51191","244.3.160.89","443","13","3841","5","362","8","3479","168.219842000","0.2684","10790.67","103703.70"
"244.3.160.239","61311","128.71.90.164","80","12","4547","7","1327","5","3220","6.409459000","0.2681","39590.08","96066.35"
"244.3.253.224","9963","244.3.160.239","80","14","3205","7","1840","7","1365","220.635584000","0.2681","54901.40","40728.49"
"66.163.119.41","3180","41.177.26.91","80","11","5405","6","721","5","4684","115.294662000","0.2680","21519.50","139802.12"
"18.132.77.186","3188","244.3.160.239","80","12","2153","6","1237","6","916","51.807695000","0.2679","36933.64","27349.41"
"253.160.251.79","2537","253.37.253.43","446","38","41690","0","0","38","41690","20.826675000","0.2679","N/A","1244816.69"
"18.132.77.186","5616","244.3.160.239","80","12","2150","6","1237","6","913","52.257551000","0.2679","36935.85","27261.46"
"244.3.160.239","62332","85.241.98.37","80","45","35192","18","1835","27","33357","154.351542000","0.2679","54799.43","996155.08"
"85.108.117.193","49948","41.177.26.176","80","17","5879","5","640","12","5239","82.386307000","0.2679","19112.75","156455.78"
"244.3.160.239","62155","188.68.193.91","80","10","2277","6","1468","4","809","116.820666000","0.2679","43844.78","24162.42"
"244.3.160.239","61424","244.3.31.75","80","11","2978","6","1217","5","1761","28.757108000","0.2677","36371.11","52629.02"
"244.3.160.239","61695","122.248.218.117","80","13","4564","7","1544","6","3020","59.793995000","0.2677","46147.06","90261.74"
"41.177.223.45","12969","244.3.160.239","80","15","4365","7","1058","8","3307","7.228112000","0.2675","31645.97","98916.10"
"244.3.160.239","62666","244.3.31.75","80","11","3051","6","1284","5","1767","213.053523000","0.2674","38410.91","52859.88"
"18.132.77.186","2525","244.3.160.239","80","12","1990","6","1237","6","753","51.538804000","0.2673","37018.06","22534.03"
"244.3.160.239","62038","188.68.72.71","80","11","1930","6","1138","5","792","108.602298000","0.2673","34062.30","23705.92"
"41.177.176.156","6844","244.3.160.239","80","10","2345","5","1476","5","869","111.257396000","0.2672","44184.18","26013.58"
"244.3.160.239","62164","244.3.31.75","80","40","32953","16","1702","24","31251","117.921973000","0.2670","50992.82","936296.43"
"244.3.160.239","61369","94.2.202.203","80","18","7709","11","6454","7","1255","18.284490000","0.2670","193391.31","37605.53"
"244.3.160.239","62039","188.68.72.71","80","11","1847","6","1142","5","705","108.603030000","0.2669","34226.46","21129.29"
"66.163.119.41","3455","41.177.26.91","80","11","5405","6","721","5","4684","116.149247000","0.2669","21612.63","140407.15"
"244.3.160.239","61895","40.248.176.156","80","16","7434","8","1439","8","5995","96.629226000","0.2666","43184.52","179910.49"
"244.3.160.239","61256","85.241.98.37","80","45","35628","18","2271","27","33357","1.704623000","0.2666","68154.19","1001065.38"
"145.95.31.210","10757","244.3.160.239","80","10","3072","5","1293","5","1779","87.843163000","0.2663","38849.68","53452.12"
"244.3.160.239","61906","40.248.176.156","80","14","5346","7","1377","7","3969","97.332032000","0.2662","41377.45","119264.40"
"244.3.160.204","51203","244.3.160.239","443","7","448","4","256","3","192","168.222974000","0.2661","7695.83","5771.88"
"18.132.77.186","5015","244.3.160.239","80","12","1953","6","1237","6","716","50.479394000","0.2660","37200.49","21532.38"
"244.3.160.239","61858","188.68.214.108","80","11","2243","6","1322","5","921","87.447897000","0.2656","39825.72","27745.46"
"244.3.160.239","62643","177.124.75.164","80","15","4260","8","2133","7","2127","210.162601000","0.2655","64273.85","64093.05"
"244.3.160.239","62083","188.68.72.71","80","11","2569","6","1160","5","1409","111.841321000","0.2652","34994.70","42506.50"
"244.3.160.239","62084","188.68.72.71","80","11","2496","6","1160","5","1336","111.842009000","0.2651","35001.57","40312.15"
"244.3.160.239","62148","188.68.193.91","80","12","3103","7","1531","5","1572","115.486210000","0.2650","46226.37","47464.31"
"68.33.110.176","15286","244.3.160.239","80","47","34900","13","1798","34","33102","99.077482000","0.2645","54380.21","1001164.43"
"244.3.160.239","61877","128.71.90.164","80","10","2744","6","1264","4","1480","91.983677000","0.2642","38267.08","44806.39"
"18.132.77.186","9181","244.3.160.239","80","12","2431","6","1237","6","1194","51.766428000","0.2636","37537.88","36233.01"
"244.3.253.224","4237","244.3.160.239","80","12","2499","6","1490","6","1009","221.529796000","0.2635","45244.58","30638.78"
"244.3.160.239","61850","188.68.214.108","80","11","2128","6","1396","5","732","86.680657000","0.2634","42399.07","22232.18"
"244.3.160.239","61506","177.124.75.164","80","13","3602","7","2182","6","1420","42.814083000","0.2633","66294.48","43143.06"
"41.177.199.139","14204","244.3.160.239","80","12","3261","6","1272","6","1989","68.741069000","0.2631","38683.63","60488.79"
"77.194.20.202","38182","244.3.210.197","80","32","28766","12","2494","20","26272","190.244114000","0.2630","75874.66","799269.85"
"244.3.160.239","62058","244.3.31.75","80","40","32953","16","1702","24","31251","110.427771000","0.2628","51815.40","951400.23"
"244.3.160.239","62250","188.68.72.71","80","11","1869","6","1166","5","703","135.523331000","0.2624","35552.03","21434.89"
"244.3.160.239","62118","244.3.31.75","80","40","32953","16","1702","24","31251","114.311937000","0.2622","51920.32","953326.62"
"244.3.160.239","62153","188.68.193.91","80","12","3248","7","1528","5","1720","116.527350000","0.2621","46639.58","52500.05"
"244.3.160.239","61862","244.3.31.75","80","11","3022","6","1255","5","1767","87.845511000","0.2618","38344.17","53987.37"
"41.177.124.47","13802","244.3.160.239","80","12","2421","6","1705","6","716","225.941160000","0.2618","52106.81","21881.80"
"244.3.160.239","61277","85.241.98.37","80","30","21831","13","1922","17","19909","2.361326000","0.2616","58775.41","608823.96"
"244.3.160.239","62701","41.43.180.128","80","11","2597","6","1529","5","1068","218.315003000","0.2612","46824.46","32706.68"
"244.3.160.239","61287","128.71.90.164","80","10","2706","6","1228","4","1478","4.478216000","0.2612","37608.29","45264.70"
"244.3.160.239","62513","122.248.218.117","80","14","5921","7","1592","7","4329","189.844157000","0.2609","48820.13","132752.73"
"244.3.160.239","62315","128.71.90.164","80","10","2924","6","1430","4","1494","150.438571000","0.2606","43903.58","45868.50"
"244.3.160.239","62333","85.241.98.37","80","14","4431","8","1160","6","3271","154.597424000","0.2604","35636.93","100490.01"
"66.163.119.41","3286","41.177.26.91","80","11","5405","6","721","5","4684","115.563019000","0.2604","22151.30","143906.66"
"244.3.160.239","61274","128.71.90.164","80","10","2505","6","1107","4","1398","2.296152000","0.2603","34024.37","42968.45"
"244.3.155.77","11232","244.3.160.239","80","106","73966","38","3819","68","70147","45.443343000","0.2602","117398.87","2156370.44"
"244.3.160.239","61957","244.3.31.75","80","11","3231","6","1464","5","1767","102.582453000","0.2602","45005.48","54320.13"
"244.3.155.77","10794","244.3.160.239","80","15","4185","8","3360","7","825","24.789973000","0.2601","103355.99","25377.59"
"41.177.242.152","2004","244.3.41.84","23","2","128","2","128","0","0","153.471808000","0.2599","3939.70","N/A"
"244.3.160.239","61934","177.124.75.164","80","16","6156","8","2140","8","4016","100.665569000","0.2599","65868.95","123612.02"
"41.177.3.215","35521","244.3.210.95","383","13","2367","8","1372","5","995","99.706479000","0.2599","42230.65","30626.46"
"244.3.160.239","62339","85.241.98.37","80","12","3198","7","1217","5","1981","155.139793000","0.2598","37473.97","60999.13"
"244.3.160.239","62753","197.154.128.197","80","10","2272","6","1595","4","677","225.944979000","0.2592","49229.72","20895.63"
"244.3.160.239","61383","177.124.75.164","80","22","13129","10","2649","12","10480","21.796452000","0.2592","81762.73","323470.52"
"244.3.160.239","62033","188.68.193.91","80","12","3578","7","1474","5","2104","108.142161000","0.2591","45507.70","64958.07"
"244.3.160.239","61874","122.248.218.117","80","14","5920","7","1592","7","4328","90.475413000","0.2590","49165.96","133662.24"
"18.132.77.186","10405","244.3.160.239","80","12","2192","6","1237","6","955","52.776873000","0.2590","38203.18","29493.97"
"244.3.160.239","62523","128.71.90.164","80","10","2981","6","1487","4","1494","191.883857000","0.2589","45946.47","46162.76"
"244.3.160.239","61276","128.71.90.164","80","10","2344","6","1227","4","1117","2.298220000","0.2589","37920.26","34520.72"
"244.3.160.239","61760","244.3.31.75","80","41","35367","16","1876","25","33491","70.816019000","0.2588","57980.87","1035094.50"
"244.3.160.239","61755","244.3.31.75","80","13","3235","7","1254","6","1981","68.743416000","0.2587","38777.31","61258.25"
"41.177.211.185","14386","244.3.160.239","80","12","3444","6","1579","6","1865","159.356726000","0.2586","48848.77","57696.62"
"18.132.77.186","7223","244.3.160.239","80","12","2519","6","1237","6","1282","52.737213000","0.2585","38288.32","39681.19"
"244.3.199.165","1505","41.177.98.142","80","46","37739","16","2014","30","35725","229.761015000","0.2584","62351.25","1106007.19"
"244.3.160.239","62340","85.241.98.37","80","12","3119","7","1217","5","1902","155.141119000","0.2582","37714.07","58941.79"
"18.132.77.186","8624","244.3.160.239","80","12","2276","6","1237","6","1039","52.017237000","0.2581","38341.28","32204.20"
"18.132.77.186","15409","244.3.160.239","80","12","2329","6","1237","6","1092","52.977206000","0.2580","38359.41","33862.96"
"244.3.160.239","61974","188.68.193.91","80","10","2327","6","1420","4","907","103.900112000","0.2579","44046.54","28133.95"
"18.132.77.186","4975","244.3.160.239","80","12","2299","6","1237","6","1062","51.027778000","0.2575","38438.08","33000.20"
"184.75.94.223","4319","244.3.41.84","23","4","838","2","201","2","637","189.642364000","0.2574","6247.13","19798.13"
"244.3.160.239","61359","48.151.224.205","80","34","26743","14","1540","20","25203","15.788724000","0.2572","47897.67","783873.41"
"18.132.77.186","12365","244.3.160.239","80","12","2379","6","1237","6","1142","51.028594000","0.2571","38495.05","35538.68"
"244.3.160.239","61300","198.123.241.156","80","11","1836","6","1108","5","728","5.271641000","0.2570","34489.20","22660.77"
"253.160.251.79","2609","253.37.253.43","446","46","52607","0","0","46","52607","51.456403000","0.2569","N/A","1638005.39"
"41.177.222.224","55566","244.3.41.84","23","4","256","2","128","2","128","32.449424000","0.2569","3986.34","3986.34"
"244.3.164.46","13602","244.3.160.239","80","12","2474","6","941","6","1533","144.485735000","0.2568","29317.50","47761.66"
"18.132.77.186","3350","244.3.160.239","80","12","2369","6","1237","6","1132","51.027774000","0.2567","38547.98","35275.92"
"244.3.160.239","62062","188.68.72.71","80","11","1871","6","1159","5","712","110.766134000","0.2562","36185.96","22229.85"
"244.3.160.239","62126","188.68.193.91","80","10","2340","6","1466","4","874","114.889796000","0.2560","45803.73","27307.27"
"244.3.181.123","4847","244.3.160.239","80","12","3501","6","1461","6","2040","2.549836000","0.2559","45669.09","63767.93"
"244.3.160.239","62557","188.68.193.91","80","12","3203","7","1412","5","1791","199.352470000","0.2559","44141.21","55989.31"
"244.3.160.239","62716","117.246.95.43","80","12","2319","7","1555","5","764","220.715929000","0.2558","48629.84","23892.73"
"244.3.160.239","62046","188.68.72.71","80","11","2764","6","1147","5","1617","109.408984000","0.2558","35872.48","50571.75"
"244.3.181.123","6627","244.3.160.239","80","21","9549","9","1454","12","8095","29.415526000","0.2555","45527.31","253468.76"
"244.3.160.239","62352","128.71.90.164","80","10","2981","6","1487","4","1494","158.603479000","0.2554","46572.63","46791.87"
"244.3.160.239","61264","85.241.98.37","80","13","4803","7","1532","6","3271","1.948592000","0.2552","48033.36","102556.87"
"244.3.160.239","62168","188.68.193.91","80","10","2364","6","1450","4","914","118.726885000","0.2550","45481.28","28668.89"
"244.3.160.239","62013","244.3.31.75","80","40","33088","16","1837","24","31251","106.781697000","0.2550","57627.98","980365.86"
"41.177.199.139","14922","244.3.160.239","80","12","1940","6","1155","6","785","98.508055000","0.2549","36243.11","24632.76"
"244.3.160.239","61935","177.124.75.164","80","13","3376","7","2076","6","1300","100.669430000","0.2548","65181.30","40816.81"
"244.3.160.239","62059","188.68.72.71","80","11","2077","6","1139","5","938","110.581753000","0.2544","35815.64","29495.23"
"244.3.160.239","62182","244.3.31.75","80","40","32953","16","1702","24","31251","121.244285000","0.2544","53531.90","982917.44"
"77.197.210.159","32452","41.177.26.176","80","15","12255","4","256","11","11999","95.805511000","0.2541","8058.77","377723.48"
"244.3.160.239","62356","244.3.31.75","80","13","3418","7","1561","6","1857","159.359039000","0.2541","49146.59","58465.86"
"244.3.160.239","61265","85.241.98.37","80","10","3073","6","1456","4","1617","1.950925000","0.2539","45884.82","50958.63"
"151.77.108.208","3979","244.3.160.239","80","59","39525","22","2648","37","36877","187.672622000","0.2534","83602.35","1164276.41"
"41.84.117.71","50468","244.3.210.197","80","18","11396","8","1040","10","10356","92.157370000","0.2532","32855.12","327161.15"
"77.197.128.118","39201","41.177.26.176","80","23","10033","9","868","14","9165","142.048080000","0.2531","27439.81","289730.23"
"244.3.160.239","61459","177.124.75.164","80","16","7259","8","2246","8","5013","32.603607000","0.2529","71038.86","158556.45"
"244.3.160.239","62089","244.3.31.75","80","11","3149","6","1388","5","1761","112.089508000","0.2529","43910.85","55711.10"
"77.197.128.225","3837","41.177.26.176","80","22","9969","8","804","14","9165","200.369419000","0.2525","25473.27","290376.24"
"244.3.153.25","50831","244.3.160.80","443","13","2833","6","1427","7","1406","219.307550000","0.2522","45257.23","44591.21"
"253.37.253.43","54768","253.160.128.224","25","11","1532","11","1532","0","0","141.059929000","0.2521","48618.91","N/A"
"244.3.160.239","62645","177.124.75.164","80","15","4918","8","2141","7","2777","210.780643000","0.2520","67979.58","88173.43"
"244.3.160.239","61764","244.3.31.75","80","38","31536","15","1812","23","29724","73.473309000","0.2519","57540.02","943884.98"
"122.155.141.12","4405","244.3.160.239","80","43","32577","17","2086","26","30491","160.341169000","0.2516","66332.78","969584.23"
"244.3.160.239","62343","85.241.98.37","80","16","7690","8","1275","8","6415","155.392195000","0.2515","40553.76","204041.06"
"244.3.160.239","62114","244.3.31.75","80","40","32953","16","1702","24","31251","114.021519000","0.2515","54141.10","994103.17"
"244.3.160.239","62160","244.3.31.75","80","40","32953","16","1702","24","31251","117.635724000","0.2513","54184.19","994894.37"
"151.77.217.75","3072","244.3.160.239","80","14","2359","8","1509","6","850","104.503982000","0.2508","48128.02","27109.89"
"244.3.160.239","62018","244.3.31.75","80","40","33088","16","1837","24","31251","107.127881000","0.2507","58610.28","997076.66"
"244.3.160.239","62723","41.43.180.128","80","11","2745","6","1431","5","1314","222.455579000","0.2507","45658.49","41925.41"
"41.177.132.22","7630","244.3.160.239","80","57","38649","20","2202","37","36447","213.378812000","0.2505","70323.07","1163971.40"
"244.3.160.239","62061","244.3.31.75","80","40","32953","16","1702","24","31251","110.723405000","0.2494","54598.31","1002498.15"
"18.132.77.186","14099","244.3.160.239","80","12","2421","6","1237","6","1184","52.546971000","0.2492","39714.26","38012.68"
"41.177.98.252","2059","244.3.160.239","80","12","1991","6","1234","6","757","25.295849000","0.2490","39646.75","24321.38"
"41.177.98.252","8494","244.3.160.239","80","12","1913","6","1231","6","682","25.296793000","0.2485","39629.14","21955.38"
"244.3.79.141","5089","244.3.160.239","80","52","32450","20","2475","32","29975","0.870200000","0.2480","79843.22","966990.07"
"244.3.56.90","5019","244.3.160.239","80","21","13023","9","1618","12","11405","15.980234000","0.2478","52243.47","368255.15"
"244.3.160.239","62508","244.3.31.75","80","43","35850","17","2086","26","33764","187.676134000","0.2477","67372.64","1090493.63"
"253.37.253.43","2000","253.116.185.77","515","11","1767","11","1767","0","0","125.271847000","0.2476","57085.40","N/A"
"244.3.160.239","61268","85.241.98.37","80","10","2073","6","1464","4","609","2.143631000","0.2475","47317.58","19683.34"
"244.3.56.90","3977","244.3.160.239","80","12","3273","6","1426","6","1847","16.267835000","0.2472","46147.93","59772.25"
"244.3.160.239","61577","177.124.75.164","80","13","3567","7","2366","6","1201","49.928094000","0.2472","76578.56","38871.87"
"244.3.160.239","61272","85.241.98.37","80","10","2114","6","1458","4","656","2.253072000","0.2470","47227.45","21249.11"
"244.3.160.239","61280","85.241.98.37","80","12","3509","7","1528","5","1981","2.593470000","0.2469","49517.34","64197.55"
"244.3.160.239","62518","122.248.218.117","80","11","2082","6","1472","5","610","190.717049000","0.2469","47704.12","19768.69"
"244.3.160.239","61586","177.124.75.164","80","13","3494","7","2367","6","1127","50.779078000","0.2467","76757.19","36546.41"
"244.3.164.46","14328","244.3.160.239","80","18","7513","8","1270","10","6243","154.696520000","0.2467","41190.80","202483.61"
"244.3.160.239","62069","188.68.193.91","80","10","2361","6","1451","4","910","111.316134000","0.2464","47112.88","29547.01"
"15.22.79.239","19978","41.177.26.176","80","13","5349","5","455","8","4894","173.707867000","0.2462","14783.35","159010.33"
"244.3.160.239","62080","40.248.176.156","80","13","3068","7","1540","6","1528","111.732331000","0.2462","50040.21","49650.29"
"244.3.181.123","3832","244.3.160.239","80","12","2751","6","1282","6","1469","110.948427000","0.2455","41775.46","47869.07"
"244.3.160.239","62547","198.123.241.156","80","11","1912","6","1468","5","444","198.090871000","0.2454","47850.52","14472.50"
"47.124.77.164","1327","244.3.41.84","23","4","256","2","128","2","128","153.474991000","0.2452","4175.59","4175.59"
"244.3.160.239","62068","188.68.72.71","80","11","1682","6","1026","5","656","111.207229000","0.2451","33490.15","21412.80"
"244.3.241.204","3872","244.3.160.239","80","10","2053","5","1379","5","674","220.709839000","0.2446","45109.03","22047.49"
"244.3.160.239","62042","188.68.72.71","80","11","1867","6","1135","5","732","109.001245000","0.2445","37133.37","23948.57"
"244.3.160.239","62345","128.71.90.164","80","10","2918","6","1499","4","1419","156.657017000","0.2441","49126.00","46504.20"
"41.177.199.139","15995","244.3.160.239","80","47","29235","18","2238","29","26997","57.467144000","0.2439","73414.36","885597.60"
"244.3.160.239","62086","77.91.159.163","80","12","2349","7","1859","5","490","111.993118000","0.2438","60988.81","16075.59"
"244.3.160.239","61587","177.124.75.164","80","13","3480","7","2367","6","1113","50.782552000","0.2438","77660.35","36517.10"
"244.3.160.239","61941","177.124.75.164","80","24","14931","11","2374","13","12557","101.411048000","0.2434","78038.52","412775.77"
"244.3.160.239","61227","117.246.95.43","80","10","1766","6","953","4","813","0.194777000","0.2433","31332.71","26729.79"
"244.3.160.239","61778","43.106.84.231","80","50","40828","19","1977","31","38851","76.970814000","0.2432","65033.70","1278009.19"
"244.3.160.239","62045","188.68.72.71","80","11","1888","6","1148","5","740","109.278721000","0.2432","37768.13","24345.31"
"41.177.211.185","3525","244.3.160.239","443","21","7700","9","1836","12","5864","159.623754000","0.2428","60484.77","193182.29"
"41.177.168.181","3571","244.3.160.239","80","13","4790","6","1048","7","3742","76.803213000","0.2423","34606.02","123564.62"
"244.3.253.224","9926","244.3.160.239","80","12","2477","6","1479","6","998","218.311626000","0.2422","48854.81","32966.26"
"244.3.160.239","61229","117.246.95.43","80","10","1782","6","952","4","830","0.196181000","0.2421","31455.35","27424.30"
"77.197.210.186","46343","41.177.26.15","80","7","1022","4","631","3","391","102.362707000","0.2413","20924.09","12965.64"
"16.176.93.164","4696","244.3.160.239","80","5","1398","3","1264","2","134","234.224662000","0.2412","41923.02","4444.37"
"244.3.160.239","62016","188.68.72.71","80","11","1697","6","1179","5","518","107.073064000","0.2412","39109.50","17182.97"
"41.177.3.215","35834","244.3.210.95","383","13","2367","8","1372","5","995","220.069980000","0.2410","45549.24","33033.16"
"244.3.160.239","61453","177.124.75.164","80","19","10511","9","2323","10","8188","32.284104000","0.2410","77124.83","271845.95"
"244.3.160.239","62184","244.3.31.75","80","40","32659","16","1702","24","30957","121.551586000","0.2409","56524.66","1028104.58"
"244.3.160.239","62017","188.68.72.71","80","11","1700","6","1183","5","517","107.081790000","0.2407","39315.06","17181.65"
"244.3.160.239","61922","244.3.31.75","80","35","32337","11","1556","24","30781","99.090026000","0.2403","51791.35","1024543.48"
"244.3.160.239","61800","43.106.84.231","80","18","7263","9","1367","9","5896","78.436714000","0.2402","45523.42","196346.80"
"77.197.128.118","12006","41.177.26.176","80","22","10505","8","1067","14","9438","209.871122000","0.2401","35556.89","314513.51"
"18.132.77.186","7433","244.3.160.239","80","12","2649","6","1237","6","1412","52.506269000","0.2389","41416.95","47276.26"
"244.3.160.239","62311","122.248.218.117","80","13","4564","7","1544","6","3020","149.679127000","0.2389","51697.58","101118.33"
"244.3.160.239","62012","188.68.72.71","80","11","1698","6","1182","5","516","106.749389000","0.2388","39603.46","17288.82"
"244.3.160.239","62346","128.71.90.164","80","10","1992","6","1527","4","465","157.053220000","0.2388","51164.56","15580.56"
"77.197.210.128","16667","41.177.26.176","80","16","12237","5","320","11","11917","0.299065000","0.2387","10722.96","399329.81"
"244.3.160.239","61519","122.248.218.117","80","11","2086","6","1467","5","619","45.097491000","0.2387","49161.99","20743.88"
"244.3.213.210","6066","244.3.160.239","80","57","39005","20","2558","37","36447","27.569238000","0.2386","85763.02","1221972.16"
"244.3.160.239","62266","40.248.176.156","80","11","2322","6","1477","5","845","138.819017000","0.2384","49557.94","28352.37"
"244.3.153.197","50542","244.3.41.152","5401","20","2980","12","1840","8","1140","187.312868000","0.2382","61799.66","38288.92"
"244.3.160.239","62227","48.151.224.205","80","39","30605","16","1880","23","28725","130.347998000","0.2382","63149.76","964881.34"
"244.3.160.239","62064","188.68.72.71","80","11","1864","6","1158","5","706","110.823843000","0.2381","38915.21","23725.51"
"77.197.210.160","58216","41.177.26.176","80","16","12429","5","320","11","12109","0.339741000","0.2380","10754.95","406973.91"
"244.3.160.239","62697","41.43.180.128","80","15","4353","8","2407","7","1946","218.018683000","0.2378","80960.97","65454.94"
"244.3.164.46","4763","244.3.160.239","80","57","35992","21","2134","36","33858","154.349286000","0.2378","71781.76","1138887.95"
"244.3.160.239","61966","188.68.211.24","80","11","1843","6","1160","5","683","103.556383000","0.2377","39046.39","22990.25"
"244.3.160.239","62655","177.124.75.164","80","27","17608","12","2397","15","15211","211.985603000","0.2376","80714.88","512204.46"
"151.77.217.75","3060","244.3.160.239","80","18","6510","9","1591","9","4919","103.181920000","0.2376","53579.17","165654.27"
"244.3.153.102","2873","244.3.160.80","443","15","1983","7","1032","8","951","233.048430000","0.2374","34772.21","32042.99"
"244.3.160.239","62267","40.248.176.156","80","11","2326","6","1476","5","850","138.819631000","0.2374","49744.29","28646.78"
"41.177.3.224","52714","244.3.41.117","8412","22","6831","11","2836","11","3995","78.646440000","0.2374","95586.78","134650.63"
"244.3.160.239","62025","188.68.72.71","80","11","1704","6","1189","5","515","107.597319000","0.2371","40114.03","17374.88"
"18.132.77.186","12252","244.3.160.239","80","11","2152","5","1173","6","979","53.017496000","0.2371","39586.42","33039.30"
"244.3.160.239","61401","177.124.75.164","80","45","36298","18","2905","27","33393","25.061430000","0.2370","98041.28","1126985.40"
"253.37.253.43","2000","253.116.23.22","515","13","3877","13","3877","0","0","175.093010000","0.2370","130882.45","N/A"
"151.77.39.25","15120","244.3.160.239","80","18","7018","8","1724","10","5294","215.083984000","0.2369","58209.07","178746.43"
"41.177.34.163","45727","41.177.98.176","80","151","128279","60","8021","91","120258","233.079324000","0.2369","270895.08","4061501.05"
"244.3.160.239","61761","244.3.31.75","80","41","35367","16","1876","25","33491","71.109813000","0.2369","63363.13","1131180.42"
"244.3.160.239","61940","177.124.75.164","80","16","6415","8","2182","8","4233","101.407317000","0.2367","73746.74","143065.96"
"41.177.98.252","13135","244.3.160.239","80","12","2520","6","1203","6","1317","42.810953000","0.2367","40659.41","44512.42"
"244.3.164.46","7790","244.3.160.239","80","12","3305","6","1231","6","2074","155.806413000","0.2365","41634.08","70145.47"
"244.3.160.239","62110","244.3.31.75","80","43","35784","17","2020","26","33764","113.654995000","0.2365","68322.01","1141992.25"
"244.3.181.123","5833","244.3.160.239","80","58","36378","21","2462","37","33916","1.701061000","0.2362","83373.55","1148536.65"
"244.3.160.239","61931","40.248.176.156","80","13","2838","7","1229","6","1609","99.933134000","0.2361","41636.67","54510.50"
"242.161.82.241","57996","244.3.210.197","80","22","15505","10","1203","12","14302","86.906106000","0.2353","40904.98","486303.38"
"244.3.160.239","62112","188.68.193.91","80","10","2197","6","1467","4","730","113.738634000","0.2352","49908.14","24835.00"
"15.186.110.132","47706","41.177.26.91","80","16","7941","8","1000","8","6941","86.403738000","0.2351","34035.31","236239.10"
"244.3.160.239","62172","77.91.159.163","80","14","2663","8","2109","6","554","119.194980000","0.2348","71867.61","18878.45"
"244.3.160.239","62014","188.68.72.71","80","11","1697","6","1179","5","518","106.917509000","0.2345","40220.55","17671.11"
"244.3.160.239","61237","82.242.98.77","80","34","31469","11","2032","23","29437","0.919385000","0.2341","69447.83","1006070.70"
"244.3.160.239","61970","40.248.176.156","80","13","4333","7","1391","6","2942","103.724293000","0.2340","47551.49","100572.60"
"244.3.160.239","62020","188.68.72.71","80","11","1710","6","1193","5","517","107.259208000","0.2340","40793.65","17678.39"
"244.3.160.239","61852","117.246.95.43","80","10","1565","6","938","4","627","87.232032000","0.2338","32090.18","21450.47"
"242.161.82.241","61126","244.3.210.197","80","20","12297","10","1185","10","11112","98.294747000","0.2337","40556.84","380310.25"
"244.3.253.224","6230","244.3.160.239","80","12","2624","6","1381","6","1243","222.449638000","0.2336","47284.80","42559.75"
"244.3.160.239","61503","122.248.218.117","80","11","2082","6","1472","5","610","41.686270000","0.2336","50417.43","20893.09"
"242.161.82.241","58828","244.3.210.197","80","20","12623","10","1113","10","11510","184.169506000","0.2335","38130.80","394326.63"
"242.161.82.241","61310","244.3.210.197","80","19","11027","9","1110","10","9917","62.719809000","0.2334","38052.79","339972.57"
"242.161.82.241","50505","244.3.210.197","80","20","12992","10","1186","10","11806","120.442166000","0.2333","40660.65","404755.17"
"41.177.98.143","8001","194.143.194.43","1570","3","298","1","140","2","158","18.383663000","0.2333","N/A","5416.96"
"242.161.82.241","63025","244.3.210.197","80","20","13176","10","1112","10","12064","180.812122000","0.2332","38140.32","413781.28"
"244.3.160.239","62021","188.68.72.71","80","11","1703","6","1186","5","517","107.429451000","0.2331","40711.77","17747.04"
"77.197.128.139","28962","41.177.26.176","80","18","13071","7","448","11","12623","95.718812000","0.2329","15390.30","433642.23"
"151.77.217.75","12990","244.3.160.239","80","15","2406","8","1518","7","888","104.558111000","0.2329","52151.51","30507.60"
"41.177.98.252","10729","244.3.160.239","80","13","6055","6","1203","7","4852","32.600873000","0.2326","41381.98","166903.88"
"244.3.160.239","61479","177.124.75.164","80","16","7259","8","2246","8","5013","37.944657000","0.2325","77265.44","172453.98"
"41.177.98.252","5531","244.3.160.239","80","16","9307","7","1280","9","8027","32.271364000","0.2325","44045.28","276212.11"
"244.3.160.204","31818","244.3.160.239","443","7","448","4","256","3","192","52.202823000","0.2324","8811.29","6608.47"
"244.3.213.252","8649","244.3.160.239","80","17","7440","9","6074","8","1366","18.281760000","0.2320","209467.24","47107.71"
"244.3.160.239","61417","244.3.31.75","80","43","36020","17","2256","26","33764","27.573693000","0.2318","77873.33","1165476.50"
"244.3.160.239","62015","188.68.193.91","80","10","2226","6","1430","4","796","106.942405000","0.2317","49371.42","27482.27"
"244.3.160.239","61624","244.3.31.75","80","34","26660","14","1900","20","24760","57.469485000","0.2317","65603.49","854917.02"
"244.3.160.239","61588","177.124.75.164","80","13","3470","7","2367","6","1103","50.794095000","0.2317","81730.96","38085.87"
"41.177.223.45","14592","244.3.160.239","80","12","1839","6","960","6","879","2.293305000","0.2316","33155.75","30358.24"
"244.3.160.239","61837","197.154.128.197","80","10","1876","6","1198","4","678","81.032704000","0.2315","41401.00","23430.62"
"244.3.56.90","14720","244.3.160.239","80","22","12055","9","1618","13","10437","21.793877000","0.2313","55956.63","360951.40"
"244.3.160.239","62082","177.124.75.164","80","19","11058","9","2204","10","8854","111.830247000","0.2313","76227.37","306223.74"
"18.132.77.186","14971","244.3.160.239","80","10","1784","5","1106","5","678","65.064397000","0.2312","38273.04","23462.14"
"77.197.210.108","25027","41.177.26.15","80","7","1013","4","622","3","391","12.966079000","0.2310","21537.58","13538.90"
"244.3.160.239","61331","198.123.241.156","80","11","1653","6","1209","5","444","8.310238000","0.2309","41882.28","15381.08"
"244.3.160.239","61888","188.68.193.91","80","10","2290","6","1419","4","871","95.614628000","0.2309","49172.66","30182.79"
"244.3.160.239","61468","122.248.218.117","80","11","2100","6","1481","5","619","34.549086000","0.2308","51326.48","21452.46"
"244.3.160.248","47307","41.177.26.193","80","40","31385","16","2489","24","28896","35.270820000","0.2308","86273.46","1001590.11"
"244.3.160.239","61896","188.68.193.91","80","10","2271","6","1427","4","844","96.649678000","0.2306","49514.23","29285.22"
"244.3.181.123","11619","244.3.160.239","80","31","21869","12","1857","19","20012","2.357329000","0.2305","64459.30","694647.05"
"244.3.164.46","12852","244.3.160.239","80","15","4577","7","1203","8","3374","154.592842000","0.2303","41788.79","117203.14"
"41.177.3.224","9305","41.177.143.72","3129","14","2996","6","1118","8","1878","74.379846000","0.2300","38885.94","65320.04"
"244.3.160.239","61230","85.241.98.37","80","36","27307","15","2079","21","25228","0.439127000","0.2298","72383.22","878347.27"
"47.167.92.130","1272","244.3.41.84","23","4","256","2","128","2","128","153.461979000","0.2296","4460.30","4460.30"
"253.160.251.79","2602","253.37.253.43","446","20","19090","0","0","20","19090","49.428413000","0.2293","N/A","666082.23"
"244.3.160.239","61955","188.68.193.91","80","12","3157","7","1491","5","1666","102.515685000","0.2292","52048.92","58157.95"
"244.3.160.204","61229","244.3.160.239","443","7","448","4","256","3","192","228.231493000","0.2291","8938.70","6704.03"
"244.3.160.239","62133","188.68.193.91","80","12","3195","7","1530","5","1665","115.047571000","0.2289","53462.39","58179.66"
"244.3.160.204","61896","244.3.160.239","443","7","448","4","256","3","192","232.232432000","0.2289","8947.49","6710.62"
"244.3.160.239","61578","177.124.75.164","80","14","3234","7","2366","7","868","49.947075000","0.2287","82745.72","30356.42"
"244.3.160.239","62651","177.124.75.164","80","19","11299","9","2203","10","9096","211.514069000","0.2287","77061.32","318179.63"
"244.3.177.130","2419","41.177.98.176","80","7","1482","4","1124","3","358","223.077984000","0.2286","39331.64","12527.34"
"41.177.98.252","2784","244.3.160.239","80","58","36180","21","2207","37","33973","25.058415000","0.2283","77321.60","1190234.08"
"244.3.160.239","62528","122.248.218.117","80","11","2086","6","1467","5","619","193.786221000","0.2283","51397.49","21687.15"
"244.3.160.204","34149","244.3.160.89","443","13","3841","5","362","8","3479","66.208483000","0.2281","12693.90","121994.73"
"244.3.160.239","61517","122.248.218.117","80","11","2068","6","1458","5","610","45.070945000","0.2281","51142.19","21396.94"
"244.3.160.204","61221","244.3.160.89","443","13","3841","5","362","8","3479","228.229353000","0.2278","12715.36","122200.95"
"244.3.160.239","61884","188.68.193.91","80","10","2506","6","1662","4","844","93.347437000","0.2274","58463.74","29689.17"
"244.3.160.239","61476","122.248.218.117","80","11","2068","6","1458","5","610","37.513288000","0.2273","51314.99","21469.23"
"244.3.160.239","61351","41.43.180.128","80","11","2923","6","1731","5","1192","14.411524000","0.2272","60938.10","41963.15"
"244.3.160.239","61613","177.124.75.164","80","20","11051","9","1746","11","9305","54.337456000","0.2272","61478.33","327637.96"
"244.3.160.204","57875","244.3.160.89","443","13","3841","5","362","8","3479","208.224620000","0.2271","12754.90","122580.93"
"15.205.242.71","2123","244.3.210.197","80","6","1249","4","911","2","338","162.749804000","0.2269","32114.64","11915.20"
"244.3.160.239","61281","85.241.98.37","80","28","17964","12","1850","16","16114","2.701157000","0.2269","65218.35","568069.45"
"244.3.160.239","62575","40.248.176.156","80","13","3055","7","1585","6","1470","201.319444000","0.2269","55890.05","51834.94"
"244.3.160.204","39506","244.3.160.239","443","7","448","4","256","3","192","98.210148000","0.2266","9038.11","6778.58"
"244.3.160.204","32812","244.3.160.89","443","13","3841","5","362","8","3479","58.201197000","0.2264","12791.46","122932.32"
"244.3.160.204","39496","244.3.160.89","443","13","3841","5","362","8","3479","98.207497000","0.2264","12794.01","122956.76"
"244.3.160.239","61593","82.242.98.77","80","39","31722","16","2362","23","29360","51.126604000","0.2263","83501.25","1037932.62"
"244.3.47.210","1219","244.3.41.84","23","4","256","2","128","2","128","32.460423000","0.2262","4526.71","4526.71"
"244.3.160.239","62081","40.248.176.156","80","13","3079","7","1541","6","1538","111.804312000","0.2262","54499.48","54393.38"
"244.3.160.239","61282","85.241.98.37","80","16","8001","8","1586","8","6415","2.746166000","0.2261","56112.30","226961.14"
"244.3.160.239","62322","85.241.98.37","80","34","25866","14","1579","20","24287","153.170932000","0.2261","55879.71","859500.04"
"244.3.160.204","58546","244.3.160.89","443","13","3841","5","362","8","3479","212.227000000","0.2257","12831.08","123313.04"
"244.3.160.239","62530","122.248.218.117","80","11","2086","6","1467","5","619","194.329671000","0.2257","51999.38","21941.12"
"244.3.160.204","34485","244.3.160.89","443","13","3841","5","362","8","3479","68.204109000","0.2256","12838.59","123385.20"
"244.3.164.46","15761","244.3.160.239","80","12","3161","6","1135","6","2026","155.137613000","0.2255","40272.86","71887.95"
"244.3.160.239","61505","122.248.218.117","80","11","2100","6","1481","5","619","42.164313000","0.2255","52551.51","21964.47"
"244.3.160.204","23453","244.3.160.89","443","13","3841","5","362","8","3479","2.191732000","0.2254","12845.71","123453.61"
"244.3.160.204","28476","244.3.160.239","443","7","448","4","256","3","192","32.199155000","0.2250","9101.13","6825.85"
"244.3.160.204","27809","244.3.160.239","443","7","448","4","256","3","192","28.198857000","0.2249","9106.19","6829.64"
"244.3.160.239","61504","122.248.218.117","80","11","2100","6","1481","5","619","41.702230000","0.2249","52689.63","22022.20"
"244.3.160.239","61477","122.248.218.117","80","11","2086","6","1467","5","619","37.527102000","0.2248","52201.06","22026.22"
"244.3.77.218","9475","244.3.160.239","80","12","1984","6","1192","6","792","5.247282000","0.2246","42453.36","28207.26"
"244.3.160.204","51197","244.3.160.254","443","7","448","4","256","3","192","168.221396000","0.2246","9119.61","6839.71"
"244.3.160.204","27801","244.3.160.89","443","13","3841","5","362","8","3479","28.196742000","0.2246","12896.50","123941.81"
"244.3.160.239","62208","40.248.176.156","80","13","2955","7","1347","6","1608","123.437986000","0.2245","47993.80","57293.27"
"244.3.164.46","10639","244.3.160.239","80","12","3082","6","1135","6","1947","155.139151000","0.2245","40444.35","69378.99"
"244.3.160.239","61480","122.248.218.117","80","11","2086","6","1467","5","619","38.039631000","0.2245","52284.32","22061.35"
"244.3.160.239","61467","122.248.218.117","80","11","2100","6","1481","5","619","34.043299000","0.2243","52822.35","22077.67"
"244.3.160.204","31810","244.3.160.89","443","13","3841","5","362","8","3479","52.200646000","0.2242","12916.46","124133.62"
"244.3.160.204","25126","244.3.160.89","443","13","3841","5","362","8","3479","12.194366000","0.2241","12920.15","124169.07"
"244.3.160.239","62519","122.248.218.117","80","11","2100","6","1481","5","619","190.731993000","0.2239","52915.06","22116.42"
"244.3.160.204","25134","244.3.160.239","443","7","448","4","256","3","192","12.196549000","0.2239","9148.00","6861.00"
"77.197.128.186","33525","41.177.26.15","80","7","1038","4","647","3","391","70.488641000","0.2239","23121.08","13972.71"
"244.3.181.123","10232","244.3.160.239","80","13","4783","6","1467","7","3316","1.945031000","0.2238","52428.90","118510.05"
"244.3.160.239","61925","40.248.176.156","80","13","4777","7","1392","6","3385","99.445250000","0.2238","49762.05","121009.00"
"244.3.160.239","62527","122.248.218.117","80","11","2068","6","1458","5","610","193.772857000","0.2238","52127.75","21809.28"
"244.3.160.204","51198","244.3.160.254","80","7","448","4","256","3","192","168.221649000","0.2238","9152.99","6864.74"
"244.3.160.239","62521","122.248.218.117","80","11","2100","6","1481","5","619","191.265490000","0.2236","52987.00","22146.49"
"244.3.160.204","30137","244.3.160.89","443","13","3841","5","362","8","3479","42.198629000","0.2236","12953.15","124486.19"
"244.3.160.204","56873","244.3.160.89","443","13","3841","5","362","8","3479","202.224324000","0.2236","12954.54","124499.55"
"41.177.98.220","7010","244.3.185.118","2127","4","1477","2","1271","2","206","216.260516000","0.2235","45502.96","7374.99"
"41.177.98.43","38637","41.177.26.155","8010","14","5616","8","2388","6","3228","230.507695000","0.2234","85514.77","115595.34"
"244.3.160.204","38494","244.3.160.89","443","13","3841","5","362","8","3479","92.207012000","0.2233","12966.25","124612.15"
"244.3.160.239","61521","122.248.218.117","80","11","2086","6","1467","5","619","45.595733000","0.2233","52560.39","22177.83"
"244.3.160.204","35160","244.3.160.239","443","7","448","4","256","3","192","72.206358000","0.2232","9175.71","6881.78"
"145.95.48.71","2176","244.3.41.13","923","4","325","2","151","2","174","162.626584000","0.2231","5415.39","6240.25"
"244.3.160.239","61464","122.248.218.117","80","11","2082","6","1472","5","610","34.028645000","0.2230","52804.10","21882.13"
"244.3.253.224","9740","244.3.160.239","80","14","4111","7","2293","7","1818","218.010547000","0.2230","82260.09","65219.73"
"244.3.160.204","39160","244.3.160.89","443","13","3841","5","362","8","3479","96.207059000","0.2230","12988.00","124821.17"
"244.3.155.77","12856","244.3.160.239","80","14","2521","8","1517","6","1004","0.192449000","0.2230","54428.36","36022.46"
"244.3.155.77","2912","244.3.160.239","80","14","2505","8","1518","6","987","0.192118000","0.2229","54481.34","35423.64"
"244.3.160.204","56216","244.3.160.239","443","7","448","4","256","3","192","198.226427000","0.2229","9189.91","6892.44"
"244.3.160.204","32822","244.3.160.239","443","7","448","4","256","3","192","58.203859000","0.2226","9199.53","6899.65"
"244.3.160.239","61926","40.248.176.156","80","13","3026","7","1392","6","1634","99.445760000","0.2226","50023.36","58719.95"
"244.3.160.204","33828","244.3.160.239","443","7","448","4","256","3","192","64.205153000","0.2226","9201.97","6901.48"
"244.3.160.204","37501","244.3.160.239","443","7","448","4","256","3","192","86.209354000","0.2225","9203.71","6902.78"
"244.3.181.123","8900","244.3.160.239","80","12","3225","6","1505","6","1720","1.947442000","0.2224","54138.15","61872.17"
"41.177.223.45","10153","244.3.160.239","80","9","1448","5","890","4","558","2.220357000","0.2223","32022.45","20077.00"
"41.177.223.45","14865","244.3.160.239","80","12","2184","6","955","6","1229","4.873410000","0.2223","34364.88","44224.54"
"244.3.160.204","26128","244.3.160.89","443","13","3841","5","362","8","3479","18.193998000","0.2222","13031.60","125240.18"
"244.3.160.204","37162","244.3.160.89","443","13","3841","5","362","8","3479","84.205813000","0.2221","13039.05","125311.79"
"41.177.192.117","4137","244.3.160.239","80","13","3388","6","1181","7","2207","164.731405000","0.2221","42548.02","79511.83"
"47.241.184.51","50453","41.177.26.91","80","17","12409","6","683","11","11726","173.223488000","0.2216","24657.37","423327.03"
"244.3.160.204","51201","244.3.160.254","4000","7","448","4","256","3","192","168.222442000","0.2216","9242.63","6931.97"
"244.3.181.123","5648","244.3.160.239","80","12","2006","6","1270","6","736","111.424684000","0.2215","45861.21","26577.83"
"41.177.199.139","2281","244.3.160.239","80","12","2032","6","1282","6","750","112.268693000","0.2215","46311.47","27093.30"
"224.47.199.136","51241","41.177.98.143","8001","3","298","2","158","1","140","146.683589000","0.2214","5707.83","N/A"
"244.3.160.204","29480","244.3.160.239","443","7","448","4","256","3","192","38.200495000","0.2214","9249.43","6937.07"
"244.3.160.239","61474","94.2.202.203","80","16","7619","10","6404","6","1215","36.900581000","0.2214","231451.41","43912.16"
"244.3.160.204","62225","244.3.160.89","443","13","3841","5","362","8","3479","234.229517000","0.2212","13090.57","125806.86"
"244.3.160.204","24467","244.3.160.239","443","7","448","4","256","3","192","8.196081000","0.2211","9261.27","6945.95"
"244.3.160.204","36821","244.3.160.89","443","13","3841","5","362","8","3479","82.204986000","0.2211","13096.07","125859.77"
"244.3.160.204","59224","244.3.160.239","443","7","448","4","256","3","192","216.229843000","0.2211","9262.32","6946.74"
"244.3.160.204","36831","244.3.160.239","443","7","448","4","256","3","192","82.207694000","0.2209","9270.45","6952.84"
"241.151.91.231","64235","41.177.98.127","210","3","298","2","223","1","75","32.799354000","0.2207","8082.57","N/A"
"244.3.181.123","11405","244.3.160.239","80","15","6194","7","1284","8","4910","121.922027000","0.2207","46543.24","177980.77"
"253.160.251.85","44750","253.37.253.43","446","23","23333","0","0","23","23333","74.159511000","0.2206","N/A","845980.93"
"244.3.164.46","4927","244.3.160.239","80","18","7775","8","1257","10","6518","155.384587000","0.2206","45588.70","236393.89"
"244.3.160.204","29138","244.3.160.89","443","13","3841","5","362","8","3479","36.198599000","0.2204","13137.48","126257.72"
"244.3.160.204","36164","244.3.160.239","443","7","448","4","256","3","192","78.206914000","0.2204","9291.14","6968.36"
"41.177.72.67","56425","244.3.41.84","23","4","256","2","128","2","128","153.475556000","0.2204","4645.85","4645.85"
"244.3.160.204","61884","244.3.160.89","443","13","3841","5","362","8","3479","232.229263000","0.2203","13143.03","126311.01"
"244.3.160.204","23794","244.3.160.89","443","13","3841","5","362","8","3479","4.192524000","0.2202","13153.29","126409.69"
"244.3.160.204","30478","244.3.160.89","443","13","3841","5","362","8","3479","44.199262000","0.2201","13157.83","126453.34"
"244.3.153.55","2858","41.177.24.241","443","17","4182","8","2371","9","1811","106.568890000","0.2201","86192.32","65834.80"
"244.3.160.204","52209","244.3.160.239","443","7","448","4","256","3","192","174.224442000","0.2200","9307.65","6980.74"
"244.3.160.204","28464","244.3.160.89","443","13","3841","5","362","8","3479","32.196070000","0.2200","13163.40","126506.79"
"244.3.160.204","35148","244.3.160.89","443","13","3841","5","362","8","3479","72.203126000","0.2199","13171.60","126585.62"
"244.3.160.204","27132","244.3.160.89","443","13","3841","5","362","8","3479","24.195634000","0.2198","13178.01","126647.25"
"244.3.160.204","51205","244.3.160.239","80","7","448","4","256","3","192","168.223520000","0.2197","9320.36","6990.27"
"41.177.192.117","4275","244.3.160.239","80","13","3884","6","1132","7","2752","164.734388000","0.2197","41219.47","100208.46"
"244.3.160.204","37823","244.3.160.89","443","13","3841","5","362","8","3479","88.205751000","0.2197","13183.05","126695.68"
"244.3.160.204","24455","244.3.160.89","443","13","3841","5","362","8","3479","8.192914000","0.2196","13185.69","126721.06"
"244.3.160.204","30486","244.3.160.239","443","7","448","4","256","3","192","44.201453000","0.2196","9326.51","6994.89"
"41.177.93.23","1176","244.3.41.84","23","4","256","2","128","2","128","153.457478000","0.2192","4672.07","4672.07"
"244.3.160.239","62429","41.177.254.197","80","13","3473","7","1311","6","2162","164.734800000","0.2191","47865.28","78935.72"
"244.3.3.145","15881","244.3.160.239","80","12","2867","6","1013","6","1854","202.734233000","0.2191","36990.21","67699.75"
"41.177.211.185","2564","244.3.160.239","80","12","2358","6","1316","6","1042","160.654101000","0.2191","48059.23","38052.98"
"41.177.199.139","15950","244.3.160.239","80","11","2751","5","1211","6","1540","112.049992000","0.2190","44240.07","56259.05"
"244.3.160.239","62348","198.123.241.156","80","11","1759","6","1315","5","444","157.889112000","0.2188","48070.33","16230.59"
"41.177.211.185","3468","244.3.160.239","80","49","39797","18","2083","31","37714","160.764239000","0.2188","76159.14","1378908.16"
"244.3.41.47","1047","244.3.41.84","923","4","325","2","151","2","174","218.473422000","0.2188","5521.23","6362.21"
"41.177.98.143","8001","244.160.201.209","3050","3","298","1","140","2","158","118.285956000","0.2186","N/A","5782.33"
"244.3.160.204","59548","244.3.160.89","443","13","3841","5","362","8","3479","218.226977000","0.2186","13249.88","127337.95"
"41.177.211.185","10798","244.3.160.239","80","12","2931","6","1338","6","1593","177.904333000","0.2186","48974.44","58308.13"
"41.177.98.220","7080","244.3.220.197","1229","3","316","1","128","2","188","63.080763000","0.2185","N/A","6881.85"
"244.3.3.145","4383","244.3.160.239","80","12","1854","6","1024","6","830","203.235327000","0.2185","37484.27","30382.76"
"244.3.3.145","5041","244.3.160.239","80","12","2693","6","1024","6","1669","203.234931000","0.2185","37487.53","61100.28"
"244.3.160.204","34159","244.3.160.239","443","7","448","4","256","3","192","66.211730000","0.2182","9383.86","7037.90"
"244.3.160.204","33150","244.3.160.89","443","13","3841","5","362","8","3479","60.203400000","0.2182","13273.69","127566.74"
"41.177.211.185","4628","244.3.160.239","80","12","2742","6","1308","6","1434","160.655920000","0.2178","48044.74","52672.90"
"41.177.223.45","12240","244.3.160.239","80","12","1809","6","960","6","849","4.878445000","0.2175","35316.68","31233.19"
"244.3.160.204","28805","244.3.160.89","443","13","3841","5","362","8","3479","34.197040000","0.2173","13325.24","128062.14"
"41.177.211.185","2074","244.3.160.239","80","42","32147","16","1954","26","30193","160.875758000","0.2173","71938.08","1111579.49"
"244.3.3.145","13824","244.3.160.239","80","12","1996","6","1024","6","972","203.125805000","0.2173","37702.68","35788.09"
"41.177.211.185","12601","244.3.160.239","80","12","3032","6","1317","6","1715","160.656823000","0.2172","48506.95","63165.84"
"41.177.211.185","13976","244.3.160.239","80","12","2140","6","1349","6","791","178.016168000","0.2172","49687.84","29134.97"
"244.3.160.239","61809","43.106.84.231","80","13","2138","7","1116","6","1022","78.532348000","0.2171","41115.38","37652.26"
"244.3.160.204","25792","244.3.160.89","443","13","3841","5","362","8","3479","16.194352000","0.2171","13337.32","128178.32"
"244.3.160.204","60885","244.3.160.89","443","13","3841","5","362","8","3479","226.229404000","0.2171","13340.46","128208.44"
"41.177.211.185","13157","244.3.160.239","80","12","2091","6","1342","6","749","178.015966000","0.2170","49480.81","27616.34"
"244.3.160.239","62202","40.248.176.156","80","11","2376","6","1531","5","845","122.836861000","0.2169","56455.40","31159.25"
"41.177.192.117","3081","244.3.160.239","80","12","2386","6","1133","6","1253","164.847059000","0.2167","41831.08","46261.56"
"244.3.160.204","35489","244.3.160.89","443","13","3841","5","362","8","3479","74.203864000","0.2165","13374.03","128531.12"
"244.3.160.204","58554","244.3.160.239","443","7","448","4","256","3","192","212.229115000","0.2165","9460.20","7095.15"
"244.3.160.204","35822","244.3.160.89","443","13","3841","5","362","8","3479","76.204910000","0.2165","13378.73","128576.25"
"41.177.211.185","8869","244.3.160.239","80","12","2941","6","1350","6","1591","178.126927000","0.2164","49914.96","58825.70"
"244.3.160.239","62487","244.3.31.75","80","11","2833","6","1231","5","1602","177.906621000","0.2163","45523.04","59242.82"
"244.3.160.204","33816","244.3.160.89","443","13","3841","5","362","8","3479","64.202051000","0.2162","13393.08","128714.20"
"244.3.149.55","49947","244.3.41.84","23","4","256","2","128","2","128","153.470116000","0.2162","4735.79","4735.79"
"41.177.211.185","9590","244.3.160.239","80","12","2946","6","1346","6","1600","178.126700000","0.2162","49805.04","59203.62"
"151.77.39.25","3014","244.3.160.239","80","13","5773","6","1510","7","4263","215.321358000","0.2161","55903.93","157826.78"
"244.3.160.204","57214","244.3.160.89","443","13","3841","5","362","8","3479","204.225528000","0.2161","13403.13","128810.70"
"244.3.160.204","23132","244.3.160.239","443","7","448","4","256","3","192","0.194458000","0.2159","9484.42","7113.32"
"203.67.168.48","54249","41.177.98.143","8001","3","298","2","158","1","140","68.178676000","0.2159","5854.32","N/A"
"244.3.160.204","24133","244.3.160.239","443","7","448","4","256","3","192","6.196338000","0.2158","9489.52","7117.14"
"244.3.181.123","7163","244.3.160.239","80","12","2216","6","1457","6","759","2.249627000","0.2158","54019.23","28140.42"
"244.3.160.204","60564","244.3.160.239","443","7","448","4","256","3","192","224.231563000","0.2157","9496.69","7122.52"
"244.3.160.204","59212","244.3.160.89","443","13","3841","5","362","8","3479","216.226668000","0.2156","13432.53","129093.30"
"244.3.181.123","15265","244.3.160.239","80","12","2225","6","1513","6","712","2.140130000","0.2156","56145.95","26421.62"
"244.3.160.204","59886","244.3.160.89","443","13","3841","5","362","8","3479","220.228543000","0.2155","13440.39","129168.79"
"244.3.181.123","4379","244.3.160.239","80","12","3489","6","1463","6","2026","2.590103000","0.2153","54363.63","75284.15"
"244.3.160.239","62500","198.123.241.156","80","11","1879","6","1435","5","444","184.852185000","0.2152","53337.79","16503.12"
"244.3.160.239","61513","177.124.75.164","80","18","9927","9","2325","9","7602","44.612649000","0.2150","86501.17","282830.91"
"244.3.160.204","60552","244.3.160.89","443","13","3841","5","362","8","3479","224.228418000","0.2150","13469.14","129445.14"
"244.3.160.204","38171","244.3.160.239","443","7","448","4","256","3","192","90.209222000","0.2150","9525.63","7144.22"
"41.177.199.139","12209","244.3.160.239","80","12","1938","6","1153","6","785","99.220114000","0.2149","42913.70","29217.05"
"244.3.160.239","62489","244.3.31.75","80","11","1992","6","1235","5","757","178.018008000","0.2149","45966.32","28175.30"
"244.3.160.204","47861","244.3.160.239","443","7","448","4","256","3","192","148.221464000","0.2149","9529.08","7146.81"
"253.160.251.79","2592","253.37.253.43","446","33","34864","0","0","33","34864","46.931900000","0.2148","N/A","1298539.50"
"244.3.160.204","25804","244.3.160.239","443","7","448","4","256","3","192","16.197597000","0.2147","9540.98","7155.74"
"244.3.160.239","61983","198.123.241.156","80","11","2539","6","1033","5","1506","104.364903000","0.2146","38503.11","56133.29"
"244.3.3.145","8632","244.3.160.239","80","15","4776","7","1084","8","3692","202.739121000","0.2146","40407.24","137623.19"
"244.3.160.204","55212","244.3.160.239","443","7","448","4","256","3","192","192.225855000","0.2146","9543.69","7157.77"
"244.3.160.239","62490","244.3.31.75","80","11","2041","6","1242","5","799","178.018809000","0.2145","46314.34","29794.81"
"244.3.160.204","26466","244.3.160.89","443","13","3841","5","362","8","3479","20.195644000","0.2145","13500.79","129749.28"
"244.3.160.239","62390","244.3.31.75","80","11","2933","6","1210","5","1723","160.659605000","0.2145","45129.05","64262.27"
"244.3.160.239","62669","244.3.31.75","80","43","35675","17","1911","26","33764","213.383636000","0.2144","71306.30","1259856.62"
"244.3.160.204","32476","244.3.160.89","443","13","3841","5","362","8","3479","56.201014000","0.2143","13514.59","129881.89"
"244.3.160.204","29804","244.3.160.89","443","13","3841","5","362","8","3479","40.198265000","0.2142","13522.35","129956.48"
"244.3.160.239","62491","244.3.31.75","80","11","2848","6","1239","5","1609","178.128999000","0.2141","46305.42","60133.52"
"244.3.160.204","38161","244.3.160.89","443","13","3841","5","362","8","3479","90.206539000","0.2140","13532.39","130053.04"
"41.177.181.208","2864","244.3.41.84","23","4","256","2","128","2","128","153.476924000","0.2139","4788.22","4788.22"
"244.3.160.204","23463","244.3.160.239","443","7","448","4","256","3","192","2.194365000","0.2138","9577.88","7183.41"
"244.3.160.239","62492","244.3.31.75","80","11","2843","6","1243","5","1600","178.129768000","0.2136","46552.56","59922.85"
"244.3.155.77","11367","244.3.160.239","80","14","2304","8","1503","6","801","87.229483000","0.2135","56322.19","30016.02"
"244.3.160.204","28815","244.3.160.239","443","7","448","4","256","3","192","34.199683000","0.2135","9593.31","7194.99"
"244.3.160.204","34493","244.3.160.239","443","7","448","4","256","3","192","68.206362000","0.2135","9593.72","7195.29"
"244.3.160.204","42848","244.3.160.239","443","7","448","4","256","3","192","118.218709000","0.2134","9596.33","7197.24"
"244.3.3.145","14636","244.3.160.239","80","19","9878","8","1153","11","8725","202.629831000","0.2133","43246.08","327252.44"
"244.3.181.123","11333","244.3.160.239","80","12","2787","6","1278","6","1509","110.148716000","0.2131","47986.71","56660.36"
"41.177.34.163","45735","41.177.98.176","80","32","18121","16","3491","16","14630","233.107522000","0.2130","131132.15","549545.49"
"41.177.142.26","3973","244.3.41.84","23","4","256","2","128","2","128","153.477616000","0.2129","4809.68","4809.68"
"244.3.160.204","26474","244.3.160.239","443","7","448","4","256","3","192","20.197765000","0.2128","9622.25","7216.69"
"41.177.199.139","3979","244.3.160.239","80","12","2575","6","1284","6","1291","111.515118000","0.2128","48267.73","48530.87"
"244.3.160.204","24793","244.3.160.89","443","13","3841","5","362","8","3479","10.193221000","0.2128","13609.85","130797.46"
"244.3.181.123","3143","244.3.160.239","80","12","2739","6","1278","6","1461","110.149162000","0.2128","48049.63","54929.97"
"244.3.160.239","62430","41.177.254.197","80","13","4019","7","1312","6","2707","164.741403000","0.2127","49336.52","101794.18"
"244.3.160.204","31477","244.3.160.89","443","13","3841","5","362","8","3479","50.199810000","0.2125","13626.12","130953.78"
"244.3.160.204","46190","244.3.160.239","443","7","448","4","256","3","192","138.220493000","0.2125","9639.10","7229.32"
"244.3.160.204","59558","244.3.160.239","443","7","448","4","256","3","192","218.229644000","0.2125","9639.14","7229.36"
"253.160.251.90","1509","253.37.253.43","446","24","25362","0","0","24","25362","140.631421000","0.2124","N/A","955195.77"
"244.3.160.204","23120","244.3.160.89","443","13","3841","5","362","8","3479","0.191314000","0.2123","13639.60","131083.30"
"244.3.160.204","40173","244.3.160.239","443","7","448","4","256","3","192","102.217725000","0.2123","9646.14","7234.60"
"244.3.2.111","4599","244.3.210.197","80","23","16722","10","1972","13","14750","219.676959000","0.2123","74306.44","555791.06"
"244.3.160.204","47853","244.3.160.89","443","13","3841","5","362","8","3479","148.219312000","0.2121","13652.52","131207.51"
"244.3.181.123","10101","244.3.160.239","80","52","32371","19","2098","33","30273","130.344675000","0.2121","79136.59","1141897.98"
"244.3.160.204","57553","244.3.160.239","443","7","448","4","256","3","192","206.228787000","0.2121","9657.42","7243.06"
"244.3.160.239","62094","40.248.176.156","80","11","2211","6","1484","5","727","112.343300000","0.2120","56002.11","27435.00"
"41.177.168.181","9835","244.3.160.239","80","16","7020","7","1140","9","5880","78.432923000","0.2119","43033.69","221963.22"
"244.3.20.25","1966","244.3.41.84","23","4","256","2","128","2","128","153.468984000","0.2119","4832.10","4832.10"
"244.3.3.145","2409","244.3.160.239","80","12","2762","6","1015","6","1747","203.131617000","0.2119","38327.02","65967.78"
"244.3.160.204","56883","244.3.160.239","443","7","448","4","256","3","192","202.226957000","0.2118","9671.46","7253.60"
"244.3.160.204","36488","244.3.160.89","443","13","3841","5","362","8","3479","80.204108000","0.2117","13676.63","131439.26"
"244.3.160.239","62759","198.123.241.156","80","13","4233","7","1149","6","3084","228.703741000","0.2117","43419.73","116541.73"
"244.3.160.204","27465","244.3.160.89","443","13","3841","5","362","8","3479","26.195785000","0.2117","13680.32","131474.65"
"244.3.160.239","62648","177.124.75.164","80","18","9529","9","2247","9","7282","211.497930000","0.2117","84921.84","275211.76"
"244.3.160.204","58223","244.3.160.239","443","7","448","4","256","3","192","210.228713000","0.2117","9675.16","7256.37"
"244.3.160.204","39834","244.3.160.89","443","13","3841","5","362","8","3479","100.221293000","0.2116","13684.32","131513.17"
"244.3.160.239","62203","40.248.176.156","80","11","2226","6","1530","5","696","122.989849000","0.2115","57867.69","26324.13"
"244.3.160.204","51870","244.3.160.239","443","7","448","4","256","3","192","172.224253000","0.2115","9683.31","7262.48"
"244.3.160.239","62095","40.248.176.156","80","11","2203","6","1483","5","720","112.343304000","0.2114","56125.35","27248.99"
"41.177.142.244","4313","244.3.41.84","23","4","256","2","128","2","128","153.461156000","0.2114","4844.81","4844.81"
"68.33.186.67","12283","244.3.160.239","80","10","2350","5","1233","5","1117","91.969186000","0.2113","46672.50","42281.58"
"41.177.181.145","1148","244.3.41.84","23","4","256","2","128","2","128","153.463603000","0.2113","4846.10","4846.10"
"145.95.31.210","6937","244.3.160.239","80","58","38785","21","2334","37","36451","88.216170000","0.2110","88489.54","1381976.04"
"41.177.3.224","65138","41.177.117.184","1606","33","12693","18","6202","15","6491","93.461162000","0.2109","235236.11","246197.61"
"41.177.161.111","49878","244.3.41.84","23","4","256","2","128","2","128","153.467487000","0.2109","4855.57","4855.57"
"244.3.160.239","61460","177.124.75.164","80","15","4597","8","2261","7","2336","32.834373000","0.2107","85847.18","88694.83"
"244.3.160.204","41844","244.3.160.239","443","7","448","4","256","3","192","112.218423000","0.2106","9724.92","7293.69"
"244.3.160.239","62199","40.248.176.156","80","13","2920","7","1605","6","1315","122.686186000","0.2106","60979.08","49961.06"
"244.3.160.239","62097","40.248.176.156","80","13","3051","7","1580","6","1471","112.535713000","0.2105","60045.79","55903.39"
"41.177.211.185","2317","244.3.160.239","80","12","2280","6","1307","6","973","160.552648000","0.2104","49687.08","36989.69"
"244.3.160.204","53210","244.3.160.239","443","7","448","4","256","3","192","180.224916000","0.2104","9734.21","7300.66"
"244.3.160.239","61988","198.123.241.156","80","11","1769","6","1041","5","728","104.574274000","0.2103","39603.21","27695.61"
"244.3.160.204","58213","244.3.160.89","443","13","3841","5","362","8","3479","210.226011000","0.2103","13772.96","132365.04"
"244.3.160.204","50530","244.3.160.89","443","13","3841","5","362","8","3479","164.220699000","0.2103","13774.01","132375.11"
"244.3.3.145","8294","244.3.160.239","80","12","2060","6","1016","6","1044","203.022971000","0.2101","38678.42","39744.36"
"41.177.223.45","3871","244.3.160.239","80","9","1460","5","896","4","564","2.137023000","0.2101","34123.42","21479.48"
"244.3.160.204","41169","244.3.160.89","443","13","3841","5","362","8","3479","108.215967000","0.2097","13809.88","132719.77"
"77.197.210.217","32868","244.3.210.197","80","6","915","4","599","2","316","99.765646000","0.2097","22851.69","12055.32"
"244.3.160.204","52864","244.3.160.89","443","13","3841","5","362","8","3479","178.222152000","0.2094","13826.89","132883.26"
"244.3.160.204","54545","244.3.160.239","443","7","448","4","256","3","192","188.225688000","0.2094","9781.21","7335.91"
"244.3.160.239","61793","43.106.84.231","80","34","24089","14","1651","20","22438","78.099017000","0.2093","63108.91","857684.83"
"244.3.160.204","33489","244.3.160.239","443","7","448","4","256","3","192","62.204976000","0.2092","9788.65","7341.48"
"244.3.79.141","8679","244.3.160.239","80","52","32414","20","2507","32","29907","51.109579000","0.2091","95893.82","1143955.48"
"244.3.160.204","38841","244.3.160.239","443","7","448","4","256","3","192","94.210007000","0.2091","9792.44","7344.33"
"41.177.98.252","11393","244.3.160.239","80","13","6055","6","1203","7","4852","37.941611000","0.2090","46044.10","185707.38"
"244.3.160.204","42506","244.3.160.89","443","13","3841","5","362","8","3479","116.217065000","0.2089","13862.16","133222.28"
"41.194.210.239","59427","41.177.98.143","8001","3","298","2","158","1","140","211.648317000","0.2087","6056.51","N/A"
"244.3.160.204","56540","244.3.160.89","443","13","3841","5","362","8","3479","200.223737000","0.2084","13896.89","133555.99"
"244.3.181.123","10126","244.3.160.239","80","12","2548","6","1283","6","1265","110.986633000","0.2083","49271.06","48579.81"
"244.3.160.239","61867","244.3.31.75","80","43","35740","17","1976","26","33764","88.218436000","0.2083","75894.91","1296819.79"
"41.177.192.117","10374","244.3.160.239","80","13","3662","6","1182","7","2480","164.746224000","0.2082","45425.50","95309.01"
"244.3.160.204","43854","244.3.160.239","443","7","448","4","256","3","192","124.219390000","0.2081","9839.86","7379.90"
"244.3.160.204","49868","244.3.160.239","443","7","448","4","256","3","192","160.222422000","0.2080","9846.72","7385.04"
"244.3.160.239","61792","43.106.84.231","80","32","22102","13","1586","19","20516","77.916134000","0.2079","61025.82","789410.90"
"41.177.241.61","18288","244.3.41.84","23","4","256","2","128","2","128","153.472558000","0.2079","4925.90","4925.90"
"244.3.160.204","54537","244.3.160.89","443","13","3841","5","362","8","3479","188.223467000","0.2079","13931.38","133887.51"
"244.3.160.204","50189","244.3.160.89","443","13","3841","5","362","8","3479","162.219737000","0.2078","13936.21","133933.90"
"244.3.160.204","52540","244.3.160.239","443","7","448","4","256","3","192","176.224787000","0.2078","9856.63","7392.47"
"244.3.160.204","56552","244.3.160.239","443","7","448","4","256","3","192","200.226977000","0.2076","9865.08","7398.81"
"244.3.160.239","62649","177.124.75.164","80","16","7146","8","2183","8","4963","211.507862000","0.2076","84141.55","191293.87"
"244.3.160.204","45178","244.3.160.89","443","13","3841","5","362","8","3479","132.217585000","0.2074","13965.11","134211.62"
"244.3.160.204","55200","244.3.160.89","443","13","3841","5","362","8","3479","192.222692000","0.2073","13973.06","134288.03"
"244.3.160.204","62235","244.3.160.239","443","7","448","4","256","3","192","234.232153000","0.2072","9883.65","7412.73"
"244.3.253.224","4821","244.3.160.239","80","12","3359","6","1418","6","1941","217.638981000","0.2069","54827.62","75049.66"
"244.3.160.204","37170","244.3.160.239","443","7","448","4","256","3","192","84.207970000","0.2066","9910.86","7433.15"
"41.177.3.224","51336","41.177.117.184","1618","28","12411","15","7298","13","5113","35.326200000","0.2066","282588.91","197982.61"
"41.177.199.139","6124","244.3.160.239","80","10","2013","5","1072","5","941","95.953005000","0.2066","41519.21","36445.50"
"41.177.161.13","2008","244.3.41.84","23","4","256","2","128","2","128","32.468186000","0.2065","4958.19","4958.19"
"244.3.3.145","5695","244.3.160.239","80","15","4909","7","1282","8","3627","203.536749000","0.2065","49677.41","140545.99"
"244.3.160.204","27144","244.3.160.239","443","7","448","4","256","3","192","24.198819000","0.2064","9922.82","7442.11"
"244.3.160.204","41832","244.3.160.89","443","13","3841","5","362","8","3479","112.215273000","0.2063","14036.86","134901.17"
"244.3.160.204","49198","244.3.160.239","443","7","448","4","256","3","192","156.222623000","0.2061","9936.44","7452.33"
"244.3.160.204","43505","244.3.160.89","443","13","3841","5","362","8","3479","122.216498000","0.2061","14053.34","135059.59"
"244.3.77.218","5461","244.3.160.239","80","10","1607","5","1167","5","440","8.281695000","0.2061","45306.53","17082.15"
"151.77.185.176","4989","244.3.160.239","80","133","100811","40","3713","93","97098","38.937470000","0.2060","144192.07","3770741.20"
"41.177.230.224","36968","244.3.31.124","443","20","3915","11","1228","9","2687","76.628289000","0.2060","47689.09","104349.01"
"244.3.160.239","61217","128.71.90.164","80","12","5843","5","320","7","5523","0.068312000","0.2060","12428.93","214515.64"
"244.3.160.204","55874","244.3.160.89","443","13","3841","5","362","8","3479","196.224559000","0.2058","14069.25","135212.47"
"244.3.160.204","40833","244.3.160.89","443","13","3841","5","362","8","3479","106.215903000","0.2058","14072.67","135245.32"
"244.3.160.204","52211","244.3.160.239","80","7","448","4","256","3","192","174.224965000","0.2057","9953.83","7465.37"
"68.157.15.122","34331","41.177.26.46","80","7","982","4","594","3","388","230.055772000","0.2057","23098.68","15088.03"
"244.3.160.239","62264","40.248.176.156","80","13","2867","7","1551","6","1316","138.608836000","0.2057","60333.47","51192.03"
"244.3.160.204","33158","244.3.160.239","443","7","448","4","256","3","192","60.205635000","0.2056","9962.64","7471.98"
"244.3.77.218","1200","244.3.41.84","23","4","256","2","128","2","128","153.461667000","0.2053","4987.36","4987.36"
"244.3.160.239","62207","40.248.176.156","80","13","3115","7","1588","6","1527","123.283868000","0.2053","61878.97","59502.01"
"77.197.210.159","57420","41.177.26.15","80","7","1015","4","624","3","391","162.816803000","0.2052","24325.47","15242.40"
"244.3.160.204","43846","244.3.160.89","443","13","3841","5","362","8","3479","124.217275000","0.2052","14116.43","135665.92"
"244.3.160.204","37835","244.3.160.239","443","7","448","4","256","3","192","88.208890000","0.2051","9986.35","7489.76"
"244.3.160.204","49190","244.3.160.89","443","13","3841","5","362","8","3479","156.220436000","0.2051","14122.90","135728.11"
"41.177.199.139","13098","244.3.160.239","80","18","7322","8","1258","10","6064","96.627062000","0.2049","49116.16","236757.08"
"244.3.160.204","44507","244.3.160.89","443","13","3841","5","362","8","3479","128.217073000","0.2048","14142.01","135911.71"
"244.3.160.239","61901","40.248.176.156","80","11","2254","6","1342","5","912","97.082959000","0.2047","52438.77","35636.48"
"244.3.160.204","53880","244.3.160.239","443","7","448","4","256","3","192","184.225322000","0.2046","10008.55","7506.41"
"244.3.160.204","42173","244.3.160.89","443","13","3841","5","362","8","3479","114.216073000","0.2045","14163.45","136117.77"
"77.197.210.122","19202","41.177.26.176","80","18","11885","6","384","12","11501","0.554750000","0.2044","15028.18","450101.75"
"41.177.199.139","13504","244.3.160.239","80","14","5113","6","1132","8","3981","97.328838000","0.2042","44347.16","155959.39"
"244.3.77.218","3034","244.3.160.239","80","12","1940","6","1180","6","760","5.267456000","0.2040","46263.85","29797.06"
"41.194.123.57","50342","41.177.98.143","8001","3","298","2","158","1","140","37.559732000","0.2040","6197.51","N/A"
"244.3.160.204","60895","244.3.160.239","443","7","448","4","256","3","192","226.232025000","0.2039","10042.61","7531.96"
"244.3.160.204","53202","244.3.160.89","443","13","3841","5","362","8","3479","180.222796000","0.2039","14203.74","136504.98"
"244.3.160.204","39172","244.3.160.239","443","7","448","4","256","3","192","96.210220000","0.2039","10045.96","7534.47"
"244.3.160.239","61973","40.248.176.156","80","13","4333","7","1391","6","2942","103.863161000","0.2037","54626.68","115536.79"
"244.3.160.204","36500","244.3.160.239","443","7","448","4","256","3","192","80.207284000","0.2036","10057.90","7543.43"
"41.177.34.163","45736","41.177.98.176","80","16","7987","8","3009","8","4978","233.107860000","0.2036","118224.86","195587.69"
"41.177.223.45","12177","244.3.160.239","80","9","1460","5","896","4","564","2.171031000","0.2036","35210.96","22164.04"
"244.3.160.239","61757","244.3.31.75","80","34","26660","14","1900","20","24760","69.109377000","0.2036","74671.59","973088.75"
"244.3.160.204","47517","244.3.160.89","443","13","3841","5","362","8","3479","146.219098000","0.2035","14228.72","136745.08"
"244.3.160.239","62204","40.248.176.156","80","11","2381","6","1530","5","851","123.141392000","0.2035","60142.40","33451.75"
"244.3.160.204","46180","244.3.160.89","443","13","3841","5","362","8","3479","138.217825000","0.2035","14231.45","136771.29"
"244.3.160.239","62741","197.154.128.197","80","37","28877","16","2144","21","26733","225.296167000","0.2035","84298.27","1051094.03"
"244.3.160.239","62538","40.248.176.156","80","11","1995","6","1549","5","446","196.537125000","0.2034","60911.11","17538.00"
"244.3.160.239","61828","197.154.128.197","80","14","5162","8","1245","6","3917","79.081146000","0.2034","48964.18","154050.36"
"244.3.160.239","62284","40.248.176.156","80","11","2020","6","1574","5","446","140.105145000","0.2034","61907.27","17541.70"
"244.3.160.239","62449","41.177.254.197","80","53","40764","21","2910","32","37854","170.842817000","0.2034","114475.66","1489127.76"
"244.3.160.239","62265","40.248.176.156","80","11","2313","6","1477","5","836","138.610519000","0.2033","58132.73","32903.83"
"244.3.160.239","62431","41.177.254.197","80","13","3747","7","1312","6","2435","164.751444000","0.2032","51653.80","95866.61"
"244.3.181.123","3806","244.3.160.239","80","12","2673","6","1284","6","1389","111.637475000","0.2031","50587.53","54724.36"
"244.3.160.204","52205","244.3.160.254","4000","7","448","4","256","3","192","174.223362000","0.2030","10088.67","7566.50"
"244.3.160.204","59894","244.3.160.239","443","7","448","4","256","3","192","220.230766000","0.2030","10089.91","7567.43"
"244.3.160.239","61899","40.248.176.156","80","13","3125","7","1400","6","1725","96.938580000","0.2029","55195.53","68008.77"
"41.177.3.224","51330","41.177.117.184","1618","70","34622","35","17172","35","17450","85.909286000","0.2029","677105.98","688067.74"
"244.3.160.204","47184","244.3.160.89","443","13","3841","5","362","8","3479","144.217512000","0.2028","14278.74","137225.80"
"244.3.160.204","48857","244.3.160.89","443","13","3841","5","362","8","3479","154.219119000","0.2027","14289.45","137328.72"
"244.3.160.239","62456","40.248.176.156","80","11","1981","6","1535","5","446","175.451942000","0.2027","60596.19","17606.45"
"41.177.98.143","8001","244.239.193.77","4670","3","298","1","140","2","158","16.781774000","0.2025","N/A","6240.96"
"244.3.181.123","7941","244.3.160.239","80","12","2060","6","1275","6","785","111.638026000","0.2025","50370.62","31012.50"
"244.3.160.239","62258","40.248.176.156","80","11","2208","6","1475","5","733","138.149353000","0.2024","58306.16","28975.20"
"244.3.160.239","62194","40.248.176.156","80","13","4148","7","1608","6","2540","122.131697000","0.2023","63594.70","100454.32"
"244.3.160.239","61731","244.3.31.75","80","34","26660","14","1900","20","24760","64.611901000","0.2023","75153.40","979367.43"
"244.3.160.204","54201","244.3.160.89","443","13","3841","5","362","8","3479","186.223336000","0.2022","14320.97","137631.60"
"41.177.98.220","7020","244.3.185.64","1659","3","391","1","134","2","257","0.636978000","0.2022","N/A","10169.01"
"244.3.160.204","32157","244.3.160.239","443","7","448","4","256","3","192","54.202857000","0.2021","10131.14","7598.36"
"244.3.160.239","62282","40.248.176.156","80","11","2025","6","1580","5","445","139.825522000","0.2021","62555.37","17618.44"
"244.3.160.239","62259","40.248.176.156","80","11","1980","6","1535","5","445","138.306869000","0.2020","60778.54","17619.84"
"41.177.67.85","2244","244.3.41.84","23","4","256","2","128","2","128","32.447356000","0.2020","5069.11","5069.11"
"244.3.160.204","52202","244.3.160.89","80","7","448","4","256","3","192","174.222559000","0.2018","10147.35","7610.52"
"244.3.160.239","61891","40.248.176.156","80","11","1966","6","1054","5","912","96.023120000","0.2018","41791.81","36161.42"
"41.177.176.156","14637","244.3.160.239","80","10","2087","5","1565","5","522","157.025143000","0.2017","62063.15","20700.94"
"244.3.160.239","61861","117.246.95.43","80","12","1907","7","1208","5","699","87.775111000","0.2017","47922.25","27729.84"
"244.3.160.204","48528","244.3.160.239","443","7","448","4","256","3","192","152.221931000","0.2014","10168.92","7626.69"
"244.3.160.204","57222","244.3.160.239","443","7","448","4","256","3","192","204.227678000","0.2014","10169.73","7627.30"
"244.3.160.239","62461","40.248.176.156","80","11","1995","6","1550","5","445","175.870545000","0.2013","61585.53","17681.01"
"244.3.181.123","7273","244.3.160.239","80","96","64733","33","2118","63","62615","0.427691000","0.2013","84156.57","2487943.22"
"244.3.160.204","42183","244.3.160.239","443","7","448","4","256","3","192","114.218750000","0.2013","10172.45","7629.34"
"244.3.160.239","62465","40.248.176.156","80","11","1998","6","1552","5","446","176.153827000","0.2013","61680.92","17725.32"
"41.177.223.45","12223","244.3.160.239","80","10","4589","4","256","6","4333","1.124241000","0.2013","10175.94","172235.78"
"244.3.160.204","52874","244.3.160.239","443","7","448","4","256","3","192","178.224771000","0.2012","10178.32","7633.74"
"244.3.160.204","51862","244.3.160.89","443","13","3841","5","362","8","3479","172.222127000","0.2011","14400.44","138395.37"
"244.3.160.204","30817","244.3.160.239","443","7","448","4","256","3","192","46.201990000","0.2011","10186.42","7639.81"
"244.3.160.204","61565","244.3.160.239","443","7","448","4","256","3","192","230.232512000","0.2010","10191.23","7643.43"
"244.3.160.239","61902","40.248.176.156","80","13","3944","7","1405","6","2539","97.083861000","0.2009","55941.83","101093.45"
"244.3.160.239","62188","40.248.176.156","80","13","3328","7","1603","6","1725","121.834832000","0.2008","63849.91","68709.36"
"244.3.160.239","62460","40.248.176.156","80","11","1992","6","1547","5","445","175.735734000","0.2008","61620.58","17725.38"
"244.3.160.239","62187","40.248.176.156","80","11","2262","6","1529","5","733","121.784511000","0.2008","60904.20","29197.37"
"244.3.160.204","45525","244.3.160.239","443","7","448","4","256","3","192","134.220310000","0.2008","10200.42","7650.32"
"244.3.160.204","50199","244.3.160.239","443","7","448","4","256","3","192","162.222416000","0.2008","10201.39","7651.04"
"244.3.160.204","45844","244.3.160.89","443","13","3841","5","362","8","3479","136.217733000","0.2008","14425.83","138639.41"
"168.22.164.224","11582","244.3.160.239","80","12","2734","6","2161","6","573","119.173227000","0.2007","86145.38","22841.88"
"244.3.160.239","62535","40.248.176.156","80","11","1995","6","1549","5","446","196.396384000","0.2006","61760.82","17782.65"
"244.3.160.239","61904","40.248.176.156","80","13","2392","7","1397","6","995","97.188097000","0.2006","55708.42","39677.79"
"244.3.181.123","2640","244.3.160.239","80","12","2065","6","1263","6","802","111.445833000","0.2006","50367.39","31983.09"
"244.3.181.123","3829","244.3.160.239","80","34","18331","13","1963","21","16368","2.697640000","0.2006","78286.71","652774.73"
"41.177.124.47","14577","244.3.160.239","80","38","29033","14","2126","24","26907","225.292372000","0.2006","84795.37","1073183.86"
"244.3.160.239","62775","40.248.176.156","80","11","1972","6","1527","5","445","231.807257000","0.2005","60939.23","17758.98"
"244.3.160.204","40843","244.3.160.239","443","7","448","4","256","3","192","106.218563000","0.2004","10218.90","7664.17"
"122.155.141.12","8780","244.3.160.239","80","15","2419","8","1449","7","970","160.340495000","0.2004","57842.87","38721.59"
"41.177.181.38","1117","244.3.41.84","23","4","256","2","128","2","128","153.468292000","0.2002","5114.94","5114.94"
"244.3.160.204","52528","244.3.160.89","443","13","3841","5","362","8","3479","176.221646000","0.2002","14465.75","139023.06"
"244.3.160.239","62463","40.248.176.156","80","11","2002","6","1558","5","444","176.009281000","0.2002","62264.90","17744.30"
"244.3.160.239","62779","40.248.176.156","80","11","1967","6","1521","5","446","232.089003000","0.2002","60790.46","17825.47"
"244.3.160.239","62765","40.248.176.156","80","11","1982","6","1535","5","447","230.776300000","0.2001","61369.01","17870.98"
"244.3.160.239","62466","40.248.176.156","80","11","1995","6","1550","5","445","176.154938000","0.2000","62001.55","17800.45"
"244.3.160.239","61909","40.248.176.156","80","13","3094","7","1397","6","1697","97.687413000","0.2000","55883.91","67884.75"
"244.3.160.239","62071","40.248.176.156","80","13","4076","7","1539","6","2537","111.372974000","0.2000","61568.31","101493.70"
"244.3.160.204","40512","244.3.160.239","443","7","448","4","256","3","192","104.217727000","0.2000","10241.49","7681.11"
"41.177.98.143","8001","186.45.149.203","2084","3","328","1","152","2","176","211.994022000","0.2000","N/A","7041.69"
"244.3.77.218","9365","244.3.160.239","80","10","1713","5","1273","5","440","157.835734000","0.1998","50962.04","17614.53"
"244.3.160.239","62776","40.248.176.156","80","11","1972","6","1527","5","445","231.947260000","0.1998","61135.63","17816.21"
"244.3.160.239","62464","40.248.176.156","80","11","1987","6","1542","5","445","176.011722000","0.1997","61761.83","17823.62"
"244.3.160.239","62270","40.248.176.156","80","11","2023","6","1579","5","444","138.981961000","0.1997","63254.88","17786.68"
"244.3.160.239","62278","40.248.176.156","80","11","2014","6","1567","5","447","139.404138000","0.1996","62800.26","17914.31"
"244.3.160.239","62454","40.248.176.156","80","11","2000","6","1555","5","445","175.174930000","0.1996","62324.34","17835.58"
"122.155.141.12","6754","244.3.160.239","80","15","3012","8","1450","7","1562","160.340550000","0.1995","58152.94","62644.76"
"244.3.181.123","4215","244.3.160.239","80","46","27877","17","2206","29","25671","0.435490000","0.1995","88476.68","1029594.16"
"41.177.211.185","7749","244.3.160.239","80","92","83447","31","2911","61","80536","160.453770000","0.1994","116766.95","3230485.36"
"41.177.124.47","10513","244.3.160.239","80","12","2414","6","1698","6","716","214.468242000","0.1994","68115.49","28722.43"
"244.3.77.194","4527","244.3.41.84","23","4","769","2","132","2","637","189.651708000","0.1994","5295.30","25553.85"
"244.3.160.239","62268","40.248.176.156","80","11","2035","6","1588","5","447","138.842543000","0.1994","63708.26","17932.99"
"244.3.160.239","62458","40.248.176.156","80","11","2000","6","1554","5","446","175.598351000","0.1993","62378.95","17902.84"
"244.3.160.239","62067","40.248.176.156","80","13","3255","7","1545","6","1710","111.133513000","0.1993","62027.64","68651.95"
"244.3.160.239","62477","40.248.176.156","80","11","1996","6","1550","5","446","176.848152000","0.1993","62229.63","17906.07"
"244.3.160.204","31487","244.3.160.239","443","7","448","4","256","3","192","50.202522000","0.1993","10277.98","7708.48"
"244.3.160.239","62475","40.248.176.156","80","11","1998","6","1552","5","446","176.710853000","0.1993","62311.49","17906.52"
"244.3.160.239","62280","40.248.176.156","80","11","2026","6","1581","5","445","139.686481000","0.1992","63482.82","17868.35"
"244.3.160.239","62476","40.248.176.156","80","11","1996","6","1550","5","446","176.714090000","0.1992","62239.31","17908.86"
"41.177.199.139","7560","244.3.160.239","80","12","2572","6","1286","6","1286","138.606694000","0.1992","51651.51","51651.51"
"244.3.160.239","62774","40.248.176.156","80","11","1973","6","1528","5","445","231.806737000","0.1991","61397.52","17880.82"
"244.3.160.239","62767","40.248.176.156","80","11","1982","6","1536","5","446","230.998190000","0.1991","61719.28","17921.09"
"244.3.160.239","62777","40.248.176.156","80","11","1967","6","1521","5","446","231.948340000","0.1990","61141.12","17928.30"
"244.3.160.239","62471","40.248.176.156","80","11","1996","6","1551","5","445","176.437336000","0.1990","62350.19","17889.00"
"244.3.160.204","55541","244.3.160.89","443","13","3841","5","362","8","3479","194.223514000","0.1990","14552.62","139857.89"
"244.3.160.239","61235","85.241.98.37","80","25","17411","11","1777","14","15634","0.856067000","0.1990","71443.65","628559.37"
"244.3.160.239","62778","40.248.176.156","80","11","1967","6","1522","5","445","232.088308000","0.1989","61212.69","17897.27"
"244.3.160.239","62772","40.248.176.156","80","11","1984","6","1538","5","446","231.666412000","0.1989","61865.83","17940.29"
"244.3.160.204","24803","244.3.160.239","443","7","448","4","256","3","192","10.195855000","0.1988","10299.32","7724.49"
"244.3.160.204","46526","244.3.160.239","443","7","448","4","256","3","192","140.221045000","0.1988","10303.73","7727.80"
"244.3.160.239","62260","40.248.176.156","80","11","1986","6","1540","5","446","138.307877000","0.1986","62020.81","17961.87"
"244.3.160.239","62462","40.248.176.156","80","11","1997","6","1551","5","446","175.874787000","0.1986","62477.97","17965.94"
"244.3.160.204","29816","244.3.160.239","443","7","448","4","256","3","192","40.201451000","0.1986","10314.42","7735.81"
"244.3.160.239","62273","40.248.176.156","80","11","2035","6","1589","5","446","139.114527000","0.1985","64032.24","17972.55"
"244.3.160.204","48516","244.3.160.89","443","13","3841","5","362","8","3479","152.218747000","0.1985","14591.04","140227.13"
"244.3.160.239","62455","40.248.176.156","80","11","2001","6","1555","5","446","175.313494000","0.1985","62678.23","17977.17"
"244.3.160.239","62468","40.248.176.156","80","11","1996","6","1551","5","445","176.293682000","0.1985","62521.10","17938.03"
"244.3.160.239","62474","40.248.176.156","80","11","2001","6","1556","5","445","176.576173000","0.1984","62727.39","17939.39"
"244.3.160.239","62275","40.248.176.156","80","11","1966","6","1521","5","445","139.158148000","0.1984","61325.08","17941.92"
"244.3.160.239","61908","40.248.176.156","80","13","3094","7","1397","6","1697","97.538466000","0.1984","56333.20","68430.52"
"244.3.160.239","62272","40.248.176.156","80","11","1965","6","1520","5","445","139.009275000","0.1983","61309.79","17949.25"
"244.3.160.239","62283","40.248.176.156","80","11","2024","6","1580","5","444","139.966721000","0.1983","63730.88","17909.18"
"41.177.192.117","4408","244.3.160.239","80","12","2665","6","1224","6","1441","164.975261000","0.1983","49373.75","58127.11"
"244.3.160.239","62263","40.248.176.156","80","11","1960","6","1513","5","447","138.464490000","0.1983","61036.37","18032.56"
"244.3.160.239","62277","40.248.176.156","80","11","2040","6","1594","5","446","139.252978000","0.1982","64331.59","17999.93"
"244.3.160.204","46518","244.3.160.89","443","13","3841","5","362","8","3479","140.218867000","0.1982","14610.25","140411.77"
"244.3.56.90","9941","244.3.160.239","80","9","2131","5","1589","4","542","14.897171000","0.1981","64157.30","21883.74"
"244.3.160.239","62771","40.248.176.156","80","11","1961","6","1514","5","447","231.487711000","0.1981","61153.49","18055.23"
"244.3.160.239","62472","40.248.176.156","80","11","1995","6","1550","5","445","176.438976000","0.1980","62623.73","17979.07"
"41.177.199.139","3592","244.3.160.239","80","12","2141","6","1276","6","865","138.608490000","0.1980","51558.94","34951.79"
"244.3.160.239","62276","40.248.176.156","80","11","1965","6","1520","5","445","139.223424000","0.1979","61431.21","17984.79"
"41.177.43.119","1432","244.3.41.84","23","4","256","2","128","2","128","153.470487000","0.1979","5173.26","5173.26"
"244.3.160.239","62459","40.248.176.156","80","11","2000","6","1554","5","446","175.733593000","0.1979","62818.34","18028.94"
"244.3.160.204","38502","244.3.160.239","443","7","448","4","256","3","192","92.209141000","0.1978","10353.00","7764.75"
"244.3.160.204","26138","244.3.160.239","443","7","448","4","256","3","192","18.196640000","0.1977","10356.56","7767.42"
"244.3.160.239","62773","40.248.176.156","80","11","1972","6","1528","5","444","231.667979000","0.1977","61818.24","17962.89"
"244.3.160.239","62279","40.248.176.156","80","11","2037","6","1591","5","446","139.548017000","0.1977","64373.54","18045.63"
"244.3.90.194","1594","244.3.41.84","23","4","256","2","128","2","128","32.461745000","0.1977","5180.85","5180.85"
"244.3.160.204","50869","244.3.160.239","443","7","448","4","256","3","192","166.223161000","0.1976","10362.48","7771.86"
"244.3.160.239","62473","40.248.176.156","80","11","1997","6","1551","5","446","176.573855000","0.1976","62782.72","18053.57"
"244.3.160.239","62766","40.248.176.156","80","11","1970","6","1526","5","444","230.923565000","0.1976","61773.25","17973.34"
"41.177.223.45","3132","244.3.160.239","80","11","4988","4","256","7","4732","1.129447000","0.1976","10364.37","191578.95"
"244.3.160.239","62457","40.248.176.156","80","11","1997","6","1553","5","444","175.597025000","0.1974","62941.07","17994.74"
"244.3.160.239","62453","40.248.176.156","80","11","1979","6","1533","5","446","175.032506000","0.1972","62184.36","18091.47"
"244.3.160.239","62452","40.248.176.156","80","11","1994","6","1548","5","446","174.895004000","0.1972","62795.05","18092.11"
"244.3.160.204","55551","244.3.160.239","443","7","448","4","256","3","192","194.226222000","0.1972","10387.13","7790.35"
"244.3.160.204","47527","244.3.160.239","443","7","448","4","256","3","192","146.221729000","0.1972","10387.19","7790.39"
"244.3.160.239","62768","40.248.176.156","80","11","1987","6","1541","5","446","231.116101000","0.1971","62533.29","18098.54"
"244.3.181.123","8405","244.3.160.239","80","18","8153","8","1635","10","6518","2.740396000","0.1971","66354.51","264525.19"
"244.3.160.204","53868","244.3.160.89","443","13","3841","5","362","8","3479","184.222137000","0.1970","14697.82","141253.38"
"244.3.160.204","44845","244.3.160.89","443","13","3841","5","362","8","3479","130.217601000","0.1970","14698.34","141258.39"
"244.3.160.239","62467","40.248.176.156","80","11","1994","6","1550","5","444","176.293012000","0.1970","62934.90","18027.80"
"244.3.181.123","15971","244.3.160.239","80","12","2557","6","1267","6","1290","108.798935000","0.1970","51464.58","52398.82"
"244.3.181.123","8819","244.3.160.239","80","12","1974","6","1266","6","708","108.798365000","0.1969","51446.16","28770.84"
"244.3.160.239","62647","177.124.75.164","80","13","3412","7","2077","6","1335","211.156911000","0.1969","84408.59","54253.96"
"41.197.164.47","1212","244.3.41.84","23","4","256","2","128","2","128","153.480061000","0.1968","5202.01","5202.01"
"244.3.160.204","28145","244.3.160.239","443","7","448","4","256","3","192","30.199038000","0.1968","10404.28","7803.21"
"244.3.181.123","11134","244.3.160.239","80","12","2055","6","1262","6","793","108.598925000","0.1967","51314.11","32244.13"
"151.77.217.75","6120","244.3.160.239","80","13","3036","7","1440","6","1596","104.347630000","0.1965","58615.51","64965.53"
"244.3.160.239","62257","40.248.176.156","80","11","1981","6","1534","5","447","138.148660000","0.1963","62508.60","18214.70"
"244.3.160.204","46857","244.3.160.239","443","7","448","4","256","3","192","142.221608000","0.1962","10436.95","7827.71"
"244.3.181.123","10857","244.3.160.239","80","12","1972","6","1266","6","706","108.599464000","0.1962","51617.11","28784.90"
"244.3.160.204","27475","244.3.160.239","443","7","448","4","256","3","192","26.198382000","0.1962","10439.55","7829.66"
"244.3.160.239","62677","197.154.128.197","80","10","2265","6","1588","4","677","214.472087000","0.1961","64790.21","27621.52"
"244.3.160.239","62438","41.177.254.197","80","10","2621","6","1290","4","1331","164.978263000","0.1961","52638.02","54311.01"
"244.3.160.204","54211","244.3.160.239","443","7","448","4","256","3","192","186.226035000","0.1960","10450.42","7837.81"
"244.3.160.204","40500","244.3.160.89","443","13","3841","5","362","8","3479","104.214548000","0.1957","14799.22","142227.85"
"244.3.160.204","43172","244.3.160.89","443","13","3841","5","362","8","3479","120.216037000","0.1955","14810.04","142331.87"
"244.3.34.61","1065","244.3.41.84","23","4","256","2","128","2","128","32.449796000","0.1955","5237.66","5237.66"
"244.3.160.239","62414","41.177.254.197","80","16","6800","8","1362","8","5438","163.764571000","0.1954","55775.10","222690.88"
"90.218.193.20","11972","244.3.160.239","80","12","2710","6","1283","6","1427","105.249392000","0.1953","52558.81","58457.85"
"244.3.160.204","44855","244.3.160.239","443","7","448","4","256","3","192","130.220194000","0.1951","10499.39","7874.54"
"41.177.223.45","12725","244.3.160.239","80","10","4608","4","256","6","4352","1.130189000","0.1949","10508.65","178647.11"
"244.3.160.204","53541","244.3.160.239","443","7","448","4","256","3","192","182.224929000","0.1949","10509.03","7881.77"
"244.3.160.204","49856","244.3.160.89","443","13","3841","5","362","8","3479","160.219259000","0.1946","14880.20","143006.15"
"244.3.160.239","61952","198.123.241.156","80","11","1660","6","1216","5","444","102.139752000","0.1946","49988.44","18252.36"
"244.3.160.204","42514","244.3.160.239","443","7","448","4","256","3","192","116.219234000","0.1945","10529.08","7896.81"
"41.177.244.39","2006","244.3.210.197","80","6","1459","4","1143","2","316","201.758113000","0.1945","47019.38","12999.23"
"41.177.98.252","5262","244.3.160.239","80","16","8781","7","1282","9","7499","44.609756000","0.1944","52763.44","308637.34"
"244.3.160.239","62435","41.177.254.197","80","10","2392","6","1249","4","1143","164.872438000","0.1943","51415.31","47051.80"
"244.3.160.239","61864","117.246.95.43","80","10","1580","6","1038","4","542","87.974970000","0.1942","42749.92","22322.21"
"244.3.160.204","35499","244.3.160.239","443","7","448","4","256","3","192","74.206541000","0.1940","10557.46","7918.10"
"41.177.223.45","12028","244.3.160.239","80","11","5808","4","256","7","5552","1.131900000","0.1940","10558.17","228980.32"
"244.3.160.239","61390","198.123.241.156","80","11","1664","6","1220","5","444","24.099461000","0.1935","50430.15","18353.27"
"244.3.164.46","4532","244.3.160.239","80","45","26608","17","1878","28","24730","153.168619000","0.1935","77647.82","1022487.07"
"41.177.13.246","1741","244.3.41.84","23","4","256","2","128","2","128","32.461002000","0.1933","5297.44","5297.44"
"244.3.155.77","11084","244.3.160.239","80","15","4132","8","3307","7","825","57.829042000","0.1932","136937.24","34161.84"
"244.3.160.204","25473","244.3.160.239","443","7","448","4","256","3","192","14.196353000","0.1931","10604.42","7953.32"
"41.177.223.45","9044","244.3.160.239","80","11","5311","4","256","7","5055","1.133683000","0.1931","10608.32","209472.90"
"244.3.160.239","62309","198.123.241.156","80","11","1944","6","1500","5","444","148.001369000","0.1929","62200.01","18411.20"
"244.3.160.239","61355","177.124.75.164","80","16","6932","8","2521","8","4411","15.462629000","0.1929","104573.27","182972.10"
"41.177.192.117","11740","244.3.160.239","80","12","2007","6","1399","6","608","176.390777000","0.1925","58131.80","25263.86"
"41.177.223.45","4221","244.3.160.239","80","13","4009","6","994","7","3015","6.407692000","0.1923","41351.62","125427.71"
"90.38.138.255","8362","244.3.160.239","80","10","1551","5","1111","5","440","102.099507000","0.1922","46250.72","18317.12"
"244.3.160.204","39842","244.3.160.239","443","7","448","4","256","3","192","100.223984000","0.1922","10658.06","7993.55"
"41.177.192.117","5410","244.3.160.239","80","22","13098","9","1537","13","11561","176.391777000","0.1921","64008.66","481460.08"
"145.95.75.108","1137","244.3.41.84","23","4","256","2","128","2","128","153.482061000","0.1915","5347.48","5347.48"
"244.3.160.239","62325","85.241.98.37","80","25","16975","11","1341","14","15634","153.547799000","0.1914","56044.30","653390.45"
"244.3.160.239","61605","177.124.75.164","80","13","3305","7","2367","6","938","52.344893000","0.1914","98952.26","39213.02"
"77.197.210.186","7766","41.177.26.46","80","7","919","4","564","3","355","11.722214000","0.1912","23597.46","14853.01"
"41.177.199.139","10676","244.3.160.239","80","10","1678","5","1261","5","417","230.920768000","0.1909","52848.02","17476.31"
"244.3.31.181","50063","41.177.98.220","7030","4","256","2","128","2","128","163.919739000","0.1908","5367.33","5367.33"
"244.3.160.204","58893","244.3.160.239","443","7","448","4","256","3","192","214.229480000","0.1908","10735.83","8051.88"
"244.3.160.204","45856","244.3.160.239","443","7","448","4","256","3","192","136.220918000","0.1905","10749.19","8061.89"
"244.3.160.239","61583","177.124.75.164","80","13","3137","7","2367","6","770","50.505540000","0.1904","99473.63","32359.40"
"244.3.160.239","61452","117.246.95.43","80","14","3686","8","2893","6","793","31.822536000","0.1902","121698.44","33358.75"
"244.3.160.204","60225","244.3.160.239","443","7","448","4","256","3","192","222.230453000","0.1900","10778.66","8084.00"
"41.177.98.220","7080","41.177.22.92","1255","3","316","1","128","2","188","96.368144000","0.1900","N/A","7916.50"
"244.3.160.239","62730","41.43.180.128","80","11","2561","6","1493","5","1068","222.866727000","0.1899","62880.37","44980.73"
"244.3.160.239","62228","48.151.224.205","80","10","1966","6","1553","4","413","133.098064000","0.1897","65490.47","17416.33"
"244.3.160.239","61594","177.124.75.164","80","13","3670","7","2367","6","1303","51.335528000","0.1896","99898.18","54992.54"
"41.177.192.117","9223","244.3.160.239","80","13","3542","6","1130","7","2412","164.765310000","0.1894","47719.59","101858.11"
"244.3.160.204","57887","244.3.160.239","443","7","448","4","256","3","192","208.227727000","0.1893","10816.86","8112.65"
"244.3.160.239","61830","43.106.84.231","80","13","1957","7","1232","6","725","79.128893000","0.1893","52057.53","30634.50"
"41.177.98.143","8001","244.145.41.106","4252","3","298","1","140","2","158","181.219442000","0.1893","N/A","6676.28"
"244.3.160.239","62342","85.241.98.37","80","25","17473","11","1475","14","15998","155.262739000","0.1893","62327.02","676005.16"
"41.177.211.185","5828","244.3.160.239","80","12","2314","6","1346","6","968","177.934194000","0.1892","56904.00","40923.53"
"244.3.160.204","23802","244.3.160.239","443","7","448","4","256","3","192","4.194636000","0.1891","10827.56","8120.67"
"244.3.160.239","62469","41.177.254.197","80","21","13170","10","1717","11","11453","176.395295000","0.1890","72683.79","484826.68"
"244.3.213.252","2117","244.3.160.239","80","17","7472","9","6082","8","1390","36.895608000","0.1888","257683.20","58891.75"
"244.3.160.239","61226","117.246.95.43","80","10","1591","6","1049","4","542","0.194773000","0.1888","44447.98","22965.49"
"244.3.160.239","62427","41.177.254.197","80","13","3390","7","1315","6","2075","164.661716000","0.1888","55726.83","87933.98"
"244.3.160.239","62470","41.177.254.197","80","10","1962","6","1465","4","497","176.395432000","0.1888","62089.10","21063.67"
"244.3.160.204","49532","244.3.160.239","443","7","448","4","256","3","192","158.221751000","0.1887","10851.02","8138.27"
"41.116.229.239","3450","244.3.160.239","80","10","2499","5","1347","5","1152","31.370535000","0.1887","57097.44","48831.66"
"41.177.168.181","13865","244.3.160.239","80","12","1959","6","953","6","1006","78.528644000","0.1885","40443.05","42692.24"
"41.177.98.143","8001","244.160.18.105","2032","3","298","1","140","2","158","73.165913000","0.1884","N/A","6709.17"
"244.3.160.239","62737","197.154.128.197","80","10","2293","6","1526","4","767","225.202091000","0.1884","64799.68","32569.69"
"244.3.160.239","61831","43.106.84.231","80","13","1983","7","1230","6","753","79.129847000","0.1884","52237.34","31979.44"
"244.3.160.204","41177","244.3.160.239","443","7","448","4","256","3","192","108.218169000","0.1883","10875.11","8156.33"
"244.3.160.204","44185","244.3.160.239","443","7","448","4","256","3","192","126.220249000","0.1882","10879.55","8159.67"
"244.3.160.239","62738","197.154.128.197","80","10","2271","6","1525","4","746","225.202948000","0.1881","64863.26","31729.83"
"253.160.251.90","1442","253.37.253.43","446","11","6897","0","0","11","6897","72.734590000","0.1881","N/A","293395.72"
"90.38.138.255","5893","244.3.160.239","80","10","1552","5","1112","5","440","228.927358000","0.1880","47331.74","18728.39"
"41.177.192.117","5493","244.3.160.239","80","12","2347","6","1185","6","1162","164.876674000","0.1875","50561.35","49579.99"
"244.3.160.204","32488","244.3.160.239","443","7","448","4","256","3","192","56.204196000","0.1873","10931.65","8198.73"
"244.3.160.239","62761","198.123.241.156","80","11","1661","6","1217","5","444","228.962104000","0.1872","52014.10","18976.39"
"244.3.160.239","62432","41.177.254.197","80","13","3677","7","1310","6","2367","164.768192000","0.1871","56001.15","101186.82"
"244.3.160.239","60151","43.106.84.231","80","51","45520","18","1152","33","44368","76.789885000","0.1871","49251.29","1896858.73"
"244.3.160.239","62436","41.177.254.197","80","10","2303","6","1251","4","1052","164.879872000","0.1871","53484.11","44976.25"
"41.177.98.143","8001","241.192.102.239","1428","3","298","1","140","2","158","114.033467000","0.1871","N/A","6756.68"
"244.3.160.239","62488","244.3.31.75","80","11","2216","6","1239","5","977","177.936276000","0.1871","52990.33","41784.95"
"47.167.26.34","1546","244.3.41.84","23","4","256","2","128","2","128","153.468613000","0.1868","5482.86","5482.86"
"244.3.160.254","62150","41.177.26.211","2641","26","2124","14","1022","12","1102","115.834237000","0.1866","43809.31","47238.61"
"244.3.160.248","47518","41.177.26.55","80","11","2214","6","763","5","1451","43.839167000","0.1866","32717.29","62218.60"
"41.177.142.91","2525","244.3.41.84","23","4","256","2","128","2","128","153.479060000","0.1865","5490.32","5490.32"
"41.177.3.224","51261","41.177.117.184","1605","19","5821","10","3420","9","2401","74.385885000","0.1864","146772.45","103041.13"
"244.3.160.239","61595","177.124.75.164","80","13","3101","7","2367","6","734","51.338140000","0.1864","101584.17","31500.96"
"244.3.160.239","62740","197.154.128.197","80","10","2337","6","1527","4","810","225.204728000","0.1863","65565.68","34779.44"
"244.3.160.239","62341","85.241.98.37","80","10","2485","6","1153","4","1332","155.262111000","0.1862","49548.24","57240.47"
"244.3.160.204","43184","244.3.160.239","443","7","448","4","256","3","192","120.219164000","0.1862","11001.53","8251.14"
"41.177.13.193","1468","244.3.41.84","23","4","256","2","128","2","128","153.461290000","0.1861","5502.09","5502.09"
"244.3.160.239","62428","41.177.254.197","80","13","3678","7","1314","6","2364","164.664893000","0.1861","56492.44","101634.80"
"244.3.160.248","48186","41.177.26.211","2641","13","1061","7","511","6","550","96.406870000","0.1860","21981.69","23659.35"
"244.3.160.239","61584","177.124.75.164","80","13","3257","7","2367","6","890","50.509294000","0.1857","101956.65","38336.04"
"244.3.160.239","61408","198.123.241.156","80","11","1669","6","1225","5","444","26.190029000","0.1855","52835.03","19150.00"
"41.177.98.252","10107","244.3.160.239","80","13","3451","6","1218","7","2233","32.831531000","0.1853","52570.81","96379.82"
"244.3.160.239","61219","117.246.95.43","80","9","1547","5","884","4","663","0.013127000","0.1853","38170.08","28627.56"
"244.3.160.239","61220","117.246.95.43","80","9","1606","5","883","4","723","0.014313000","0.1851","38156.35","31242.40"
"244.3.181.123","13637","244.3.160.239","80","12","1995","6","1283","6","712","110.762726000","0.1851","55462.79","30779.04"
"41.177.124.47","3204","244.3.160.239","80","12","2519","6","1636","6","883","225.197781000","0.1850","70732.56","38176.56"
"244.3.160.239","61218","117.246.95.43","80","9","1593","5","884","4","709","0.012954000","0.1850","38223.31","30656.48"
"244.3.160.204","29146","244.3.160.239","443","7","448","4","256","3","192","36.200762000","0.1850","11070.45","8302.84"
"41.177.26.214","39505","15.251.180.105","80","13","1403","7","592","6","811","88.072903000","0.1850","25602.77","35074.06"
"41.177.199.139","13172","244.3.160.239","80","12","2773","6","1275","6","1498","111.730011000","0.1849","55173.61","64823.58"
"244.3.181.123","9293","244.3.160.239","80","12","2888","6","1271","6","1617","109.405565000","0.1848","55021.35","69999.62"
"41.177.192.117","15141","244.3.160.239","80","13","3305","6","1185","7","2120","164.658772000","0.1847","51314.53","91803.21"
"244.3.160.239","61221","117.246.95.43","80","9","1595","5","883","4","712","0.014724000","0.1847","38240.21","30834.69"
"41.177.124.47","15486","244.3.160.239","80","12","2497","6","1635","6","862","225.198480000","0.1847","70836.72","37346.33"
"244.3.160.239","62201","94.2.202.197","80","13","4902","7","1375","6","3527","122.725827000","0.1842","59727.43","153206.28"
"41.177.26.214","39476","15.251.180.105","80","13","1403","7","592","6","811","24.291704000","0.1839","25752.85","35279.66"
"244.3.181.123","12596","244.3.160.239","80","12","2200","6","1263","6","937","110.578558000","0.1836","55045.87","40837.67"
"41.177.98.143","8001","244.56.202.204","1613","3","298","1","140","2","158","144.130401000","0.1834","N/A","6892.87"
"244.3.160.239","61784","197.154.128.197","80","10","1651","6","1096","4","555","77.261368000","0.1833","47825.02","24217.96"
"41.177.124.47","11157","244.3.160.239","80","12","2563","6","1637","6","926","225.200136000","0.1833","71446.50","40415.06"
"41.177.26.214","39531","15.251.180.105","80","13","1403","7","592","6","811","233.116048000","0.1832","25852.52","35416.20"
"41.177.124.47","2525","244.3.160.239","80","12","2500","6","1638","6","862","225.200630000","0.1831","71562.76","37660.01"
"41.177.3.224","65152","41.177.117.184","1606","32","12631","17","6138","15","6493","214.567679000","0.1830","268346.93","283867.16"
"244.3.160.204","30480","244.3.160.254","4000","7","448","4","256","3","192","44.199825000","0.1830","11192.30","8394.22"
"41.177.26.214","39510","15.251.180.105","80","13","1403","7","592","6","811","117.623102000","0.1830","25882.75","35457.62"
"77.197.210.48","41699","41.177.26.176","80","20","11212","7","448","13","10764","1.209615000","0.1830","19587.70","470629.39"
"41.177.223.45","7189","244.3.160.239","80","12","2319","6","810","6","1509","2.292538000","0.1827","35468.17","66075.90"
"244.3.160.204","34829","244.3.160.239","443","7","448","4","256","3","192","70.205946000","0.1824","11225.18","8418.88"
"90.218.193.20","11193","244.3.160.239","443","21","7952","9","1947","12","6005","102.921385000","0.1823","85442.52","263524.56"
"244.3.160.239","61596","177.124.75.164","80","13","3094","7","2367","6","727","51.342310000","0.1822","103906.37","31913.78"
"244.3.160.239","61753","117.246.95.43","80","12","2143","7","1379","5","764","68.521566000","0.1821","60573.12","33559.00"
"41.177.192.117","2993","244.3.160.239","80","13","3543","6","1134","7","2409","164.661841000","0.1820","49846.43","105890.69"
"244.3.160.239","62660","177.124.75.164","80","13","3081","7","2077","6","1004","212.306543000","0.1820","91303.73","44135.26"
"41.177.26.214","39490","15.251.180.105","80","13","1403","7","592","6","811","58.882911000","0.1819","26034.85","35665.99"
"41.177.223.45","15577","244.3.160.239","80","12","2184","6","955","6","1229","2.293538000","0.1819","42001.10","54051.68"
"41.177.192.117","9805","244.3.160.239","80","16","6715","7","1232","9","5483","163.761710000","0.1819","54197.92","241207.14"
"254.210.244.164","62803","41.177.98.127","210","9","762","4","345","5","417","0.689828000","0.1817","15186.78","18356.20"
"41.177.242.231","1181","244.3.41.84","23","2","128","2","128","0","0","153.483322000","0.1816","5638.83","N/A"
"77.197.217.224","40540","41.177.26.176","80","7","964","4","593","3","371","27.745896000","0.1815","26138.61","16353.16"
"41.177.199.139","7210","244.3.160.239","80","12","2155","6","1275","6","880","138.817229000","0.1814","56230.57","38810.12"
"244.3.160.239","62657","177.124.75.164","80","16","5610","8","2141","8","3469","211.992396000","0.1813","94486.28","153093.37"
"244.3.3.145","11944","244.3.160.239","80","12","1944","6","1015","6","929","203.346337000","0.1812","44800.49","41004.59"
"41.177.26.214","39502","15.251.180.105","80","13","1403","7","592","6","811","80.682580000","0.1812","26131.10","35797.84"
"41.177.223.45","4691","244.3.160.239","80","10","1994","5","881","5","1113","4.476188000","0.1812","38896.89","49139.89"
"244.3.3.145","11679","244.3.160.239","80","12","2845","6","1014","6","1831","203.346616000","0.1812","44771.67","80845.10"
"244.3.155.77","9072","244.3.160.239","80","13","2453","7","1663","6","790","87.772285000","0.1810","73502.76","34917.13"
"244.3.160.204","48867","244.3.160.239","443","7","448","4","256","3","192","154.221783000","0.1809","11318.54","8488.91"
"41.177.199.139","12756","244.3.160.239","80","11","2720","5","1212","6","1508","111.801877000","0.1808","53617.94","66712.75"
"244.3.160.239","62760","198.123.241.156","80","11","1670","6","1226","5","444","228.945636000","0.1806","54310.57","19668.75"
"253.160.251.90","1761","253.37.253.43","446","15","12574","0","0","15","12574","215.020801000","0.1805","N/A","557188.36"
"244.3.160.204","30485","244.3.160.254","80","7","448","4","256","3","192","44.201124000","0.1804","11351.54","8513.66"
"90.218.72.197","12368","244.3.160.239","80","10","1468","5","901","5","567","11.958797000","0.1803","39982.03","25160.72"
"142.122.248.71","25552","244.3.210.197","80","9","1225","5","724","4","501","36.329817000","0.1802","32146.70","22245.16"
"244.3.160.204","30488","244.3.160.239","80","7","448","4","256","3","192","44.201937000","0.1802","11367.11","8525.33"
"145.67.150.3","14790","244.3.160.239","80","10","1409","5","965","5","444","24.069570000","0.1802","42851.27","19716.03"
"244.3.160.239","61599","177.124.75.164","80","13","3670","7","2367","6","1303","51.613753000","0.1801","105128.16","57871.57"
"244.3.160.204","61231","244.3.160.239","80","7","448","4","256","3","192","228.232063000","0.1801","11370.96","8528.22"
"244.3.160.239","61779","43.106.84.231","80","29","20295","12","1532","17","18763","76.970904000","0.1799","68111.97","834193.81"
"41.177.168.181","10675","244.3.160.239","80","40","24299","14","1552","26","22747","78.096591000","0.1799","69010.75","1011461.03"
"244.3.160.204","48197","244.3.160.239","443","7","448","4","256","3","192","150.221293000","0.1798","11389.42","8542.07"
"41.177.100.56","1363","244.3.41.84","23","4","256","2","128","2","128","153.466801000","0.1798","5696.64","5696.64"
"244.3.160.204","26805","244.3.160.239","443","7","448","4","256","3","192","22.197289000","0.1797","11395.00","8546.25"
"244.3.160.204","39508","244.3.160.239","80","7","448","4","256","3","192","98.210662000","0.1796","11405.79","8554.34"
"244.3.160.204","23459","244.3.160.254","443","7","448","4","256","3","192","2.193293000","0.1796","11405.91","8554.43"
"244.3.160.239","61994","198.123.241.156","80","11","1995","6","1551","5","444","105.021963000","0.1795","69139.60","19792.38"
"41.177.192.117","9143","244.3.160.239","80","13","3840","6","1181","7","2659","164.775802000","0.1794","52677.36","118602.11"
"242.161.82.241","59892","244.3.210.197","80","17","7573","9","1119","8","6454","25.912159000","0.1791","49973.48","288229.55"
"244.3.160.204","32824","244.3.160.239","80","7","448","4","256","3","192","58.204399000","0.1790","11440.77","8580.57"
"244.3.160.239","62739","197.154.128.197","80","10","2274","6","1528","4","746","225.204680000","0.1788","68357.33","33373.41"
"244.3.160.204","34161","244.3.160.239","80","7","448","4","256","3","192","66.212398000","0.1786","11464.59","8598.44"
"244.3.160.204","34495","244.3.160.239","80","7","448","4","256","3","192","68.206862000","0.1786","11464.98","8598.73"
"41.177.168.181","4153","244.3.160.239","80","37","22253","13","1487","24","20766","77.913329000","0.1784","66682.36","931221.20"
"244.3.160.204","39174","244.3.160.239","80","7","448","4","256","3","192","96.210757000","0.1783","11489.35","8617.01"
"244.3.160.204","61228","244.3.160.254","80","7","448","4","256","3","192","228.231214000","0.1782","11493.48","8620.11"
"244.3.160.239","61579","177.124.75.164","80","13","3420","7","2366","6","1054","50.248000000","0.1780","106323.94","47364.93"
"244.3.160.204","39503","244.3.160.254","80","7","448","4","256","3","192","98.209324000","0.1780","11507.23","8630.43"
"244.3.160.204","57889","244.3.160.239","80","7","448","4","256","3","192","208.228251000","0.1780","11508.72","8631.54"
"41.177.211.185","6263","244.3.160.239","80","12","2387","6","1350","6","1037","178.425019000","0.1779","60700.07","46626.65"
"244.3.160.204","34156","244.3.160.254","80","7","448","4","256","3","192","66.210705000","0.1776","11531.14","8648.36"
"244.3.160.204","58556","244.3.160.239","80","7","448","4","256","3","192","212.229633000","0.1776","11532.05","8649.04"
"41.177.192.117","5372","244.3.160.239","80","12","2211","6","1165","6","1046","164.887019000","0.1775","52503.49","47140.48"
"244.3.160.204","34492","244.3.160.254","80","7","448","4","256","3","192","68.206020000","0.1775","11539.65","8654.74"
"244.3.160.204","61227","244.3.160.254","443","7","448","4","256","3","192","228.230968000","0.1774","11542.84","8657.13"
"244.3.160.204","57885","244.3.160.254","4000","7","448","4","256","3","192","208.227202000","0.1772","11560.63","8670.47"
"244.3.160.204","27811","244.3.160.239","80","7","448","4","256","3","192","28.199399000","0.1771","11561.15","8670.86"
"244.3.160.204","55882","244.3.160.239","443","7","448","4","256","3","192","196.226787000","0.1770","11569.25","8676.94"
"244.3.160.204","29482","244.3.160.239","80","7","448","4","256","3","192","38.201039000","0.1770","11569.84","8677.38"
"244.3.160.204","32819","244.3.160.254","80","7","448","4","256","3","192","58.203033000","0.1770","11571.14","8678.36"
"244.3.160.239","61790","43.106.84.231","80","29","18933","12","1525","17","17408","77.766863000","0.1770","68940.19","786957.87"
"244.3.160.204","27472","244.3.160.254","80","7","448","4","256","3","192","26.197590000","0.1769","11574.48","8680.86"
"244.3.160.204","34148","244.3.160.89","80","7","448","4","256","3","192","66.208143000","0.1769","11577.10","8682.82"
"244.3.160.239","62437","41.177.254.197","80","10","2217","6","1281","4","936","164.890170000","0.1768","57954.62","42346.23"
"244.3.160.204","26140","244.3.160.239","80","7","448","4","256","3","192","18.197175000","0.1768","11585.48","8689.11"
"244.3.160.204","34155","244.3.160.254","443","7","448","4","256","3","192","66.210426000","0.1768","11585.55","8689.16"
"244.3.160.239","62433","41.177.254.197","80","13","3925","7","1311","6","2614","164.778710000","0.1767","59351.14","118340.11"
"244.3.160.204","39495","244.3.160.89","80","7","448","4","256","3","192","98.207249000","0.1767","11589.81","8692.36"
"244.3.160.204","23465","244.3.160.239","80","7","448","4","256","3","192","2.194910000","0.1766","11595.65","8696.74"
"244.3.160.204","34491","244.3.160.254","443","7","448","4","256","3","192","68.205758000","0.1766","11596.37","8697.28"
"242.161.82.241","50343","244.3.210.197","80","13","4721","7","905","6","3816","211.790566000","0.1766","41004.73","172899.50"
"244.3.160.204","39502","244.3.160.254","443","7","448","4","256","3","192","98.209062000","0.1765","11603.86","8702.89"
"244.3.41.67","1099","244.3.41.84","23","4","256","2","128","2","128","32.454047000","0.1764","5804.23","5804.23"
"244.3.160.204","50538","244.3.160.239","443","7","448","4","256","3","192","164.222854000","0.1763","11615.77","8711.83"
"244.3.160.204","23460","244.3.160.254","80","7","448","4","256","3","192","2.193552000","0.1762","11620.45","8715.34"
"244.3.160.204","27808","244.3.160.254","80","7","448","4","256","3","192","28.198585000","0.1762","11624.41","8718.31"
"244.3.160.204","32818","244.3.160.254","443","7","448","4","256","3","192","58.202807000","0.1761","11629.03","8721.77"
"244.3.160.204","35830","244.3.160.239","443","7","448","4","256","3","192","76.207141000","0.1760","11633.85","8725.39"
"244.3.160.204","31820","244.3.160.239","80","7","448","4","256","3","192","52.203389000","0.1760","11634.64","8725.98"
"244.3.160.204","58553","244.3.160.254","80","7","448","4","256","3","192","212.228817000","0.1760","11637.09","8727.82"
"244.3.160.204","61223","244.3.160.254","4000","7","448","4","256","3","192","228.229910000","0.1759","11640.80","8730.60"
"244.3.160.204","57882","244.3.160.254","80","7","448","4","256","3","192","208.226384000","0.1759","11641.46","8731.09"
"244.3.181.123","4702","244.3.160.239","80","12","1992","6","1259","6","733","108.995731000","0.1759","57256.88","33335.42"
"244.3.160.204","61220","244.3.160.89","80","7","448","4","256","3","192","228.229099000","0.1758","11646.82","8735.11"
"244.3.160.204","39170","244.3.160.254","4000","7","448","4","256","3","192","96.209676000","0.1758","11647.95","8735.96"
"244.3.160.204","27807","244.3.160.254","443","7","448","4","256","3","192","28.198326000","0.1758","11650.00","8737.50"
"244.3.160.248","49693","41.177.26.55","80","11","1283","6","791","5","492","194.255479000","0.1757","36006.51","22395.96"
"244.3.160.239","62497","244.3.31.75","80","11","2288","6","1243","5","1045","178.427167000","0.1757","56602.91","47586.52"
"41.177.40.117","10766","244.3.160.239","80","14","2648","7","2011","7","637","111.989822000","0.1757","91590.71","29012.08"
"244.3.160.204","26135","244.3.160.254","80","7","448","4","256","3","192","18.195840000","0.1756","11663.07","8747.30"
"242.161.82.241","57263","244.3.210.197","80","13","4914","7","905","6","4009","94.883569000","0.1756","41241.11","182691.27"
"244.3.160.204","38504","244.3.160.239","80","7","448","4","256","3","192","92.209695000","0.1755","11667.79","8750.84"
"244.3.160.239","61817","43.106.84.231","80","13","1997","7","1101","6","896","78.828436000","0.1755","50185.75","40841.44"
"244.3.160.239","61795","43.106.84.231","80","28","18004","12","1523","16","16481","78.283294000","0.1754","69452.60","751574.71"
"244.3.160.204","30149","244.3.160.239","80","7","448","4","256","3","192","42.201809000","0.1753","11681.76","8761.32"
"244.3.160.204","58552","244.3.160.254","443","7","448","4","256","3","192","212.228544000","0.1753","11681.83","8761.37"
"242.161.82.241","54619","244.3.210.197","80","13","4883","7","975","6","3908","5.431255000","0.1753","44497.18","178353.83"
"244.3.160.204","25136","244.3.160.239","80","7","448","4","256","3","192","12.197095000","0.1753","11684.70","8763.52"
"90.218.193.20","3342","244.3.160.239","80","12","2729","6","1291","6","1438","105.262881000","0.1752","58933.63","65644.12"
"244.3.160.204","26807","244.3.160.239","80","7","448","4","256","3","192","22.197833000","0.1752","11688.10","8766.07"
"244.3.160.204","57881","244.3.160.254","443","7","448","4","256","3","192","208.226143000","0.1752","11690.37","8767.77"
"244.3.155.77","2619","244.3.160.239","80","11","1973","6","1418","5","555","87.971749000","0.1752","64754.40","25344.64"
"244.3.160.204","43515","244.3.160.239","443","7","448","4","256","3","192","122.219133000","0.1752","11690.57","8767.92"
"244.3.181.123","6529","244.3.160.239","80","10","1660","5","1061","5","599","111.204188000","0.1751","48473.77","27366.44"
"244.3.160.239","61536","117.246.95.43","80","10","1695","6","995","4","700","45.816510000","0.1751","45460.00","31981.91"
"41.177.199.139","10702","244.3.160.239","80","12","2150","6","1276","6","874","138.816924000","0.1751","58311.77","39940.82"
"244.3.160.204","34487","244.3.160.254","4000","7","448","4","256","3","192","68.204661000","0.1751","11699.31","8774.49"
"244.3.160.204","34484","244.3.160.89","80","7","448","4","256","3","192","68.203861000","0.1750","11700.65","8775.49"
"244.3.160.204","30147","244.3.160.239","443","7","448","4","256","3","192","42.201297000","0.1750","11701.05","8775.79"
"244.3.253.224","12362","244.3.160.239","80","12","2441","6","1443","6","998","222.861145000","0.1750","65976.65","45630.42"
"244.3.160.204","26134","244.3.160.254","443","7","448","4","256","3","192","18.195589000","0.1749","11710.02","8782.51"
"244.3.160.204","31817","244.3.160.254","80","7","448","4","256","3","192","52.202544000","0.1749","11712.56","8784.42"
"244.3.160.204","56885","244.3.160.239","80","7","448","4","256","3","192","202.227489000","0.1748","11718.46","8788.84"
"244.3.160.204","61898","244.3.160.239","80","7","448","4","256","3","192","232.232983000","0.1747","11725.44","8794.08"
"244.3.160.204","54881","244.3.160.239","443","7","448","4","256","3","192","190.225703000","0.1747","11726.24","8794.68"
"244.3.160.204","38501","244.3.160.254","80","7","448","4","256","3","192","92.208870000","0.1746","11727.99","8795.99"
"244.3.160.204","35162","244.3.160.239","80","7","448","4","256","3","192","72.206938000","0.1746","11730.00","8797.50"
"244.3.160.204","39167","244.3.160.254","80","7","448","4","256","3","192","96.208881000","0.1746","11731.28","8798.46"
"41.177.43.188","1818","244.3.41.84","23","2","128","2","128","0","0","32.466251000","0.1746","5865.71","N/A"
"244.3.160.204","37837","244.3.160.239","80","7","448","4","256","3","192","88.209421000","0.1746","11732.62","8799.47"
"244.3.160.204","29148","244.3.160.239","80","7","448","4","256","3","192","36.201304000","0.1745","11737.73","8803.30"
"244.3.160.204","27803","244.3.160.254","4000","7","448","4","256","3","192","28.197285000","0.1744","11740.56","8805.42"
"244.3.160.204","25133","244.3.160.254","80","7","448","4","256","3","192","12.196262000","0.1744","11742.85","8807.14"
"244.3.160.204","31816","244.3.160.254","443","7","448","4","256","3","192","52.202280000","0.1744","11742.85","8807.14"
"244.3.160.204","27800","244.3.160.89","80","7","448","4","256","3","192","28.196494000","0.1744","11745.07","8808.80"
"244.3.160.239","61564","117.246.95.43","80","10","1507","6","1030","4","477","46.357467000","0.1744","47257.46","21885.25"
"244.3.160.204","29476","244.3.160.254","4000","7","448","4","256","3","192","38.199428000","0.1743","11746.96","8810.22"
"41.116.229.239","6743","244.3.160.239","80","16","6315","7","1408","9","4907","29.435936000","0.1743","64609.38","225169.21"
"244.3.160.204","39166","244.3.160.254","443","7","448","4","256","3","192","96.208622000","0.1743","11747.77","8810.83"
"90.218.72.197","2460","244.3.160.239","80","10","1470","5","903","5","567","11.976799000","0.1743","41445.78","26024.10"
"244.3.160.204","25132","244.3.160.254","443","7","448","4","256","3","192","12.195997000","0.1742","11757.55","8818.16"
"244.3.160.204","24469","244.3.160.239","80","7","448","4","256","3","192","8.196650000","0.1739","11775.60","8831.70"
"244.3.160.204","38500","244.3.160.254","443","7","448","4","256","3","192","92.208606000","0.1739","11776.21","8832.15"
"41.177.64.0","4530","244.3.41.84","23","4","256","2","128","2","128","153.473048000","0.1739","5888.58","5888.58"
"244.3.160.204","35832","244.3.160.239","80","7","448","4","256","3","192","76.207652000","0.1739","11778.44","8833.83"
"244.3.160.204","35158","244.3.160.254","4000","7","448","4","256","3","192","72.205812000","0.1738","11780.61","8835.46"
"244.3.160.204","37172","244.3.160.239","80","7","448","4","256","3","192","84.208464000","0.1738","11782.10","8836.58"
"244.3.160.204","44519","244.3.160.239","443","7","448","4","256","3","192","128.220246000","0.1738","11783.32","8837.49"
"244.3.160.204","29473","244.3.160.89","80","7","448","4","256","3","192","38.198622000","0.1738","11783.66","8837.74"
"41.177.199.139","8328","244.3.160.239","80","11","2474","5","895","6","1579","99.931145000","0.1738","41201.52","72689.61"
"244.3.155.77","14792","244.3.160.239","80","15","4185","8","3360","7","825","31.814810000","0.1737","154745.11","37995.45"
"244.3.160.204","61894","244.3.160.254","4000","7","448","4","256","3","192","232.231889000","0.1736","11798.87","8849.15"
"244.3.160.204","31809","244.3.160.89","80","7","448","4","256","3","192","52.200402000","0.1735","11800.77","8850.58"
"244.3.160.204","29818","244.3.160.239","80","7","448","4","256","3","192","40.201996000","0.1735","11800.97","8850.73"
"244.3.160.204","23804","244.3.160.239","80","7","448","4","256","3","192","4.195205000","0.1735","11801.04","8850.78"
"244.3.160.204","26801","244.3.160.254","4000","7","448","4","256","3","192","22.196229000","0.1735","11802.67","8852.01"
"244.3.160.204","32811","244.3.160.89","80","7","448","4","256","3","192","58.200948000","0.1735","11802.74","8852.06"
"244.3.160.204","31812","244.3.160.254","4000","7","448","4","256","3","192","52.201203000","0.1735","11806.35","8854.76"
"244.3.160.204","33160","244.3.160.239","80","7","448","4","256","3","192","60.206173000","0.1734","11810.37","8857.77"
"244.3.160.204","58548","244.3.160.254","4000","7","448","4","256","3","192","212.227487000","0.1733","11814.59","8860.94"
"244.3.160.204","35829","244.3.160.254","80","7","448","4","256","3","192","76.206811000","0.1733","11816.02","8862.02"
"244.3.160.204","23452","244.3.160.89","80","7","448","4","256","3","192","2.191489000","0.1733","11817.86","8863.40"
"244.3.160.204","57224","244.3.160.239","80","7","448","4","256","3","192","204.228195000","0.1733","11818.34","8863.75"
"244.3.160.204","62237","244.3.160.239","80","7","448","4","256","3","192","234.232632000","0.1733","11818.95","8864.21"
"244.3.160.204","26476","244.3.160.239","80","7","448","4","256","3","192","20.198274000","0.1732","11825.23","8868.92"
"244.3.160.204","37833","244.3.160.254","4000","7","448","4","256","3","192","88.208341000","0.1732","11825.85","8869.38"
"244.3.160.204","26127","244.3.160.89","80","7","448","4","256","3","192","18.193756000","0.1732","11827.42","8870.56"
"244.3.160.204","35155","244.3.160.254","80","7","448","4","256","3","192","72.204973000","0.1732","11827.76","8870.82"
"244.3.160.204","29145","244.3.160.254","80","7","448","4","256","3","192","36.200489000","0.1731","11831.72","8873.79"
"244.3.160.204","35828","244.3.160.254","443","7","448","4","256","3","192","76.206560000","0.1731","11832.34","8874.25"
"244.3.160.204","24465","244.3.160.254","4000","7","448","4","256","3","192","8.195549000","0.1730","11836.23","8877.18"
"244.3.160.204","27146","244.3.160.239","80","7","448","4","256","3","192","24.199352000","0.1730","11838.36","8878.77"
"244.3.160.204","36833","244.3.160.239","80","7","448","4","256","3","192","82.208214000","0.1730","11839.59","8879.69"
"41.177.98.143","8001","153.103.26.253","4168","4","362","2","204","2","158","104.610815000","0.1730","9434.83","7307.37"
"244.3.160.204","58545","244.3.160.89","80","7","448","4","256","3","192","212.226710000","0.1729","11844.65","8883.49"
"244.3.160.204","25128","244.3.160.254","4000","7","448","4","256","3","192","12.194903000","0.1729","11846.71","8885.03"
"244.3.160.204","24462","244.3.160.254","80","7","448","4","256","3","192","8.194714000","0.1728","11849.31","8886.99"
"244.3.160.204","26798","244.3.160.89","80","7","448","4","256","3","192","22.195436000","0.1728","11852.47","8889.35"
"244.3.160.204","33491","244.3.160.239","80","7","448","4","256","3","192","62.205546000","0.1728","11853.70","8890.28"
"244.3.160.204","37169","244.3.160.254","80","7","448","4","256","3","192","84.207677000","0.1727","11855.63","8891.72"
"244.3.160.204","29144","244.3.160.254","443","7","448","4","256","3","192","36.200191000","0.1727","11857.82","8893.37"
"41.177.192.117","3052","244.3.160.239","80","42","30951","17","1866","25","29085","163.880803000","0.1727","86435.41","1347252.86"
"244.3.160.204","33157","244.3.160.254","80","7","448","4","256","3","192","60.205333000","0.1727","11858.23","8893.68"
"244.3.160.204","61891","244.3.160.254","80","7","448","4","256","3","192","232.231094000","0.1727","11858.71","8894.04"
"244.3.160.204","59560","244.3.160.239","80","7","448","4","256","3","192","218.230172000","0.1727","11858.99","8894.24"
"244.3.160.204","36828","244.3.160.254","80","7","448","4","256","3","192","82.206890000","0.1727","11861.32","8895.99"
"244.3.160.204","28478","244.3.160.239","80","7","448","4","256","3","192","32.199690000","0.1726","11866.27","8899.70"
"244.3.160.204","62232","244.3.160.254","80","7","448","4","256","3","192","234.231355000","0.1725","11873.43","8905.07"
"244.3.160.204","56218","244.3.160.239","80","7","448","4","256","3","192","198.226974000","0.1724","11877.21","8907.91"
"244.3.181.123","6127","244.3.160.239","80","12","2013","6","1272","6","741","109.275356000","0.1724","59034.43","34390.34"
"244.3.160.204","33156","244.3.160.254","443","7","448","4","256","3","192","60.205034000","0.1724","11882.52","8911.89"
"244.3.160.204","30144","244.3.160.254","80","7","448","4","256","3","192","42.200484000","0.1723","11883.83","8912.87"
"41.177.160.57","1563","244.3.41.84","23","4","256","2","128","2","128","32.467247000","0.1722","5946.02","5946.02"
"244.3.160.204","36166","244.3.160.239","80","7","448","4","256","3","192","78.207452000","0.1722","11892.04","8919.03"
"244.3.160.204","27142","244.3.160.254","4000","7","448","4","256","3","192","24.198256000","0.1722","11892.73","8919.55"
"244.3.160.204","25125","244.3.160.89","80","7","448","4","256","3","192","12.194107000","0.1722","11895.08","8921.31"
"244.3.160.204","37168","244.3.160.254","443","7","448","4","256","3","192","84.207381000","0.1722","11896.60","8922.45"
"244.3.160.204","38496","244.3.160.254","4000","7","448","4","256","3","192","92.207573000","0.1721","11898.12","8923.59"
"90.218.193.20","5278","244.3.160.239","80","57","41220","18","2048","39","39172","102.199334000","0.1721","95189.96","1820693.82"
"244.3.160.204","23801","244.3.160.254","80","7","448","4","256","3","192","4.194433000","0.1721","11900.89","8925.67"
"244.3.160.204","37830","244.3.160.254","80","7","448","4","256","3","192","88.207568000","0.1720","11904.07","8928.05"
"244.3.160.204","57221","244.3.160.254","80","7","448","4","256","3","192","204.227412000","0.1720","11904.83","8928.62"
"244.3.160.204","33830","244.3.160.239","80","7","448","4","256","3","192","64.205681000","0.1720","11905.59","8929.19"
"244.3.160.204","61890","244.3.160.254","443","7","448","4","256","3","192","232.230825000","0.1719","11911.41","8933.56"
"244.3.160.204","24461","244.3.160.254","443","7","448","4","256","3","192","8.194462000","0.1719","11913.70","8935.27"
"244.3.160.204","23134","244.3.160.239","80","7","448","4","256","3","192","0.195025000","0.1719","11914.67","8936.00"
"244.3.160.204","29814","244.3.160.254","4000","7","448","4","256","3","192","40.200890000","0.1719","11915.22","8936.42"
"244.3.160.204","59555","244.3.160.254","80","7","448","4","256","3","192","218.228829000","0.1719","11916.88","8937.66"
"244.3.160.204","25806","244.3.160.239","80","7","448","4","256","3","192","16.198078000","0.1719","11917.02","8937.77"
"244.3.160.204","37829","244.3.160.254","443","7","448","4","256","3","192","88.207312000","0.1718","11919.59","8939.69"
"244.3.160.204","30143","244.3.160.254","443","7","448","4","256","3","192","42.200259000","0.1718","11920.14","8940.11"
"244.3.160.204","57220","244.3.160.254","443","7","448","4","256","3","192","204.227105000","0.1718","11920.42","8940.32"
"244.3.160.204","56880","244.3.160.254","80","7","448","4","256","3","192","202.226164000","0.1718","11922.85","8942.14"
"244.3.160.204","30484","244.3.160.254","443","7","448","4","256","3","192","44.200858000","0.1717","11924.59","8943.44"
"244.3.160.204","38493","244.3.160.89","80","7","448","4","256","3","192","92.206767000","0.1717","11926.25","8944.69"
"244.3.160.204","62231","244.3.160.254","443","7","448","4","256","3","192","234.231107000","0.1717","11928.20","8946.15"
"244.3.160.204","60566","244.3.160.239","80","7","448","4","256","3","192","224.232144000","0.1716","11932.30","8949.22"
"244.3.160.204","59554","244.3.160.254","443","7","448","4","256","3","192","218.228564000","0.1716","11934.25","8950.68"
"244.3.160.204","36827","244.3.160.254","443","7","448","4","256","3","192","82.206622000","0.1716","11935.08","8951.31"
"244.3.160.204","32490","244.3.160.239","80","7","448","4","256","3","192","56.204739000","0.1716","11935.22","8951.41"
"244.3.160.204","23800","244.3.160.254","443","7","448","4","256","3","192","4.194100000","0.1715","11942.46","8956.84"
"41.177.241.61","49433","244.3.41.84","23","4","256","2","128","2","128","153.474448000","0.1714","5972.90","5972.90"
"244.3.160.204","27139","244.3.160.254","80","7","448","4","256","3","192","24.197465000","0.1714","11946.92","8960.19"
"244.3.160.204","35154","244.3.160.254","443","7","448","4","256","3","192","72.204715000","0.1714","11947.26","8960.45"
"244.3.160.204","28817","244.3.160.239","80","7","448","4","256","3","192","34.200195000","0.1714","11948.52","8961.39"
"244.3.160.204","56212","244.3.160.254","4000","7","448","4","256","3","192","198.225330000","0.1714","11949.63","8962.23"
"244.3.160.204","28474","244.3.160.254","4000","7","448","4","256","3","192","32.198632000","0.1714","11950.75","8963.06"
"77.197.128.41","7113","41.177.26.46","80","7","934","4","580","3","354","42.778198000","0.1713","27086.03","16531.82"
"244.3.160.204","37164","244.3.160.254","4000","7","448","4","256","3","192","84.206328000","0.1712","11962.97","8972.22"
"244.3.160.204","36160","244.3.160.254","4000","7","448","4","256","3","192","78.205838000","0.1712","11964.57","8973.43"
"244.3.153.55","2861","41.177.24.241","443","16","3175","8","2247","8","928","107.103125000","0.1712","105029.45","43376.65"
"68.33.110.176","9878","244.3.160.239","80","15","5062","7","1392","8","3670","122.710485000","0.1711","65074.86","171569.49"
"244.3.160.204","59547","244.3.160.89","80","7","448","4","256","3","192","218.226749000","0.1711","11969.47","8977.10"
"122.155.141.12","13650","244.3.160.239","80","15","6521","7","1590","8","4931","158.181962000","0.1711","74343.36","230557.93"
"244.3.160.204","29140","244.3.160.254","4000","7","448","4","256","3","192","36.199231000","0.1711","11971.92","8978.94"
"244.3.160.204","59226","244.3.160.239","80","7","448","4","256","3","192","216.230397000","0.1710","11973.74","8980.30"
"244.3.160.204","30136","244.3.160.89","80","7","448","4","256","3","192","42.198390000","0.1710","11975.28","8981.46"
"244.3.160.204","35824","244.3.160.254","4000","7","448","4","256","3","192","76.205499000","0.1710","11976.68","8982.51"
"244.3.160.204","56879","244.3.160.254","443","7","448","4","256","3","192","202.225886000","0.1709","11980.88","8985.66"
"244.3.160.204","59896","244.3.160.239","80","7","448","4","256","3","192","220.231365000","0.1709","11982.84","8987.13"
"244.3.160.204","36502","244.3.160.239","80","7","448","4","256","3","192","80.207784000","0.1709","11984.67","8988.50"
"244.3.160.204","60562","244.3.160.254","4000","7","448","4","256","3","192","224.231034000","0.1709","11984.95","8988.71"
"244.3.160.204","37503","244.3.160.239","80","7","448","4","256","3","192","86.209865000","0.1709","11985.09","8988.82"
"244.3.160.239","61604","177.124.75.164","80","13","3263","7","2367","6","896","52.325042000","0.1708","110834.06","41954.93"
"244.3.160.204","28812","244.3.160.254","80","7","448","4","256","3","192","34.198873000","0.1708","11988.25","8991.18"
"244.3.160.204","35501","244.3.160.239","80","7","448","4","256","3","192","74.207167000","0.1708","11988.60","8991.45"
"41.177.192.117","11217","244.3.160.239","80","35","24879","14","1644","21","23235","161.673038000","0.1708","77004.15","1088315.89"
"244.3.160.204","29811","244.3.160.254","80","7","448","4","256","3","192","40.200119000","0.1708","11991.97","8993.97"
"244.3.181.123","8728","244.3.160.239","80","10","1698","5","1239","5","459","107.069472000","0.1707","58059.64","21508.78"
"244.3.160.204","60897","244.3.160.239","80","7","448","4","256","3","192","226.232577000","0.1707","11997.38","8998.03"
"244.3.160.204","25802","244.3.160.254","4000","7","448","4","256","3","192","16.196982000","0.1707","12000.68","9000.51"
"41.177.98.98","43369","244.3.31.224","7630","4","256","2","128","2","128","47.393544000","0.1706","6002.17","6002.17"
"244.3.160.204","27138","244.3.160.254","443","7","448","4","256","3","192","24.197212000","0.1705","12011.73","9008.80"
"244.3.160.204","38173","244.3.160.239","80","7","448","4","256","3","192","90.209742000","0.1705","12013.00","9009.75"
"244.3.160.204","33152","244.3.160.254","4000","7","448","4","256","3","192","60.203965000","0.1705","12015.25","9011.44"
"244.3.160.239","61572","177.124.75.164","80","13","3261","7","2367","6","894","49.681368000","0.1704","111113.07","41966.66"
"244.3.218.55","1948","244.3.41.84","23","4","256","2","128","2","128","32.452612000","0.1704","6008.68","6008.68"
"244.3.160.204","35496","244.3.160.254","80","7","448","4","256","3","192","74.205729000","0.1704","12017.44","9013.08"
"244.3.160.239","61603","177.124.75.164","80","13","3266","7","2367","6","899","52.115120000","0.1704","111131.98","42208.55"
"244.3.160.239","61601","177.124.75.164","80","13","3266","7","2367","6","899","51.875304000","0.1704","111132.63","42208.80"
"244.3.160.204","29810","244.3.160.254","443","7","448","4","256","3","192","40.199831000","0.1703","12023.22","9017.42"
"244.3.181.123","14698","244.3.160.239","80","10","1702","5","1243","5","459","107.078512000","0.1703","58391.07","21561.95"
"244.3.160.204","60559","244.3.160.254","80","7","448","4","256","3","192","224.230234000","0.1703","12026.40","9019.80"
"244.3.160.204","59219","244.3.160.254","80","7","448","4","256","3","192","216.228507000","0.1703","12026.47","9019.85"
"244.3.160.204","56872","244.3.160.89","80","7","448","4","256","3","192","202.224067000","0.1703","12028.73","9021.55"
"244.3.160.204","37161","244.3.160.89","80","7","448","4","256","3","192","84.205565000","0.1703","12029.09","9021.81"
"244.3.160.204","62224","244.3.160.89","80","7","448","4","256","3","192","234.229263000","0.1703","12029.16","9021.87"
"41.177.142.167","1133","244.3.41.84","23","4","256","2","128","2","128","153.456781000","0.1702","6014.75","6014.75"
"244.3.160.204","57555","244.3.160.239","80","7","448","4","256","3","192","206.229243000","0.1702","12034.88","9026.16"
"244.3.160.204","28471","244.3.160.254","80","7","448","4","256","3","192","32.197862000","0.1702","12034.95","9026.21"
"244.3.160.204","56209","244.3.160.89","80","7","448","4","256","3","192","198.224489000","0.1702","12035.59","9026.69"
"244.3.160.204","28811","244.3.160.254","443","7","448","4","256","3","192","34.198611000","0.1702","12036.16","9027.12"
"244.3.160.204","29137","244.3.160.89","80","7","448","4","256","3","192","36.198353000","0.1701","12040.19","9030.14"
"244.3.160.204","59893","244.3.160.254","80","7","448","4","256","3","192","220.230446000","0.1701","12040.54","9030.41"
"90.218.72.197","11470","244.3.160.239","80","19","9190","8","1114","11","8076","3.253170000","0.1701","52403.18","379899.57"
"244.3.160.204","33826","244.3.160.254","4000","7","448","4","256","3","192","64.204570000","0.1700","12043.59","9032.69"
"244.3.160.204","59222","244.3.160.254","4000","7","448","4","256","3","192","216.229304000","0.1700","12046.28","9034.71"
"244.3.160.204","27477","244.3.160.239","80","7","448","4","256","3","192","26.198908000","0.1700","12047.20","9035.40"
"244.3.160.204","33149","244.3.160.89","80","7","448","4","256","3","192","60.203170000","0.1700","12050.46","9037.85"
"244.3.160.204","35821","244.3.160.89","80","7","448","4","256","3","192","76.204640000","0.1699","12051.31","9038.48"
"244.3.160.204","28470","244.3.160.254","443","7","448","4","256","3","192","32.197598000","0.1698","12057.91","9043.43"
"244.3.160.204","35495","244.3.160.254","443","7","448","4","256","3","192","74.205460000","0.1698","12058.27","9043.70"
"244.3.160.239","61571","177.124.75.164","80","15","5204","8","2430","7","2774","49.630285000","0.1698","114483.59","130690.32"
"244.3.160.204","26473","244.3.160.254","80","7","448","4","256","3","192","20.197505000","0.1698","12064.37","9048.28"
"244.3.160.204","59892","244.3.160.254","443","7","448","4","256","3","192","220.230291000","0.1698","12064.66","9048.49"
"244.3.160.239","61677","117.246.95.43","80","12","2084","7","1385","5","699","59.367395000","0.1697","65275.15","32943.92"
"244.3.160.204","30477","244.3.160.89","80","7","448","4","256","3","192","44.199024000","0.1697","12065.65","9049.24"
"244.3.160.204","36157","244.3.160.89","80","7","448","4","256","3","192","78.204980000","0.1697","12066.15","9049.61"
"244.3.160.204","33485","244.3.160.254","4000","7","448","4","256","3","192","62.203896000","0.1697","12068.64","9051.48"
"244.3.160.204","31489","244.3.160.239","80","7","448","4","256","3","192","50.203026000","0.1697","12069.21","9051.91"
"41.177.3.215","35455","41.177.180.176","383","5","995","0","0","5","995","94.336959000","0.1697","N/A","46919.02"
"244.3.160.204","60558","244.3.160.254","443","7","448","4","256","3","192","224.229972000","0.1696","12076.68","9057.51"
"244.3.160.204","26472","244.3.160.254","443","7","448","4","256","3","192","20.197207000","0.1696","12077.11","9057.83"
"244.3.155.77","15271","244.3.160.239","80","11","1984","6","1429","5","555","0.191572000","0.1696","67419.18","26184.49"
"244.3.160.204","58225","244.3.160.239","80","7","448","4","256","3","192","210.229226000","0.1695","12082.24","9061.68"
"244.3.3.145","16263","244.3.160.239","80","29","18495","12","1408","17","17087","203.463626000","0.1695","66453.89","806461.32"
"244.3.160.204","36820","244.3.160.89","80","7","448","4","256","3","192","82.204747000","0.1695","12084.16","9063.12"
"244.3.160.204","57216","244.3.160.254","4000","7","448","4","256","3","192","204.226056000","0.1695","12084.95","9063.71"
"244.3.160.204","60227","244.3.160.239","80","7","448","4","256","3","192","222.231008000","0.1694","12087.09","9065.32"
"244.3.160.204","27471","244.3.160.254","443","7","448","4","256","3","192","26.197330000","0.1694","12087.45","9065.58"
"244.3.160.204","57549","244.3.160.254","4000","7","448","4","256","3","192","206.227616000","0.1694","12089.51","9067.14"
"244.3.160.204","60892","244.3.160.254","80","7","448","4","256","3","192","226.231251000","0.1694","12090.73","9068.05"
"244.3.160.204","57213","244.3.160.89","80","7","448","4","256","3","192","204.225218000","0.1694","12091.51","9068.63"
"244.3.160.204","32486","244.3.160.254","4000","7","448","4","256","3","192","56.203658000","0.1694","12091.66","9068.74"
"244.3.181.123","7917","244.3.160.239","80","7","1628","4","1156","3","472","111.837631000","0.1693","54631.38","22306.24"
"244.3.160.204","23796","244.3.160.254","4000","7","448","4","256","3","192","4.193032000","0.1692","12105.66","9079.25"
"244.3.160.204","25799","244.3.160.254","80","7","448","4","256","3","192","16.196355000","0.1692","12106.02","9079.52"
"244.3.160.204","38168","244.3.160.254","80","7","448","4","256","3","192","90.208402000","0.1692","12106.02","9079.52"
"244.3.160.204","24135","244.3.160.239","80","7","448","4","256","3","192","6.196858000","0.1692","12106.45","9079.84"
"244.3.160.204","60891","244.3.160.254","443","7","448","4","256","3","192","226.230950000","0.1691","12113.33","9084.99"
"244.3.160.204","37497","244.3.160.254","4000","7","448","4","256","3","192","86.208243000","0.1690","12115.83","9086.88"
"244.3.164.46","3367","244.3.160.239","80","34","17953","13","1585","21","16368","155.260647000","0.1690","75034.91","774871.59"
"244.3.153.102","2854","244.3.160.80","443","14","2386","7","1720","7","666","199.087471000","0.1689","81468.81","31545.48"
"244.3.160.204","23793","244.3.160.89","80","7","448","4","256","3","192","4.192263000","0.1689","12126.45","9094.84"
"244.3.160.204","56554","244.3.160.239","80","7","448","4","256","3","192","200.227453000","0.1688","12134.43","9100.82"
"244.3.181.123","3082","244.3.160.239","80","7","1628","4","1156","3","472","111.838184000","0.1687","54808.81","22378.68"
"244.3.160.204","36498","244.3.160.254","4000","7","448","4","256","3","192","80.206722000","0.1687","12142.12","9106.59"
"244.3.160.204","59218","244.3.160.254","443","7","448","4","256","3","192","216.228218000","0.1686","12146.88","9110.16"
"244.3.160.239","62416","41.177.254.197","80","42","31025","17","1932","25","29093","163.886770000","0.1683","91812.55","1382558.23"
"244.3.160.204","59888","244.3.160.254","4000","7","448","4","256","3","192","220.229071000","0.1683","12166.14","9124.61"
"244.3.160.239","61585","177.124.75.164","80","13","3066","7","2367","6","699","50.546576000","0.1683","112520.72","33228.55"
"244.3.160.204","32483","244.3.160.254","80","7","448","4","256","3","192","56.202860000","0.1683","12169.69","9127.26"
"244.3.160.204","61567","244.3.160.239","80","7","448","4","256","3","192","230.233041000","0.1683","12170.41","9127.81"
"244.3.160.239","61481","117.246.95.43","80","14","3658","8","2865","6","793","38.123098000","0.1683","136216.95","37703.33"
"244.3.160.204","24129","244.3.160.254","4000","7","448","4","256","3","192","6.195250000","0.1682","12173.30","9129.98"
"244.3.160.204","31484","244.3.160.254","80","7","448","4","256","3","192","50.201649000","0.1682","12173.74","9130.30"
"244.3.160.204","60221","244.3.160.254","4000","7","448","4","256","3","192","222.229376000","0.1682","12174.46","9130.85"
"244.3.160.204","35488","244.3.160.89","80","7","448","4","256","3","192","74.203592000","0.1682","12174.82","9131.12"
"244.3.160.204","30819","244.3.160.239","80","7","448","4","256","3","192","46.202523000","0.1682","12175.26","9131.44"
"244.3.160.204","23130","244.3.160.254","4000","7","448","4","256","3","192","0.193943000","0.1682","12175.69","9131.77"
"244.3.160.204","26468","244.3.160.254","4000","7","448","4","256","3","192","20.196162000","0.1682","12178.15","9133.61"
"244.3.160.204","28804","244.3.160.89","80","7","448","4","256","3","192","34.196844000","0.1681","12180.18","9135.14"
"244.3.160.204","25798","244.3.160.254","443","7","448","4","256","3","192","16.195921000","0.1681","12180.40","9135.30"
"244.3.160.204","58895","244.3.160.239","80","7","448","4","256","3","192","214.230064000","0.1681","12181.63","9136.22"
"244.3.160.204","33823","244.3.160.254","80","7","448","4","256","3","192","64.203788000","0.1681","12184.38","9138.29"
"244.3.160.204","38167","244.3.160.254","443","7","448","4","256","3","192","90.208157000","0.1681","12185.25","9138.94"
"244.3.160.204","24805","244.3.160.239","80","7","448","4","256","3","192","10.196364000","0.1680","12188.73","9141.55"
"244.3.160.204","25475","244.3.160.239","80","7","448","4","256","3","192","14.196866000","0.1680","12189.03","9141.77"
"244.3.160.204","60884","244.3.160.89","80","7","448","4","256","3","192","226.229145000","0.1680","12189.32","9141.99"
"244.3.160.239","62337","85.241.98.37","80","10","1803","6","1147","4","656","154.827978000","0.1680","54627.18","31242.74"
"244.3.160.204","32482","244.3.160.254","443","7","448","4","256","3","192","56.202602000","0.1679","12194.47","9145.85"
"244.3.160.204","58220","244.3.160.254","80","7","448","4","256","3","192","210.227871000","0.1679","12195.12","9146.34"
"244.3.160.204","37494","244.3.160.89","80","7","448","4","256","3","192","86.207423000","0.1679","12195.56","9146.67"
"244.3.160.204","31483","244.3.160.254","443","7","448","4","256","3","192","50.201388000","0.1679","12196.14","9147.10"
"244.3.160.204","33482","244.3.160.89","80","7","448","4","256","3","192","62.203073000","0.1679","12196.65","9147.49"
"244.3.160.239","61597","177.124.75.164","80","13","3103","7","2367","6","736","51.606613000","0.1678","112843.25","35087.72"
"244.3.160.239","62403","41.177.254.197","80","35","25009","15","1824","20","23185","161.676349000","0.1676","87044.18","1106425.12"
"244.3.160.204","60218","244.3.160.89","80","7","448","4","256","3","192","222.228572000","0.1676","12217.82","9163.37"
"244.3.160.204","32159","244.3.160.239","80","7","448","4","256","3","192","54.203396000","0.1676","12220.52","9165.39"
"244.3.181.123","15521","244.3.160.239","80","33","17844","13","1904","20","15940","0.852805000","0.1676","90892.27","760936.37"
"244.3.160.204","33822","244.3.160.254","443","7","448","4","256","3","192","64.203535000","0.1674","12231.76","9173.82"
"244.3.160.204","23127","244.3.160.254","80","7","448","4","256","3","192","0.193134000","0.1674","12232.34","9174.26"
"244.3.160.204","57546","244.3.160.89","80","7","448","4","256","3","192","206.226791000","0.1674","12232.71","9174.53"
"244.3.160.204","34831","244.3.160.239","80","7","448","4","256","3","192","70.206499000","0.1674","12234.83","9176.12"
"244.3.3.145","12993","244.3.160.239","80","39","26857","16","1655","23","25202","202.955839000","0.1673","79116.10","1204763.70"
"244.3.160.204","61561","244.3.160.254","4000","7","448","4","256","3","192","230.231417000","0.1673","12243.60","9182.70"
"41.177.98.98","43378","244.3.31.184","7830","4","256","2","128","2","128","58.298308000","0.1673","6122.24","6122.24"
"244.3.160.204","30813","244.3.160.254","4000","7","448","4","256","3","192","46.200923000","0.1672","12247.78","9185.83"
"244.3.160.204","50540","244.3.160.239","80","7","448","4","256","3","192","164.223404000","0.1672","12249.02","9186.77"
"244.3.160.204","26465","244.3.160.89","80","7","448","4","256","3","192","20.195392000","0.1671","12252.98","9189.74"
"244.3.160.204","39844","244.3.160.239","80","7","448","4","256","3","192","100.224626000","0.1671","12253.42","9190.07"
"244.3.160.204","23126","244.3.160.254","443","7","448","4","256","3","192","0.192877000","0.1671","12257.89","9193.42"
"244.3.160.204","58219","244.3.160.254","443","7","448","4","256","3","192","210.227585000","0.1671","12259.66","9194.74"
"244.3.56.90","16246","244.3.160.239","80","15","5794","7","1490","8","4304","15.459409000","0.1670","71357.59","206122.86"
"244.3.160.204","58212","244.3.160.89","80","7","448","4","256","3","192","210.225723000","0.1669","12274.20","9205.65"
"244.3.160.204","27464","244.3.160.89","80","7","448","4","256","3","192","26.195582000","0.1668","12276.41","9207.31"
"244.3.160.204","61558","244.3.160.89","80","7","448","4","256","3","192","230.230607000","0.1668","12280.68","9210.51"
"244.3.160.204","47863","244.3.160.239","80","7","448","4","256","3","192","148.222020000","0.1667","12285.25","9213.94"
"244.3.181.123","5535","244.3.160.239","80","12","1988","6","1282","6","706","110.820520000","0.1667","61524.06","33881.43"
"244.3.160.204","24800","244.3.160.254","80","7","448","4","256","3","192","10.194998000","0.1667","12286.13","9214.60"
"244.3.181.123","13351","244.3.160.239","80","10","1708","5","1249","5","459","107.593701000","0.1667","59946.84","22030.11"
"244.3.160.239","61573","177.124.75.164","80","13","3332","7","2367","6","965","49.685388000","0.1667","113621.91","46322.41"
"244.3.160.204","45186","244.3.160.239","443","7","448","4","256","3","192","132.219666000","0.1667","12289.16","9216.87"
"244.3.160.204","36495","244.3.160.254","80","7","448","4","256","3","192","80.205929000","0.1666","12296.24","9222.18"
"244.3.160.204","24126","244.3.160.89","80","7","448","4","256","3","192","6.194406000","0.1665","12298.16","9223.62"
"244.3.181.123","12469","244.3.160.239","80","10","1698","5","1239","5","459","106.911638000","0.1665","59537.25","22056.17"
"244.3.160.204","32153","244.3.160.254","4000","7","448","4","256","3","192","54.201812000","0.1665","12301.63","9226.22"
"244.3.160.204","56547","244.3.160.254","80","7","448","4","256","3","192","200.225650000","0.1664","12304.22","9228.16"
"244.3.160.204","56550","244.3.160.254","4000","7","448","4","256","3","192","200.226437000","0.1664","12307.03","9230.27"
"244.3.160.204","30810","244.3.160.89","80","7","448","4","256","3","192","46.200120000","0.1664","12310.43","9232.82"
"244.3.160.204","38160","244.3.160.89","80","7","448","4","256","3","192","90.206293000","0.1662","12320.28","9240.21"
"244.3.160.204","56546","244.3.160.254","443","7","448","4","256","3","192","200.225369000","0.1661","12333.63","9250.23"
"244.3.160.204","39841","244.3.160.254","80","7","448","4","256","3","192","100.223601000","0.1660","12334.97","9251.23"
"244.3.160.239","61582","177.124.75.164","80","13","3143","7","2367","6","776","50.259376000","0.1659","114129.35","37416.30"
"244.3.160.204","32150","244.3.160.89","80","7","448","4","256","3","192","54.200988000","0.1658","12349.25","9261.94"
"244.3.160.204","58889","244.3.160.254","4000","7","448","4","256","3","192","214.228422000","0.1658","12350.59","9262.94"
"41.177.199.139","10183","244.3.160.239","80","10","1702","5","1285","5","417","176.845801000","0.1658","61995.68","20118.44"
"244.3.160.204","24799","244.3.160.254","443","7","448","4","256","3","192","10.194741000","0.1658","12351.26","9263.45"
"244.3.160.204","36494","244.3.160.254","443","7","448","4","256","3","192","80.205684000","0.1657","12359.54","9269.65"
"244.3.160.204","31476","244.3.160.89","80","7","448","4","256","3","192","50.199528000","0.1655","12371.71","9278.78"
"244.3.160.204","59885","244.3.160.89","80","7","448","4","256","3","192","220.228309000","0.1655","12372.60","9279.45"
"244.3.160.204","50537","244.3.160.254","80","7","448","4","256","3","192","164.222574000","0.1655","12373.95","9280.46"
"244.3.160.204","52876","244.3.160.239","80","7","448","4","256","3","192","178.225351000","0.1655","12375.59","9281.70"
"244.3.160.204","25469","244.3.160.254","4000","7","448","4","256","3","192","14.195252000","0.1654","12379.04","9284.28"
"244.3.160.204","47860","244.3.160.254","80","7","448","4","256","3","192","148.221185000","0.1653","12388.40","9291.30"
"244.3.160.204","39840","244.3.160.254","443","7","448","4","256","3","192","100.223275000","0.1653","12389.00","9291.75"
"244.3.160.204","24792","244.3.160.89","80","7","448","4","256","3","192","10.192940000","0.1653","12391.02","9293.26"
"244.3.160.239","61600","177.124.75.164","80","13","3544","7","2367","6","1177","51.833530000","0.1652","114596.26","56983.44"
"244.3.160.204","41179","244.3.160.239","80","7","448","4","256","3","192","108.218678000","0.1650","12409.19","9306.89"
"244.3.160.239","61629","117.246.95.43","80","14","3639","8","2846","6","793","57.880559000","0.1650","137955.27","38439.40"
"244.3.181.123","13696","244.3.160.239","80","10","1701","5","1242","5","459","106.745812000","0.1650","60210.52","22251.71"
"244.3.181.123","2918","244.3.160.239","80","10","2011","5","1515","5","496","133.094060000","0.1650","73447.42","24046.15"
"41.177.199.139","15321","244.3.160.239","80","11","2697","5","1256","6","1441","201.317234000","0.1650","60894.02","69863.28"
"41.177.199.139","5694","244.3.160.239","80","13","4567","6","1147","7","3420","99.438596000","0.1650","55611.78","165817.18"
"244.3.160.248","47192","41.177.26.72","80","13","3439","7","1409","6","2030","24.280699000","0.1650","68315.15","98424.24"
"244.3.160.204","42516","244.3.160.239","80","7","448","4","256","3","192","116.219741000","0.1649","12421.98","9316.49"
"244.3.160.204","50536","244.3.160.254","443","7","448","4","256","3","192","164.222314000","0.1648","12427.49","9320.61"
"244.3.160.204","54547","244.3.160.239","80","7","448","4","256","3","192","188.226243000","0.1647","12431.26","9323.44"
"244.3.160.239","61722","117.246.95.43","80","10","1563","6","1021","4","542","60.311698000","0.1647","49600.13","26330.33"
"244.3.160.204","46192","244.3.160.239","80","7","448","4","256","3","192","138.221040000","0.1647","12437.83","9328.37"
"41.177.90.57","3684","244.3.41.84","23","4","256","2","128","2","128","153.481624000","0.1646","6221.52","6221.52"
"77.197.210.198","23624","41.177.26.176","80","16","12230","6","384","10","11846","0.229876000","0.1645","18669.89","575946.71"
"244.3.160.204","47859","244.3.160.254","443","7","448","4","256","3","192","148.220917000","0.1645","12448.41","9336.31"
"41.177.93.111","1225","244.3.41.84","23","4","256","2","128","2","128","32.455616000","0.1644","6228.03","6228.03"
"244.3.160.204","34825","244.3.160.254","4000","7","448","4","256","3","192","70.204843000","0.1644","12458.18","9343.63"
"77.197.210.152","31996","41.177.26.15","80","7","1028","4","637","3","391","221.838192000","0.1644","31003.22","19030.24"
"244.3.160.204","58886","244.3.160.89","80","7","448","4","256","3","192","214.227614000","0.1644","12460.98","9345.74"
"244.3.160.204","25466","244.3.160.89","80","7","448","4","256","3","192","14.194416000","0.1643","12462.04","9346.53"
"244.3.160.204","38843","244.3.160.239","80","7","448","4","256","3","192","94.210557000","0.1642","12468.95","9351.71"
"244.3.3.145","6462","244.3.160.239","80","13","3326","6","1014","7","2312","202.568950000","0.1641","49431.47","112707.64"
"244.3.160.204","50532","244.3.160.254","4000","7","448","4","256","3","192","164.221259000","0.1640","12488.11","9366.08"
"41.177.192.117","4922","244.3.160.239","80","19","9098","8","1488","11","7610","161.504889000","0.1640","72588.46","371235.36"
"244.3.160.204","42850","244.3.160.239","80","7","448","4","256","3","192","118.219220000","0.1640","12489.10","9366.82"
"77.197.128.41","5832","41.177.26.176","80","7","872","4","531","3","341","190.505846000","0.1640","25907.02","16637.09"
"244.3.160.204","47196","244.3.160.239","443","7","448","4","256","3","192","144.220636000","0.1639","12492.15","9369.11"
"244.3.160.204","52871","244.3.160.254","80","7","448","4","256","3","192","178.223970000","0.1639","12495.50","9371.63"
"244.3.181.123","3021","244.3.160.239","80","12","2653","6","1074","6","1579","123.435054000","0.1638","52459.02","77125.50"
"244.3.77.218","12852","244.3.160.239","80","10","1624","5","1184","5","440","228.910236000","0.1638","57831.91","21491.59"
"41.177.199.139","8516","244.3.160.239","80","12","2751","6","1147","6","1604","99.443675000","0.1638","56025.01","78347.09"
"244.3.160.204","28147","244.3.160.239","80","7","448","4","256","3","192","30.199563000","0.1637","12507.40","9380.55"
"244.3.160.204","54544","244.3.160.254","80","7","448","4","256","3","192","188.225410000","0.1637","12513.29","9384.97"
"244.3.153.102","2859","244.3.160.80","443","14","2374","7","1708","7","666","200.321521000","0.1636","83515.17","32565.05"
"244.3.160.204","38837","244.3.160.254","4000","7","448","4","256","3","192","94.208924000","0.1636","12518.80","9389.10"
"244.3.160.204","38834","244.3.160.89","80","7","448","4","256","3","192","94.208086000","0.1635","12523.24","9392.43"
"244.3.160.204","44521","244.3.160.239","80","7","448","4","256","3","192","128.220775000","0.1635","12525.69","9394.27"
"244.3.160.204","50529","244.3.160.89","80","7","448","4","256","3","192","164.220450000","0.1635","12526.30","9394.73"
"244.3.160.239","61469","117.246.95.43","80","14","3672","8","2879","6","793","34.897893000","0.1635","140891.77","38807.63"
"15.186.164.176","50779","41.177.26.46","80","12","3221","6","842","6","2379","87.505063000","0.1635","41210.37","116436.43"
"244.3.160.204","47855","244.3.160.254","4000","7","448","4","256","3","192","148.219882000","0.1634","12529.83","9397.37"
"244.3.160.204","41176","244.3.160.254","80","7","448","4","256","3","192","108.217852000","0.1634","12533.20","9399.90"
"244.3.160.204","55884","244.3.160.239","80","7","448","4","256","3","192","196.227310000","0.1633","12538.34","9403.76"
"244.3.160.204","34822","244.3.160.89","80","7","448","4","256","3","192","70.204006000","0.1633","12541.03","9405.77"
"244.3.160.204","52870","244.3.160.254","443","7","448","4","256","3","192","178.223703000","0.1632","12549.87","9412.40"
"244.3.160.204","39836","244.3.160.254","4000","7","448","4","256","3","192","100.221983000","0.1631","12556.17","9417.13"
"244.3.160.204","47529","244.3.160.239","80","7","448","4","256","3","192","146.222265000","0.1630","12562.88","9422.16"
"244.3.160.204","42513","244.3.160.254","80","7","448","4","256","3","192","116.218948000","0.1630","12564.49","9423.37"
"244.3.181.123","16365","244.3.160.239","80","10","1712","5","1253","5","459","107.255781000","0.1630","61504.10","22530.23"
"244.3.160.204","54543","244.3.160.254","443","7","448","4","256","3","192","188.225088000","0.1630","12566.27","9424.70"
"41.177.98.143","8001","194.120.155.106","4435","3","298","1","140","2","158","194.594454000","0.1629","N/A","7760.50"
"244.3.160.204","45188","244.3.160.239","80","7","448","4","256","3","192","132.220187000","0.1628","12578.46","9433.85"
"244.3.153.55","2860","41.177.24.241","443","16","3173","8","2244","8","929","107.070209000","0.1628","110277.04","45653.91"
"244.3.160.204","47852","244.3.160.89","80","7","448","4","256","3","192","148.219066000","0.1627","12585.96","9439.47"
"253.160.251.90","1528","253.37.253.43","446","14","11028","0","0","14","11028","145.881973000","0.1627","N/A","542219.55"
"244.3.160.204","41175","244.3.160.254","443","7","448","4","256","3","192","108.217584000","0.1627","12587.28","9440.46"
"244.3.160.204","43517","244.3.160.239","80","7","448","4","256","3","192","122.219690000","0.1627","12588.36","9441.27"
"244.3.160.204","39833","244.3.160.89","80","7","448","4","256","3","192","100.220990000","0.1627","12589.52","9442.14"
"151.77.192.83","7866","244.3.160.239","80","12","3762","6","1731","6","2031","8.925792000","0.1627","85129.40","99883.20"
"244.3.160.204","55214","244.3.160.239","80","7","448","4","256","3","192","192.226399000","0.1626","12597.81","9448.35"
"244.3.160.204","42185","244.3.160.239","80","7","448","4","256","3","192","114.219258000","0.1625","12600.13","9450.10"
"244.3.181.123","10693","244.3.160.239","80","10","1705","5","1246","5","459","107.426057000","0.1625","61355.89","22602.21"
"244.3.160.204","42512","244.3.160.254","443","7","448","4","256","3","192","116.218656000","0.1624","12613.48","9460.11"
"244.3.160.204","42844","244.3.160.254","4000","7","448","4","256","3","192","118.217630000","0.1623","12615.34","9461.51"
"68.33.110.176","7001","244.3.160.239","80","10","2453","5","1347","5","1106","127.799463000","0.1622","66418.89","54535.48"
"244.3.160.204","28141","244.3.160.254","4000","7","448","4","256","3","192","30.197945000","0.1622","12627.55","9470.67"
"244.3.160.204","49200","244.3.160.239","80","7","448","4","256","3","192","156.223164000","0.1622","12627.71","9470.78"
"90.218.72.197","14198","244.3.160.239","80","10","1467","5","900","5","567","11.994786000","0.1622","44395.12","27968.92"
"68.64.225.84","49360","244.3.210.197","80","7","2309","4","464","3","1845","180.219693000","0.1622","22890.83","91020.65"
"244.3.160.204","51872","244.3.160.239","80","7","448","4","256","3","192","172.224796000","0.1621","12630.44","9472.83"
"244.3.160.204","44517","244.3.160.254","4000","7","448","4","256","3","192","128.219681000","0.1621","12634.96","9476.22"
"244.3.160.239","61428","117.246.95.43","80","14","3621","8","2893","6","728","29.251114000","0.1621","142803.37","35935.31"
"244.3.31.181","49928","41.177.98.220","7030","4","256","2","128","2","128","44.737776000","0.1620","6321.22","6321.22"
"244.3.160.239","62319","85.241.98.37","80","10","2425","6","1721","4","704","152.531734000","0.1620","84999.20","34770.15"
"244.3.160.204","54539","244.3.160.254","4000","7","448","4","256","3","192","188.224011000","0.1619","12647.36","9485.52"
"244.3.155.77","14404","244.3.160.239","80","13","2624","7","1834","6","790","68.518949000","0.1619","90609.85","39030.42"
"244.3.160.204","46187","244.3.160.254","80","7","448","4","256","3","192","138.219669000","0.1619","12649.24","9486.93"
"244.3.153.102","2857","244.3.160.80","443","14","2378","7","1712","7","666","199.757990000","0.1619","84593.86","32908.59"
"244.3.160.204","53212","244.3.160.239","80","7","448","4","256","3","192","180.225505000","0.1619","12650.64","9487.98"
"244.3.160.204","55881","244.3.160.254","80","7","448","4","256","3","192","196.226482000","0.1618","12654.86","9491.15"
"244.3.160.204","41846","244.3.160.239","80","7","448","4","256","3","192","112.218958000","0.1618","12659.87","9494.90"
"244.3.160.204","43512","244.3.160.254","80","7","448","4","256","3","192","122.218325000","0.1618","12660.42","9495.31"
"244.3.160.239","61602","177.124.75.164","80","13","3389","7","2367","6","1022","52.084301000","0.1618","117064.49","50544.95"
"244.3.160.239","61569","177.124.75.164","80","15","4736","8","2430","7","2306","49.602606000","0.1617","120186.96","114053.96"
"77.197.210.123","17837","41.177.26.15","80","7","1035","4","643","3","392","132.820295000","0.1617","31806.49","19390.58"
"244.3.160.204","28138","244.3.160.89","80","7","448","4","256","3","192","30.197146000","0.1617","12663.71","9497.78"
"244.3.153.102","2862","244.3.160.80","443","14","2371","7","1705","7","666","201.154338000","0.1617","84379.83","32960.10"
"244.3.153.102","2861","244.3.160.80","443","14","2366","7","1700","7","666","200.984923000","0.1616","84139.15","32962.75"
"244.3.160.204","50201","244.3.160.239","80","7","448","4","256","3","192","162.222956000","0.1616","12671.31","9503.48"
"244.3.160.204","42180","244.3.160.254","80","7","448","4","256","3","192","114.217904000","0.1615","12678.52","9508.89"
"244.3.160.204","52863","244.3.160.89","80","7","448","4","256","3","192","178.221903000","0.1615","12681.04","9510.78"
"244.3.160.204","42841","244.3.160.89","80","7","448","4","256","3","192","118.216824000","0.1615","12683.47","9512.60"
"244.3.160.204","41171","244.3.160.254","4000","7","448","4","256","3","192","108.216509000","0.1614","12685.98","9514.49"
"244.3.153.102","2856","244.3.160.80","443","14","2359","7","1693","7","666","199.423078000","0.1614","83904.82","33006.86"
"244.3.160.204","54213","244.3.160.239","80","7","448","4","256","3","192","186.226542000","0.1613","12693.69","9520.27"
"244.3.160.239","61284","48.151.224.205","80","18","8760","9","1093","9","7667","3.266753000","0.1613","54203.50","380217.95"
"244.3.160.204","44514","244.3.160.254","80","7","448","4","256","3","192","128.218875000","0.1613","12699.20","9524.40"
"244.3.160.204","40845","244.3.160.239","80","7","448","4","256","3","192","106.219085000","0.1612","12702.51","9526.88"
"244.3.3.145","15357","244.3.160.239","80","12","1818","6","1017","6","801","202.845874000","0.1612","50472.09","39752.35"
"244.3.160.204","46186","244.3.160.254","443","7","448","4","256","3","192","138.219412000","0.1612","12708.03","9531.02"
"244.3.160.204","55880","244.3.160.254","443","7","448","4","256","3","192","196.226248000","0.1612","12708.10","9531.08"
"244.3.160.204","45185","244.3.160.254","80","7","448","4","256","3","192","132.219365000","0.1611","12708.89","9531.67"
"244.3.160.204","42179","244.3.160.254","443","7","448","4","256","3","192","114.217641000","0.1611","12709.76","9532.32"
"244.3.160.239","61361","117.246.95.43","80","14","3673","8","2880","6","793","16.240392000","0.1611","142988.36","39371.45"
"244.3.160.204","49197","244.3.160.254","80","7","448","4","256","3","192","156.222321000","0.1611","12711.18","9533.39"
"244.3.160.204","45858","244.3.160.239","80","7","448","4","256","3","192","136.221433000","0.1611","12714.97","9536.23"
"244.3.160.204","47524","244.3.160.254","80","7","448","4","256","3","192","146.220903000","0.1609","12725.87","9544.40"
"244.3.160.204","49534","244.3.160.239","80","7","448","4","256","3","192","158.222360000","0.1609","12727.37","9545.53"
"244.3.160.239","61767","41.43.180.128","80","13","3389","7","1992","6","1397","74.111245000","0.1607","99155.66","69538.38"
"244.3.160.204","55210","244.3.160.254","4000","7","448","4","256","3","192","192.225274000","0.1607","12745.35","9559.02"
"244.3.160.204","51869","244.3.160.254","80","7","448","4","256","3","192","172.223975000","0.1607","12746.39","9559.79"
"244.3.160.204","41842","244.3.160.254","4000","7","448","4","256","3","192","112.217881000","0.1606","12748.53","9561.40"
"244.3.160.204","43511","244.3.160.254","443","7","448","4","256","3","192","122.218054000","0.1606","12749.72","9562.29"
"244.3.160.204","40510","244.3.160.254","4000","7","448","4","256","3","192","104.217181000","0.1606","12752.02","9564.02"
"244.3.160.239","61609","177.124.75.164","80","13","3305","7","2367","6","938","52.844714000","0.1606","117938.69","46737.00"
"244.3.160.204","41513","244.3.160.239","443","7","448","4","256","3","192","110.218217000","0.1605","12759.89","9569.91"
"244.3.160.204","44513","244.3.160.254","443","7","448","4","256","3","192","128.218615000","0.1605","12760.20","9570.15"
"244.3.160.204","54536","244.3.160.89","80","7","448","4","256","3","192","188.223211000","0.1605","12761.71","9571.29"
"244.3.160.204","49196","244.3.160.254","443","7","448","4","256","3","192","156.222062000","0.1604","12767.12","9575.34"
"244.3.160.204","50196","244.3.160.254","80","7","448","4","256","3","192","162.221591000","0.1603","12772.62","9579.46"
"244.3.160.204","53209","244.3.160.254","80","7","448","4","256","3","192","180.224639000","0.1603","12776.04","9582.03"
"244.3.160.204","45184","244.3.160.254","443","7","448","4","256","3","192","132.219114000","0.1603","12777.72","9583.29"
"244.3.153.102","2849","244.3.160.80","443","16","3632","8","1935","8","1697","197.940223000","0.1602","96615.34","84731.90"
"244.3.160.204","42508","244.3.160.254","4000","7","448","4","256","3","192","116.217628000","0.1602","12782.66","9587.00"
"244.3.160.239","61608","177.124.75.164","80","13","3632","7","2367","6","1265","52.804658000","0.1602","118225.86","63183.66"
"244.3.153.102","2855","244.3.160.80","443","14","2359","7","1693","7","666","199.129902000","0.1601","84572.30","33269.43"
"244.3.160.204","40840","244.3.160.254","80","7","448","4","256","3","192","106.217744000","0.1601","12793.44","9595.08"
"244.3.160.204","55207","244.3.160.254","80","7","448","4","256","3","192","192.224505000","0.1601","12794.32","9595.74"
"244.3.160.204","41168","244.3.160.89","80","7","448","4","256","3","192","108.215715000","0.1600","12796.48","9597.36"
"244.3.160.204","47523","244.3.160.254","443","7","448","4","256","3","192","146.220647000","0.1600","12797.44","9598.08"
"244.3.160.204","43856","244.3.160.239","80","7","448","4","256","3","192","124.219933000","0.1600","12799.12","9599.34"
"244.3.153.102","2860","244.3.160.80","443","14","2375","7","1709","7","666","200.522916000","0.1600","85453.20","33301.25"
"244.3.160.204","45854","244.3.160.254","4000","7","448","4","256","3","192","136.220361000","0.1600","12804.00","9603.00"
"244.3.160.204","51868","244.3.160.254","443","7","448","4","256","3","192","172.223707000","0.1599","12806.96","9605.22"
"244.3.77.218","15796","244.3.160.239","80","14","4309","7","1171","7","3138","228.699171000","0.1599","58596.14","157023.66"
"244.3.160.239","61590","177.124.75.164","80","13","3482","7","2367","6","1115","51.094822000","0.1598","118498.86","55820.12"
"244.3.160.204","52542","244.3.160.239","80","7","448","4","256","3","192","176.225409000","0.1598","12819.23","9614.42"
"244.3.160.204","53208","244.3.160.254","443","7","448","4","256","3","192","180.224368000","0.1598","12819.95","9614.96"
"41.177.168.181","12003","244.3.160.239","80","12","1780","6","1069","6","711","79.126450000","0.1597","53546.05","35613.88"
"244.3.160.204","50195","244.3.160.254","443","7","448","4","256","3","192","162.221338000","0.1597","12825.89","9619.42"
"244.3.160.204","55206","244.3.160.254","443","7","448","4","256","3","192","192.224214000","0.1597","12827.50","9620.62"
"244.3.160.239","61787","197.154.128.197","80","15","6902","8","1245","7","5657","77.285300000","0.1596","62395.85","283512.71"
"244.3.3.145","16143","244.3.160.239","80","12","1811","6","1011","6","800","202.847732000","0.1596","50669.39","40094.47"
"244.3.160.204","54208","244.3.160.254","80","7","448","4","256","3","192","186.225168000","0.1596","12836.02","9627.02"
"244.3.160.204","46179","244.3.160.89","80","7","448","4","256","3","192","138.217580000","0.1595","12837.95","9628.46"
"244.3.160.239","61610","177.124.75.164","80","13","3442","7","2367","6","1075","53.044257000","0.1595","118746.32","53929.99"
"244.3.160.204","40839","244.3.160.254","443","7","448","4","256","3","192","106.217482000","0.1595","12843.43","9632.57"
"244.3.160.204","55876","244.3.160.254","4000","7","448","4","256","3","192","196.225120000","0.1595","12843.59","9632.69"
"244.3.160.239","62334","85.241.98.37","80","12","3060","7","1084","5","1976","154.598032000","0.1593","54454.92","99264.68"
"244.3.160.204","43853","244.3.160.254","80","7","448","4","256","3","192","124.219197000","0.1592","12861.90","9646.42"
"244.3.160.204","47198","244.3.160.239","80","7","448","4","256","3","192","144.221163000","0.1592","12866.50","9649.88"
"244.3.160.204","51864","244.3.160.254","4000","7","448","4","256","3","192","172.222647000","0.1591","12870.30","9652.73"
"244.3.160.204","42505","244.3.160.89","80","7","448","4","256","3","192","116.216815000","0.1591","12873.62","9655.22"
"244.3.160.204","45180","244.3.160.254","4000","7","448","4","256","3","192","132.218077000","0.1591","12876.29","9657.22"
"244.3.160.204","53204","244.3.160.254","4000","7","448","4","256","3","192","180.223297000","0.1589","12886.74","9665.06"
"244.3.160.204","41839","244.3.160.254","80","7","448","4","256","3","192","112.217126000","0.1589","12888.28","9666.21"
"41.177.168.181","2074","244.3.160.239","80","12","1806","6","1067","6","739","79.127280000","0.1589","53723.38","37208.60"
"244.3.160.204","53543","244.3.160.239","80","7","448","4","256","3","192","182.225513000","0.1589","12889.74","9667.31"
"244.3.164.46","13484","244.3.160.239","80","31","17394","12","1512","19","15882","153.545749000","0.1588","76170.80","800095.72"
"244.3.160.204","49192","244.3.160.254","4000","7","448","4","256","3","192","156.220992000","0.1588","12897.21","9672.91"
"244.3.160.204","54207","244.3.160.254","443","7","448","4","256","3","192","186.224911000","0.1588","12900.06","9675.04"
"244.3.153.102","2858","244.3.160.80","443","14","2381","7","1715","7","666","200.129827000","0.1587","86454.61","33573.63"
"244.3.160.204","49528","244.3.160.254","4000","7","448","4","256","3","192","158.220702000","0.1587","12905.99","9679.49"
"244.3.160.204","48530","244.3.160.239","80","7","448","4","256","3","192","152.222504000","0.1587","12906.89","9680.16"
"244.3.160.204","52538","244.3.160.254","4000","7","448","4","256","3","192","176.224260000","0.1587","12907.62","9680.71"
"244.3.160.204","42172","244.3.160.89","80","7","448","4","256","3","192","114.215810000","0.1586","12914.29","9685.72"
"244.3.160.204","55873","244.3.160.89","80","7","448","4","256","3","192","196.224312000","0.1586","12914.70","9686.02"
"244.3.34.121","3560","244.3.41.84","23","4","256","2","128","2","128","153.458972000","0.1585","6458.65","6458.65"
"244.3.160.239","61611","177.124.75.164","80","13","3329","7","2367","6","962","53.084988000","0.1585","119462.49","48552.14"
"244.3.160.204","43504","244.3.160.89","80","7","448","4","256","3","192","122.216246000","0.1585","12922.28","9691.71"
"244.3.34.145","1565","244.3.41.84","23","4","256","2","128","2","128","153.458284000","0.1584","6463.91","6463.91"
"244.3.153.102","2868","244.3.160.80","443","16","2598","8","1868","8","730","211.729663000","0.1584","94338.07","36866.59"
"244.3.160.204","43852","244.3.160.254","443","7","448","4","256","3","192","124.218888000","0.1584","12928.56","9696.42"
"244.3.160.204","40514","244.3.160.239","80","7","448","4","256","3","192","104.218274000","0.1584","12928.64","9696.48"
"244.3.160.204","55553","244.3.160.239","80","7","448","4","256","3","192","194.226771000","0.1584","12929.54","9697.15"
"244.3.160.204","45851","244.3.160.254","80","7","448","4","256","3","192","136.219571000","0.1584","12931.09","9698.32"
"244.3.160.204","46859","244.3.160.239","80","7","448","4","256","3","192","142.222137000","0.1584","12931.91","9698.93"
"244.3.160.204","53882","244.3.160.239","80","7","448","4","256","3","192","184.225898000","0.1583","12935.58","9701.69"
"244.3.160.239","61754","117.246.95.43","80","10","1568","6","1026","4","542","68.705703000","0.1582","51886.32","27409.73"
"244.3.160.204","49863","244.3.160.254","80","7","448","4","256","3","192","160.221095000","0.1582","12947.28","9710.46"
"244.3.160.204","40832","244.3.160.89","80","7","448","4","256","3","192","106.215657000","0.1582","12948.50","9711.38"
"41.177.3.203","58762","244.3.31.68","4888","26","4288","12","1723","14","2565","6.797117000","0.1582","87154.46","129745.31"
"244.3.160.204","45850","244.3.160.254","443","7","448","4","256","3","192","136.219304000","0.1581","12950.47","9712.85"
"244.3.160.204","41838","244.3.160.254","443","7","448","4","256","3","192","112.216865000","0.1581","12951.21","9713.40"
"244.3.160.204","48869","244.3.160.239","80","7","448","4","256","3","192","154.222324000","0.1581","12951.78","9713.83"
"244.3.160.204","44857","244.3.160.239","80","7","448","4","256","3","192","130.220729000","0.1581","12957.35","9718.01"
"244.3.160.204","51861","244.3.160.89","80","7","448","4","256","3","192","172.221852000","0.1580","12958.01","9718.51"
"244.3.160.204","53201","244.3.160.89","80","7","448","4","256","3","192","180.222552000","0.1580","12959.73","9719.80"
"244.3.160.239","61788","197.154.128.197","80","10","1766","6","1113","4","653","77.286992000","0.1580","56361.21","33067.27"
"151.77.185.176","11993","244.3.160.239","80","74","53716","25","2666","49","51050","38.947086000","0.1580","135029.22","2585611.99"
"244.3.160.204","45177","244.3.160.89","80","7","448","4","256","3","192","132.217307000","0.1579","12966.29","9724.72"
"244.3.160.204","43186","244.3.160.239","80","7","448","4","256","3","192","120.219706000","0.1579","12972.45","9729.34"
"244.3.160.204","49866","244.3.160.254","4000","7","448","4","256","3","192","160.221893000","0.1579","12973.19","9729.89"
"244.3.160.204","49862","244.3.160.254","443","7","448","4","256","3","192","160.220856000","0.1578","12975.25","9731.44"
"244.3.160.239","61233","85.241.98.37","80","13","5978","7","1526","6","4452","0.721960000","0.1578","77386.80","225770.67"
"244.3.160.204","40175","244.3.160.239","80","7","448","4","256","3","192","102.218218000","0.1577","12983.14","9737.36"
"244.3.153.102","2867","244.3.160.80","443","16","2607","8","1877","8","730","211.675878000","0.1577","95204.88","37026.94"
"244.3.160.204","50871","244.3.160.239","80","7","448","4","256","3","192","166.223730000","0.1577","12988.99","9741.74"
"244.3.77.160","3972","244.3.41.84","23","4","256","2","128","2","128","153.481432000","0.1577","6494.66","6494.66"
"244.3.160.204","46528","244.3.160.239","80","7","448","4","256","3","192","140.221609000","0.1576","12993.60","9745.20"
"244.3.160.204","48526","244.3.160.254","4000","7","448","4","256","3","192","152.221404000","0.1576","12996.99","9747.74"
"244.3.160.204","49525","244.3.160.89","80","7","448","4","256","3","192","158.219850000","0.1576","12997.40","9748.05"
"244.3.160.204","49870","244.3.160.239","80","7","448","4","256","3","192","160.222985000","0.1576","12998.22","9748.67"
"244.3.160.204","52535","244.3.160.254","80","7","448","4","256","3","192","176.223474000","0.1575","12999.87","9749.90"
"244.3.160.204","47194","244.3.160.254","4000","7","448","4","256","3","192","144.220096000","0.1575","13000.04","9750.03"
"244.3.160.204","53537","244.3.160.254","4000","7","448","4","256","3","192","182.223842000","0.1575","13003.09","9752.32"
"244.3.160.204","47516","244.3.160.89","80","7","448","4","256","3","192","146.218829000","0.1574","13010.28","9757.71"
"244.3.160.204","49189","244.3.160.89","80","7","448","4","256","3","192","156.220170000","0.1574","13011.68","9758.76"
"41.177.37.102","1073","244.3.41.84","23","4","256","2","128","2","128","153.478555000","0.1574","6506.54","6506.54"
"244.3.160.239","61482","177.124.75.164","80","13","3512","7","2182","6","1330","38.174512000","0.1572","111029.13","67675.87"
"244.3.160.204","55548","244.3.160.254","80","7","448","4","256","3","192","194.225419000","0.1572","13027.41","9770.56"
"244.3.160.204","43848","244.3.160.254","4000","7","448","4","256","3","192","124.217810000","0.1571","13036.53","9777.40"
"244.3.160.204","48523","244.3.160.254","80","7","448","4","256","3","192","152.220587000","0.1571","13038.86","9779.14"
"244.3.160.204","44187","244.3.160.239","80","7","448","4","256","3","192","126.220717000","0.1570","13041.84","9781.38"
"244.3.160.204","48864","244.3.160.254","80","7","448","4","256","3","192","154.220996000","0.1570","13042.51","9781.88"
"244.3.160.204","50188","244.3.160.89","80","7","448","4","256","3","192","162.219490000","0.1570","13044.92","9783.69"
"244.3.160.204","46853","244.3.160.254","4000","7","448","4","256","3","192","142.220508000","0.1570","13045.08","9783.81"
"244.3.160.248","50020","41.177.26.72","80","9","3142","5","1240","4","1902","233.107653000","0.1569","63233.45","96991.95"
"244.3.160.204","46525","244.3.160.254","80","7","448","4","256","3","192","140.220762000","0.1569","13055.65","9791.73"
"244.3.160.204","54200","244.3.160.89","80","7","448","4","256","3","192","186.223101000","0.1569","13056.39","9792.30"
"244.3.160.204","53878","244.3.160.254","4000","7","448","4","256","3","192","184.224760000","0.1568","13063.14","9797.36"
"41.177.3.215","35758","41.177.180.176","383","5","995","0","0","5","995","214.582974000","0.1567","N/A","50787.98"
"244.3.151.202","60606","244.3.41.84","23","4","838","2","201","2","637","189.651420000","0.1567","10260.34","32516.59"
"244.3.160.204","44852","244.3.160.254","80","7","448","4","256","3","192","130.219401000","0.1567","13068.23","9801.17"
"244.3.160.204","52534","244.3.160.254","443","7","448","4","256","3","192","176.223237000","0.1567","13068.39","9801.29"
"244.3.160.204","55547","244.3.160.254","443","7","448","4","256","3","192","194.225080000","0.1567","13071.48","9803.61"
"244.3.160.204","43182","244.3.160.254","4000","7","448","4","256","3","192","120.218640000","0.1566","13077.32","9807.99"
"244.3.160.204","46850","244.3.160.89","80","7","448","4","256","3","192","142.219673000","0.1566","13080.75","9810.56"
"244.3.160.204","48522","244.3.160.254","443","7","448","4","256","3","192","152.220326000","0.1566","13080.91","9810.68"
"244.3.160.204","53534","244.3.160.89","80","7","448","4","256","3","192","182.223024000","0.1564","13096.89","9822.67"
"41.177.211.185","3025","244.3.160.239","80","34","20323","13","1938","21","18385","159.896050000","0.1564","99153.89","940631.74"
"244.3.160.204","44851","244.3.160.254","443","7","448","4","256","3","192","130.219121000","0.1563","13098.90","9824.18"
"244.3.160.204","48863","244.3.160.254","443","7","448","4","256","3","192","154.220695000","0.1563","13102.92","9827.19"
"244.3.160.204","46524","244.3.160.254","443","7","448","4","256","3","192","140.220497000","0.1562","13111.82","9833.86"
"244.3.160.204","43845","244.3.160.89","80","7","448","4","256","3","192","124.217048000","0.1562","13113.24","9834.93"
"244.3.160.204","40169","244.3.160.254","4000","7","448","4","256","3","192","102.216609000","0.1561","13118.45","9838.84"
"41.177.98.143","8001","41.194.224.218","4693","3","298","1","140","2","158","125.838339000","0.1561","N/A","8099.60"
"244.3.160.204","53875","244.3.160.254","80","7","448","4","256","3","192","184.223961000","0.1560","13131.24","9848.43"
"244.3.160.239","61591","177.124.75.164","80","13","3412","7","2367","6","1045","51.099053000","0.1559","121451.57","53619.30"
"244.3.160.239","61465","177.124.75.164","80","16","6241","8","2246","8","3995","34.038812000","0.1559","115268.15","205029.51"
"77.194.20.202","38148","244.3.210.197","80","12","6461","7","1363","5","5098","189.836221000","0.1559","69964.26","261685.84"
"244.3.160.204","50865","244.3.160.254","4000","7","448","4","256","3","192","166.222076000","0.1558","13140.92","9855.69"
"244.3.160.204","47191","244.3.160.254","80","7","448","4","256","3","192","144.219300000","0.1558","13143.88","9857.91"
"244.3.160.204","48199","244.3.160.239","80","7","448","4","256","3","192","150.221787000","0.1558","13148.10","9861.07"
"244.3.160.204","40166","244.3.160.89","80","7","448","4","256","3","192","102.215789000","0.1557","13151.14","9863.35"
"244.3.160.204","53874","244.3.160.254","443","7","448","4","256","3","192","184.223703000","0.1555","13166.52","9874.89"
"41.177.98.143","8001","244.239.193.215","2259","3","298","1","140","2","158","124.916752000","0.1554","N/A","8132.64"
"244.3.160.204","43179","244.3.160.254","80","7","448","4","256","3","192","120.217853000","0.1553","13191.37","9893.53"
"244.3.160.204","47190","244.3.160.254","443","7","448","4","256","3","192","144.219042000","0.1553","13191.37","9893.53"
"244.3.160.204","46520","244.3.160.254","4000","7","448","4","256","3","192","140.219435000","0.1552","13194.35","9895.76"
"244.3.160.204","45527","244.3.160.239","80","7","448","4","256","3","192","134.220841000","0.1552","13195.79","9896.84"
"244.3.155.77","14151","244.3.160.239","80","11","2095","6","1375","5","720","45.813973000","0.1552","70879.03","37114.84"
"41.177.199.139","15954","244.3.160.239","80","10","1893","5","1210","5","683","138.146968000","0.1551","62410.95","35228.66"
"244.3.181.123","12792","244.3.160.239","80","12","2221","6","1347","6","874","122.833323000","0.1551","69485.37","45085.53"
"244.3.160.204","55540","244.3.160.89","80","7","448","4","256","3","192","194.223239000","0.1550","13208.64","9906.48"
"244.3.160.239","62324","85.241.98.37","80","13","5542","7","1090","6","4452","153.424018000","0.1550","56250.08","229748.04"
"244.3.160.204","40507","244.3.160.254","80","7","448","4","256","3","192","104.216393000","0.1550","13214.52","9910.89"
"244.3.164.46","4274","244.3.160.239","80","12","2570","6","1135","6","1435","155.258161000","0.1550","58590.10","74076.46"
"244.3.160.204","40506","244.3.160.254","443","7","448","4","256","3","192","104.216107000","0.1548","13225.87","9919.40"
"244.3.160.204","50862","244.3.160.89","80","7","448","4","256","3","192","166.221299000","0.1548","13228.35","9921.26"
"244.3.160.204","43178","244.3.160.254","443","7","448","4","256","3","192","120.217599000","0.1546","13244.18","9933.13"
"244.3.160.204","46517","244.3.160.89","80","7","448","4","256","3","192","140.218616000","0.1545","13252.66","9939.50"
"244.3.160.204","44181","244.3.160.254","4000","7","448","4","256","3","192","126.219110000","0.1544","13262.53","9946.90"
"41.177.153.153","1938","244.3.41.84","23","4","256","2","128","2","128","32.467570000","0.1543","6636.12","6636.12"
"244.3.160.239","61239","85.241.98.37","80","16","8009","8","1590","8","6419","1.172537000","0.1542","82464.60","332918.42"
"244.3.160.204","48856","244.3.160.89","80","7","448","4","256","3","192","154.218892000","0.1540","13296.28","9972.21"
"244.3.160.204","48193","244.3.160.254","4000","7","448","4","256","3","192","150.220211000","0.1537","13325.87","9994.40"
"244.3.155.77","3361","244.3.160.239","80","11","1965","6","1410","5","555","46.354951000","0.1537","73397.84","28890.64"
"244.3.160.204","44178","244.3.160.89","80","7","448","4","256","3","192","126.218286000","0.1534","13348.98","10011.73"
"41.177.3.203","58771","244.3.31.68","4888","20","2716","10","1534","10","1182","127.105261000","0.1533","80053.75","61684.18"
"244.3.160.204","44844","244.3.160.89","80","7","448","4","256","3","192","130.217326000","0.1531","13374.69","10031.02"
"244.3.160.239","61392","177.124.75.164","80","14","4109","8","2744","6","1365","24.422638000","0.1530","143513.71","71390.75"
"244.3.160.239","62327","85.241.98.37","80","16","7573","8","1154","8","6419","153.835130000","0.1529","60390.00","335912.82"
"244.3.160.204","48190","244.3.160.89","80","7","448","4","256","3","192","150.219412000","0.1527","13407.62","10055.71"
"244.3.160.239","61238","85.241.98.37","80","13","5573","7","1519","6","4054","1.043513000","0.1527","79578.79","212384.74"
"244.3.160.204","45521","244.3.160.254","4000","7","448","4","256","3","192","134.219243000","0.1526","13419.92","10064.94"
"244.3.160.204","54883","244.3.160.239","80","7","448","4","256","3","192","190.226154000","0.1526","13422.29","10066.72"
"244.3.160.204","41515","244.3.160.239","80","7","448","4","256","3","192","110.218680000","0.1526","13423.17","10067.38"
"41.177.199.139","11096","244.3.160.239","80","10","1666","5","1249","5","417","231.485384000","0.1524","65576.35","21893.79"
"41.116.229.239","15815","244.3.160.239","80","10","1676","5","1120","5","556","32.525060000","0.1522","58858.31","29218.95"
"41.116.229.239","5962","244.3.160.239","80","10","1687","5","1131","5","556","32.524684000","0.1522","59440.67","29221.06"
"244.3.160.239","61485","197.154.128.197","80","104","97808","38","3235","66","94573","38.964524000","0.1521","170141.15","4973959.46"
"41.177.13.66","1388","244.3.41.84","23","4","256","2","128","2","128","32.456306000","0.1520","6735.34","6735.34"
"244.3.160.204","45518","244.3.160.89","80","7","448","4","256","3","192","134.218423000","0.1520","13472.53","10104.40"
"41.116.229.239","4155","244.3.160.239","80","10","1674","5","1118","5","556","32.524240000","0.1520","58845.59","29264.89"
"244.3.160.239","61592","177.124.75.164","80","13","3492","7","2367","6","1125","51.102912000","0.1517","124814.62","59322.54"
"41.177.199.139","15286","244.3.160.239","80","12","2039","6","1283","6","756","112.340725000","0.1516","67689.75","39885.78"
"244.3.181.123","3198","244.3.160.239","80","12","2072","6","1346","6","726","122.986321000","0.1514","71109.23","38354.61"
"244.3.160.248","49212","41.177.26.193","80","13","3481","7","2647","6","834","166.136246000","0.1512","140010.31","44113.56"
"244.3.160.204","54877","244.3.160.254","4000","7","448","4","256","3","192","190.224488000","0.1511","13551.79","10163.84"
"244.3.160.239","61607","177.124.75.164","80","13","3534","7","2367","6","1167","52.614897000","0.1511","125356.65","61804.48"
"41.177.192.117","13537","244.3.160.239","80","12","2546","6","1361","6","1185","168.822488000","0.1510","72084.00","62762.34"
"41.116.229.239","15769","244.3.160.239","80","10","1674","5","1118","5","556","32.525520000","0.1510","59241.60","29461.83"
"244.3.160.239","62326","85.241.98.37","80","13","5137","7","1083","6","4054","153.712903000","0.1508","57434.92","214996.45"
"41.177.199.139","13455","244.3.160.239","80","10","2013","5","1072","5","941","97.076470000","0.1508","56877.19","49926.71"
"244.3.181.123","2223","244.3.160.239","80","12","2643","6","1357","6","1286","122.682169000","0.1506","72094.09","68322.03"
"244.3.160.204","41509","244.3.160.254","4000","7","448","4","256","3","192","110.217100000","0.1505","13605.89","10204.42"
"41.177.199.139","15616","244.3.160.239","80","10","1687","5","1270","5","417","138.300129000","0.1504","67562.63","22183.95"
"244.3.160.204","54874","244.3.160.89","80","7","448","4","256","3","192","190.223675000","0.1502","13632.25","10224.19"
"244.3.160.204","41506","244.3.160.89","80","7","448","4","256","3","192","110.216312000","0.1499","13659.07","10244.30"
"244.3.155.77","6886","244.3.160.239","80","13","2630","7","1840","6","790","59.364627000","0.1497","98343.13","42223.41"
"90.218.193.20","4254","244.3.160.239","80","12","2267","6","1290","6","977","105.256288000","0.1495","69023.17","52275.69"
"90.218.193.20","8942","244.3.160.239","80","12","1965","6","1290","6","675","105.256284000","0.1495","69025.48","36117.99"
"41.177.211.185","13139","244.3.160.239","80","12","2155","6","1342","6","813","177.743750000","0.1495","71830.49","43515.79"
"41.177.103.151","1887","244.3.41.84","23","4","289","2","143","2","146","153.463993000","0.1489","7683.83","7845.03"
"15.186.110.142","40976","41.177.26.176","80","12","2549","6","813","6","1736","64.813923000","0.1488","43722.31","93360.31"
"244.3.160.239","62361","244.3.31.75","80","25","18564","11","1728","14","16836","159.898336000","0.1485","93110.97","907185.39"
"244.3.155.77","15156","244.3.160.239","80","15","4157","8","3332","7","825","38.120464000","0.1483","179703.77","44494.48"
"197.33.223.117","50717","244.3.210.197","80","12","5995","7","1125","5","4870","93.304906000","0.1482","60748.83","262974.94"
"41.177.199.139","15618","244.3.160.239","80","11","2692","5","1251","6","1441","112.533329000","0.1480","67610.20","77878.74"
"244.3.160.239","62320","85.241.98.37","80","10","2451","6","1707","4","744","152.662663000","0.1480","92272.14","40217.03"
"244.3.160.239","62444","41.177.254.197","80","10","2502","6","1427","4","1075","168.825930000","0.1479","77175.29","58138.36"
"77.194.20.202","37667","244.3.210.197","80","14","9009","8","1353","6","7656","182.884134000","0.1478","73256.90","414526.85"
"15.186.110.142","51520","41.177.26.176","80","10","1377","5","871","5","506","208.884625000","0.1475","47226.59","27435.88"
"41.177.168.181","10852","244.3.160.239","80","32","18968","12","1426","20","17542","77.764027000","0.1475","77336.08","951353.11"
"41.177.199.139","4882","244.3.160.239","80","13","3712","6","1160","7","2552","97.081725000","0.1474","62938.72","138465.19"
"41.177.98.143","8001","186.45.149.67","1919","3","298","1","140","2","158","0.222554000","0.1474","N/A","8573.04"
"41.177.211.185","5730","244.3.160.239","80","12","2934","6","1345","6","1589","178.234603000","0.1471","73143.54","86412.70"
"244.3.160.239","62484","244.3.31.75","80","11","2056","6","1235","5","821","177.746195000","0.1471","67174.78","44656.27"
"244.3.160.239","61789","197.154.128.197","80","14","5869","8","1260","6","4609","77.298564000","0.1466","68771.19","251560.66"
"244.3.160.239","61808","43.106.84.231","80","13","2172","7","1232","6","940","78.531964000","0.1463","67373.95","51405.45"
"41.177.211.185","5298","244.3.160.239","80","12","3145","6","1345","6","1800","178.347030000","0.1463","73559.07","98443.36"
"244.3.160.239","61807","43.106.84.231","80","13","1933","7","1221","6","712","78.531499000","0.1463","66789.74","38947.01"
"244.3.160.239","62420","41.177.254.197","80","21","11724","10","1496","11","10228","164.240299000","0.1462","81844.23","559560.69"
"41.177.211.185","11219","244.3.160.239","80","12","3125","6","1346","6","1779","178.346683000","0.1462","73648.00","97340.11"
"41.177.192.117","10966","244.3.160.239","80","21","11639","9","1366","12","10273","164.237325000","0.1462","74748.97","562149.44"
"90.218.193.20","2371","244.3.160.239","80","12","2345","6","1299","6","1046","105.259607000","0.1462","71084.60","57239.79"
"41.177.168.181","10801","244.3.160.239","80","12","1820","6","938","6","882","78.825617000","0.1461","51345.91","48280.49"
"244.3.160.239","61335","117.246.95.43","80","13","3741","7","1677","6","2064","8.938091000","0.1459","91957.80","113178.84"
"41.177.93.34","1259","244.3.41.84","23","4","256","2","128","2","128","153.477381000","0.1458","7023.27","7023.27"
"41.177.168.181","8571","244.3.160.239","80","31","18033","11","1360","20","16673","78.280909000","0.1457","74648.88","915162.37"
"15.186.110.142","43183","41.177.26.176","80","10","1450","5","945","5","505","94.696392000","0.1455","51971.26","27773.00"
"41.177.159.241","1124","244.3.41.84","23","4","256","2","128","2","128","153.462486000","0.1454","7044.53","7044.53"
"41.177.211.185","11463","244.3.160.239","80","12","2422","6","1338","6","1084","178.236878000","0.1453","73657.63","59674.79"
"244.3.160.239","61222","117.246.95.43","80","10","1610","6","947","4","663","0.075923000","0.1453","52156.91","36515.35"
"41.177.199.139","13819","244.3.160.239","80","10","1703","5","1286","5","417","176.291284000","0.1450","70970.32","23012.93"
"15.186.110.142","41018","41.177.26.176","80","11","1396","6","891","5","505","65.365643000","0.1448","49210.89","27891.69"
"244.3.155.77","15491","244.3.160.239","80","11","1956","6","1401","5","555","60.309051000","0.1448","77385.68","30656.00"
"244.3.181.123","8513","244.3.160.239","80","12","2838","6","1340","6","1498","123.280475000","0.1448","74056.68","82788.73"
"244.3.155.77","12867","244.3.160.239","80","15","4171","8","3346","7","825","34.894415000","0.1446","185084.29","45634.95"
"41.177.199.139","10895","244.3.160.239","80","10","2675","5","1088","5","1587","97.536519000","0.1446","60186.56","87790.51"
"41.177.199.139","8050","244.3.160.239","80","10","1703","5","1286","5","417","176.426791000","0.1443","71294.43","23118.02"
"41.197.164.55","1302","244.3.41.84","23","4","256","2","128","2","128","153.476110000","0.1442","7103.51","7103.51"
"244.3.160.239","62495","244.3.31.75","80","13","3148","7","1303","6","1845","178.348930000","0.1439","72446.24","102581.21"
"244.3.153.106","2238","41.177.202.249","445","2","128","1","64","1","64","232.754613000","0.1439","N/A","N/A"
"244.3.160.239","62496","244.3.31.75","80","13","3168","7","1302","6","1866","178.349520000","0.1439","72405.24","103769.72"
"244.3.160.239","62493","244.3.31.75","80","11","2836","6","1238","5","1598","178.238085000","0.1438","68860.98","88885.18"
"77.194.20.202","38171","244.3.210.197","80","8","3757","5","1235","3","2522","190.099433000","0.1436","68796.96","140490.63"
"41.177.192.117","5376","244.3.160.239","80","12","1784","6","1174","6","610","164.129906000","0.1435","65428.05","33995.83"
"253.37.253.251","2865","253.160.108.127","80","5","935","3","805","2","130","139.486845000","0.1433","44931.59","7256.03"
"244.3.160.239","61223","117.246.95.43","80","10","1634","6","949","4","685","0.078071000","0.1433","52989.01","38248.12"
"244.3.160.239","62494","244.3.31.75","80","11","2323","6","1231","5","1092","178.239241000","0.1430","68885.44","61107.15"
"244.3.160.239","61224","117.246.95.43","80","10","1707","6","947","4","760","0.078471000","0.1429","53017.58","42548.43"
"41.177.199.139","2394","244.3.160.239","80","10","2706","5","1091","5","1615","96.936039000","0.1429","61088.36","90428.70"
"41.177.37.57","1167","244.3.41.84","23","4","256","2","128","2","128","32.463492000","0.1428","7170.47","7170.47"
"15.186.110.142","51861","41.177.26.176","80","10","1399","5","893","5","506","213.519701000","0.1426","50086.94","28380.73"
"16.176.93.164","10995","244.3.160.239","80","3","192","2","128","1","64","0.027910000","0.1426","7180.47","N/A"
"244.3.155.77","11927","244.3.160.239","80","15","4185","8","3360","7","825","29.248275000","0.1424","188802.49","46357.76"
"244.3.181.123","3489","244.3.160.239","80","12","2226","6","1346","6","880","123.137754000","0.1423","75671.12","49472.94"
"244.3.160.239","61606","177.124.75.164","80","13","3762","7","2367","6","1395","52.573394000","0.1423","133090.62","78437.44"
"68.33.110.176","3559","244.3.160.239","80","27","17672","10","1410","17","16262","15.583717000","0.1419","79480.28","916672.54"
"244.3.181.123","8153","244.3.160.239","80","13","3912","6","1360","7","2552","122.128423000","0.1418","76733.20","143987.59"
"41.177.199.139","3134","244.3.160.239","80","10","1679","5","1262","5","417","231.942962000","0.1418","71221.98","23533.73"
"41.177.199.139","13203","244.3.160.239","80","13","4122","6","1146","7","2976","103.860564000","0.1417","64687.29","167983.74"
"244.3.181.123","5121","244.3.160.239","80","10","1743","5","1326","5","417","140.101702000","0.1417","74870.31","23545.19"
"41.177.199.139","4769","244.3.160.239","80","10","1701","5","1284","5","417","196.533791000","0.1416","72560.31","23565.15"
"244.3.90.4","1509","244.3.41.84","23","4","256","2","128","2","128","32.471944000","0.1414","7240.84","7240.84"
"41.177.3.224","52711","41.177.117.153","1533","37","9282","19","4692","18","4590","61.713691000","0.1414","265547.95","259775.17"
"41.177.230.224","36824","41.177.26.91","80","22","13015","10","716","12","12299","54.868165000","0.1413","40532.99","696250.27"
"244.3.235.84","4908","244.3.41.84","23","4","256","2","128","2","128","153.478305000","0.1412","7252.79","7252.79"
"244.3.155.77","7335","244.3.160.239","80","15","4172","8","3347","7","825","16.237726000","0.1411","189805.13","46784.95"
"244.3.181.123","6866","244.3.160.239","80","10","2906","5","1291","5","1615","121.831538000","0.1411","73211.88","91585.74"
"244.3.160.239","61825","43.106.84.231","80","14","3516","7","1231","7","2285","78.940170000","0.1409","69906.94","129762.27"
"244.3.160.239","62418","41.177.254.197","80","10","1739","6","1240","4","499","164.133279000","0.1406","70566.31","28397.25"
"244.3.181.123","11038","244.3.160.239","80","10","1964","5","1281","5","683","121.781154000","0.1403","73053.89","38950.67"
"244.3.181.123","7884","244.3.160.239","80","10","1749","5","1332","5","417","139.822306000","0.1402","75991.61","23790.17"
"253.127.160.213","1340","253.37.253.43","23","6","664","0","0","6","664","26.444783000","0.1401","N/A","37924.17"
"41.177.199.139","12361","244.3.160.239","80","10","1687","5","1270","5","417","175.448823000","0.1401","72537.23","23817.34"
"244.3.160.239","61819","43.106.84.231","80","13","1978","7","1231","6","747","78.829895000","0.1399","70396.66","42718.36"
"41.177.199.139","2370","244.3.160.239","80","9","1637","5","1284","4","353","196.392449000","0.1398","73453.80","20194.07"
"244.3.160.239","61860","117.246.95.43","80","10","2366","6","931","4","1435","87.629731000","0.1398","53286.40","82133.17"
"41.177.199.139","11567","244.3.160.239","80","10","2675","5","1088","5","1587","97.685463000","0.1396","62365.65","90969.02"
"77.194.20.202","38162","244.3.210.197","80","8","3622","5","1234","3","2388","189.958303000","0.1395","70743.70","136901.09"
"41.177.211.185","6144","244.3.160.239","80","12","2667","6","1105","6","1562","159.353671000","0.1395","63355.55","89557.80"
"41.177.199.139","8489","244.3.160.239","80","10","1974","5","1088","5","886","97.186115000","0.1395","62384.87","50802.39"
"41.177.199.139","2833","244.3.160.239","80","7","1467","4","1018","3","449","103.719983000","0.1395","58374.07","25746.52"
"244.3.160.239","61818","43.106.84.231","80","13","1940","7","1227","6","713","78.829861000","0.1395","70362.06","40886.84"
"244.3.160.239","61820","43.106.84.231","80","13","2389","7","1106","6","1283","78.830315000","0.1391","63617.15","73798.19"
"244.3.181.123","13175","244.3.160.239","80","10","1750","5","1333","5","417","139.682525000","0.1391","76679.15","23987.40"
"41.177.199.139","10802","244.3.160.239","80","10","1679","5","1262","5","417","231.804959000","0.1390","72644.59","24003.80"
"41.177.199.139","13995","244.3.160.239","80","10","1680","5","1263","5","417","231.802680000","0.1389","72731.98","24013.65"
"244.3.241.123","1801","244.3.41.84","23","4","256","2","128","2","128","153.476493000","0.1389","7374.07","7374.07"
"244.3.181.123","8686","244.3.160.239","80","10","1748","5","1331","5","417","138.978717000","0.1388","76692.60","24027.66"
"244.3.181.123","11717","244.3.160.239","80","10","1757","5","1340","5","417","138.839018000","0.1388","77241.22","24037.01"
"41.177.199.139","15432","244.3.160.239","80","13","3823","6","1274","7","2549","111.370919000","0.1385","73604.39","147266.56"
"41.177.199.139","7974","244.3.160.239","80","10","2817","5","1216","5","1601","111.131376000","0.1384","70264.14","92510.60"
"41.177.199.139","13085","244.3.160.239","80","10","1674","5","1257","5","417","232.084462000","0.1384","72650.04","24101.09"
"41.177.199.139","2448","244.3.160.239","80","10","1704","5","1287","5","417","176.151456000","0.1383","74446.32","24121.30"
"244.3.181.123","13142","244.3.160.239","80","10","1736","5","1319","5","417","139.400823000","0.1383","76322.74","24129.33"
"41.177.199.139","11584","244.3.160.239","80","10","1702","5","1285","5","417","176.710539000","0.1382","74380.11","24137.36"
"41.177.93.235","1159","244.3.41.84","23","4","256","2","128","2","128","153.473552000","0.1381","7414.43","7414.43"
"244.3.155.77","10693","244.3.160.239","80","11","1961","6","1406","5","555","68.703168000","0.1381","81460.02","32155.27"
"41.177.199.139","15118","244.3.160.239","80","10","1687","5","1270","5","417","230.774182000","0.1381","73582.66","24160.61"
"41.177.199.139","12000","244.3.160.239","80","10","1699","5","1282","5","417","175.733674000","0.1381","74282.78","24162.18"
"41.177.199.139","14245","244.3.160.239","80","10","1702","5","1285","5","417","175.868118000","0.1380","74491.67","24173.56"
"41.177.199.139","9622","244.3.160.239","80","10","1702","5","1285","5","417","176.152769000","0.1378","74584.09","24203.55"
"41.177.199.139","7982","244.3.160.239","80","10","1673","5","1256","5","417","232.086885000","0.1378","72904.57","24204.78"
"244.3.181.123","15769","244.3.160.239","80","10","1763","5","1346","5","417","139.249533000","0.1378","78139.40","24208.12"
"244.3.181.123","9834","244.3.160.239","80","10","1749","5","1332","5","417","139.963370000","0.1377","77366.52","24220.60"
"244.3.77.218","16376","244.3.160.239","80","10","1623","5","1183","5","440","26.179768000","0.1375","68825.59","25598.70"
"244.3.160.239","62355","244.3.31.75","80","11","2594","6","1023","5","1571","159.355860000","0.1374","59545.12","91442.21"
"41.177.199.139","5282","244.3.160.239","80","10","1686","5","1269","5","417","138.145958000","0.1374","73870.87","24274.35"
"244.3.155.77","2588","244.3.160.239","80","9","1035","5","350","4","685","0.038220000","0.1374","20375.05","39876.88"
"244.3.181.123","2661","244.3.160.239","80","10","1760","5","1343","5","417","139.544618000","0.1374","78216.68","24286.19"
"244.3.181.123","13074","244.3.160.239","80","10","1758","5","1341","5","417","139.111165000","0.1373","78120.68","24292.56"
"41.177.199.139","9688","244.3.160.239","80","10","1673","5","1256","5","417","139.155053000","0.1373","73176.95","24295.21"
"41.177.199.139","12776","244.3.160.239","80","10","1694","5","1277","5","417","176.009649000","0.1372","74454.13","24312.74"
"244.3.160.239","62328","85.241.98.37","80","10","2195","6","1060","4","1135","153.960251000","0.1372","61823.80","66198.13"
"41.177.199.139","5936","244.3.160.239","80","10","1706","5","1289","5","417","175.596121000","0.1370","75269.52","24350.19"
"41.177.199.139","11529","244.3.160.239","80","10","1680","5","1263","5","417","231.665932000","0.1369","73779.29","24359.43"
"244.3.31.241","50890","244.3.41.84","2717","5","328","3","198","2","130","63.555319000","0.1369","11569.81","7596.34"
"41.177.199.139","9721","244.3.160.239","80","10","1690","5","1273","5","417","231.664256000","0.1367","74498.90","24403.80"
"41.177.199.139","8132","244.3.160.239","80","10","1673","5","1256","5","417","231.946120000","0.1366","73554.06","24420.42"
"41.177.199.139","2203","244.3.160.239","80","10","1688","5","1271","5","417","230.996020000","0.1366","74453.21","24427.21"
"41.177.199.139","3188","244.3.160.239","80","10","1707","5","1290","5","417","175.172725000","0.1365","75581.14","24432.04"
"41.177.199.139","8520","244.3.160.239","80","10","1706","5","1289","5","417","175.730867000","0.1365","75533.06","24435.44"
"41.177.199.139","9509","244.3.160.239","80","10","1692","5","1275","5","417","138.305597000","0.1365","74752.11","24448.34"
"41.177.199.139","14467","244.3.160.239","80","10","1704","5","1287","5","417","176.708738000","0.1364","75459.53","24449.59"
"244.3.155.77","8572","244.3.160.239","80","9","1095","5","350","4","745","0.039389000","0.1364","20525.90","43690.85"
"41.177.199.139","7438","244.3.160.239","80","10","1703","5","1286","5","417","175.872175000","0.1364","75424.67","24457.30"
"244.3.155.77","5374","244.3.160.239","80","9","1084","5","350","4","734","0.040026000","0.1364","20535.09","43065.01"
"41.177.199.139","11675","244.3.160.239","80","10","1672","5","1255","5","417","139.006812000","0.1362","73699.43","24488.18"
"244.3.160.239","62421","94.2.202.98","80","10","2210","6","1207","4","1003","164.343614000","0.1362","70916.57","58930.67"
"68.33.110.176","16308","244.3.160.239","80","28","19457","9","1346","19","18111","7.427506000","0.1361","79090.98","1064202.66"
"41.177.199.139","3504","244.3.160.239","80","10","1702","5","1285","5","417","176.436629000","0.1361","75512.72","24504.91"
"41.177.199.139","14568","244.3.160.239","80","10","1708","5","1291","5","417","176.574014000","0.1361","75908.80","24518.96"
"41.177.199.139","13359","244.3.160.239","80","10","1665","5","1248","5","417","138.462294000","0.1360","73412.30","24529.59"
"41.177.199.139","10024","244.3.160.239","80","10","1700","5","1283","5","417","174.892107000","0.1359","75505.01","24540.60"
"244.3.155.77","16338","244.3.160.239","80","9","1081","5","350","4","731","0.039152000","0.1359","20599.60","43023.73"
"244.3.160.239","62050","122.168.72.208","80","9","2694","6","1253","3","1441","109.716944000","0.1359","73758.49","84825.21"
"41.177.192.117","12972","244.3.160.239","80","22","11879","9","1370","13","10509","161.817771000","0.1358","80698.01","619018.52"
"244.3.153.30","1788","41.177.230.83","631","10","1495","5","735","5","760","44.905572000","0.1358","43297.37","44770.07"
"41.177.199.139","14172","244.3.160.239","80","10","1702","5","1285","5","417","176.290362000","0.1358","75711.82","24569.52"
"244.3.77.235","1145","244.3.41.84","23","4","256","2","128","2","128","32.454838000","0.1357","7544.67","7544.67"
"41.177.199.139","2237","244.3.160.239","80","10","1703","5","1286","5","417","176.571675000","0.1357","75819.88","24585.45"
"41.177.199.139","5068","244.3.160.239","80","10","1710","5","1293","5","417","176.006632000","0.1356","76277.56","24599.96"
"41.177.199.139","4963","244.3.160.239","80","10","1707","5","1290","5","417","175.311238000","0.1356","76116.30","24605.04"
"41.177.199.139","6009","244.3.160.239","80","10","1705","5","1288","5","417","175.594712000","0.1355","76046.53","24620.65"
"41.177.199.139","6851","244.3.160.239","80","10","1685","5","1268","5","417","175.030186000","0.1354","74916.55","24637.38"
"41.177.199.139","6471","244.3.160.239","80","10","1672","5","1255","5","417","139.221278000","0.1354","74150.66","24638.11"
"203.25.39.39","51489","41.177.98.143","8001","3","328","2","176","1","152","170.729110000","0.1354","10401.89","N/A"
"41.177.150.71","2624","244.3.41.84","23","4","256","2","128","2","128","153.464420000","0.1353","7569.21","7569.21"
"41.177.199.139","7894","244.3.160.239","80","10","1693","5","1276","5","417","231.113851000","0.1352","75486.21","24669.08"
"41.177.98.252","10035","244.3.160.239","80","15","5159","7","1267","8","3892","34.035969000","0.1351","75020.35","230449.26"
"41.116.229.239","12900","244.3.160.239","80","10","2485","5","1339","5","1146","29.299754000","0.1351","79317.01","67884.46"
"244.3.164.46","12894","244.3.160.239","80","12","1888","6","1129","6","759","154.825800000","0.1350","66920.06","44988.78"
"244.3.160.239","62185","94.2.202.98","80","10","2202","6","1189","4","1013","121.609489000","0.1348","70548.62","60105.76"
"41.177.192.117","14899","244.3.160.239","80","15","4961","7","1192","8","3769","161.674151000","0.1348","70748.66","223701.10"
"244.3.160.239","61804","43.106.84.231","80","13","1893","7","1115","6","778","78.440940000","0.1336","66753.48","46577.76"
"244.3.157.123","1809","244.3.41.84","23","4","256","2","128","2","128","153.484363000","0.1335","7669.89","7669.89"
"41.177.98.252","5110","244.3.160.239","80","12","2430","6","1203","6","1227","38.170199000","0.1335","72089.89","73528.09"
"244.3.160.239","62407","41.177.254.197","80","22","11964","10","1500","12","10464","161.820520000","0.1334","89975.26","627667.39"
"244.3.160.239","62336","85.241.98.37","80","10","1762","6","1153","4","609","154.727309000","0.1333","69200.93","36551.06"
"41.177.192.117","12655","244.3.160.239","80","13","5794","6","1128","7","4666","161.675436000","0.1333","67713.69","280099.35"
"244.3.160.239","61246","85.241.98.37","80","10","2631","6","1496","4","1135","1.303281000","0.1329","90054.70","68323.59"
"244.3.160.239","61734","177.124.75.164","80","11","3063","6","1746","5","1317","65.131115000","0.1329","105118.19","79290.18"
"41.177.98.143","8001","194.31.194.116","4146","3","298","1","140","2","158","99.021838000","0.1326","N/A","9529.91"
"90.218.193.20","13633","244.3.160.239","80","11","3260","5","1218","6","2042","103.699774000","0.1324","73596.83","123386.48"
"151.77.217.75","11368","244.3.160.239","80","11","2176","6","1690","5","486","105.017526000","0.1321","102319.60","29424.45"
"244.3.160.239","61810","43.106.84.231","80","13","1931","7","1106","6","825","78.546501000","0.1318","67145.77","50086.13"
"244.3.160.239","61721","117.246.95.43","80","10","1587","6","918","4","669","60.215655000","0.1315","55858.95","40707.67"
"47.167.92.164","3547","244.3.41.84","23","4","256","2","128","2","128","153.464731000","0.1311","7813.51","7813.51"
"41.116.229.239","9161","244.3.160.239","80","10","1507","5","1019","5","488","36.439579000","0.1309","62256.10","29814.50"
"244.3.160.239","61706","117.246.95.43","80","12","2860","7","984","5","1876","59.966923000","0.1309","60125.57","114629.64"
"244.3.160.239","62400","41.177.254.197","80","19","9399","9","1538","10","7861","161.507769000","0.1308","94093.90","480931.15"
"244.3.39.95","1384","244.3.41.84","23","4","256","2","128","2","128","32.466188000","0.1307","7832.58","7832.58"
"41.177.136.15","1052","244.3.41.84","23","4","256","2","128","2","128","153.473926000","0.1304","7851.62","7851.62"
"244.3.224.4","3919","244.3.41.84","23","4","256","2","128","2","128","32.448175000","0.1304","7854.81","7854.81"
"41.177.192.117","5633","244.3.160.239","80","12","2358","6","1175","6","1183","164.825591000","0.1300","72333.29","72825.77"
"244.3.164.46","5520","244.3.160.239","80","10","2557","5","1739","5","818","152.529065000","0.1298","107159.64","50406.32"
"244.3.160.239","61854","117.246.95.43","80","10","1727","6","937","4","790","87.337104000","0.1298","57756.17","48695.17"
"244.3.160.239","61345","48.151.224.205","80","10","1440","6","960","4","480","12.040562000","0.1292","59462.98","29731.49"
"244.3.160.239","61414","48.151.224.205","80","10","1761","6","1348","4","413","27.397260000","0.1285","83901.94","25705.86"
"41.116.229.239","10418","244.3.160.239","80","10","1707","5","1149","5","558","28.392506000","0.1285","71528.62","34737.14"
"244.3.160.239","61496","197.154.128.197","80","10","1955","6","1277","4","678","39.866754000","0.1284","79540.32","42230.49"
"41.177.98.252","2060","244.3.160.239","80","10","2282","5","1604","5","678","24.418896000","0.1283","99991.43","42265.70"
"41.177.223.45","13282","244.3.160.239","80","11","5390","4","256","7","5134","0.069348000","0.1280","15998.00","320834.90"
"244.3.160.239","61720","117.246.95.43","80","10","1587","6","918","4","669","60.189353000","0.1280","57396.97","41828.51"
"41.177.43.106","2456","244.3.41.84","23","4","256","2","128","2","128","153.458612000","0.1278","8010.76","8010.76"
"244.3.160.239","61956","81.67.210.81","80","13","3835","7","1540","6","2295","102.540696000","0.1278","96417.22","143686.71"
"253.37.253.43","2001","253.116.23.22","515","13","3890","13","3890","0","0","9.671484000","0.1275","244068.86","N/A"
"244.3.160.239","61388","177.124.75.164","80","15","4353","8","2356","7","1997","23.557384000","0.1275","147833.25","125306.87"
"244.3.160.239","62434","41.177.254.197","80","10","2314","6","1241","4","1073","164.828316000","0.1275","77873.39","67331.30"
"184.75.94.39","1783","244.3.41.84","23","4","2287","2","159","2","2128","232.541726000","0.1275","9980.23","133571.85"
"244.3.160.239","61882","48.151.224.205","80","10","1928","6","1515","4","413","92.950651000","0.1273","95187.23","25948.73"
"244.3.160.239","62102","48.151.224.205","80","10","2005","6","1592","4","413","112.919540000","0.1272","100121.85","25973.82"
"244.3.181.123","6392","244.3.160.239","80","15","6052","7","1525","8","4527","0.718512000","0.1272","95922.51","284748.32"
"244.3.160.239","61341","48.151.224.205","80","10","1459","6","979","4","480","11.908893000","0.1272","61580.56","30192.71"
"244.3.160.239","62323","85.241.98.37","80","10","1961","6","1049","4","912","153.324294000","0.1270","66058.97","57431.63"
"41.177.3.224","52719","41.177.117.153","1533","27","5686","14","2537","13","3149","121.299957000","0.1267","160146.45","198778.54"
"151.77.185.176","10333","244.3.160.239","80","26","18496","11","1682","15","16814","39.431323000","0.1264","106440.54","1064025.69"
"244.3.161.161","1088","244.3.41.84","23","4","256","2","128","2","128","153.460037000","0.1264","8101.33","8101.33"
"244.3.160.239","61346","48.151.224.205","80","10","1440","6","960","4","480","12.073777000","0.1263","60795.09","30397.54"
"244.3.160.239","61344","48.151.224.205","80","10","1443","6","963","4","480","12.035024000","0.1262","61067.73","30438.75"
"244.3.164.46","15468","244.3.160.239","80","12","2847","6","1127","6","1720","154.595974000","0.1261","71482.94","109095.52"
"244.3.160.239","61342","48.151.224.205","80","10","1441","6","961","4","480","12.026808000","0.1260","61003.77","30470.14"
"244.3.160.239","62331","85.241.98.37","80","12","3044","7","1098","5","1946","154.253689000","0.1260","69722.03","123569.29"
"244.3.160.239","61879","48.151.224.205","80","10","1446","6","1033","4","413","92.144849000","0.1259","65642.00","26244.09"
"68.33.110.176","4944","244.3.160.239","80","11","3340","5","1341","6","1999","163.047685000","0.1259","85239.60","127064.84"
"41.116.229.239","2529","244.3.160.239","80","10","1507","5","1019","5","488","31.606696000","0.1258","64775.53","31021.06"
"244.3.160.239","61286","48.151.224.205","80","10","1418","6","938","4","480","3.716629000","0.1258","59662.10","30530.71"
"244.3.160.239","62358","244.3.31.75","443","20","5931","11","2005","9","3926","159.739831000","0.1252","128078.19","250790.51"
"244.3.160.248","50023","41.177.26.55","80","20","12437","9","926","11","11511","233.553774000","0.1246","59438.03","738867.40"
"244.3.160.239","61703","117.246.95.43","80","10","1573","6","921","4","652","59.912796000","0.1245","59194.99","41905.68"
"244.3.155.77","4342","244.3.160.239","80","14","2349","8","1512","6","837","0.073528000","0.1244","97248.80","53834.16"
"90.218.193.20","14209","244.3.160.239","80","58","42951","17","1981","41","40970","101.483324000","0.1243","127471.33","2636294.90"
"90.218.72.197","2292","244.3.160.239","80","10","1467","5","900","5","567","12.058772000","0.1242","57971.95","36522.33"
"68.33.110.176","14617","244.3.160.239","80","10","2075","5","1135","5","940","164.327716000","0.1242","73129.09","60565.06"
"90.218.193.20","14603","244.3.160.239","80","54","38101","18","2050","36","36051","104.121599000","0.1241","132152.56","2324015.50"
"90.218.72.197","8177","244.3.160.239","80","10","1473","5","973","5","500","92.131245000","0.1239","62806.10","32274.46"
"244.3.160.239","61700","117.246.95.43","80","10","1683","6","920","4","763","59.883371000","0.1239","59388.36","49253.61"
"244.3.160.239","61701","117.246.95.43","80","10","1683","6","920","4","763","59.884444000","0.1238","59433.92","49291.40"
"68.33.110.176","13985","244.3.160.239","80","30","19585","11","1474","19","18111","7.253888000","0.1238","95277.34","1170670.22"
"77.194.20.202","38167","244.3.210.197","80","8","3387","5","1233","3","2154","190.045294000","0.1238","79707.16","139245.11"
"244.3.181.123","14246","244.3.160.239","80","20","8211","9","1659","11","6552","1.168843000","0.1237","107290.97","423731.42"
"244.3.160.239","61278","85.241.98.37","80","12","3430","7","1528","5","1902","2.500780000","0.1232","99223.20","123509.50"
"244.3.160.239","61228","117.246.95.43","80","10","2451","6","972","4","1479","0.195925000","0.1230","63242.14","96229.55"
"244.3.160.239","61374","43.106.84.108","80","10","2131","6","1275","4","856","18.868822000","0.1228","83085.57","55781.37"
"244.3.155.77","4758","244.3.160.239","80","14","2373","8","1514","6","859","0.075677000","0.1227","98737.25","56020.67"
"244.3.41.161","1284","244.3.41.84","23","4","256","2","128","2","128","153.472048000","0.1225","8356.93","8356.93"
"244.3.160.239","62221","151.241.241.198","80","10","2381","6","1394","4","987","127.865315000","0.1225","91034.51","64455.56"
"244.3.155.77","13568","244.3.160.239","80","14","2446","8","1512","6","934","0.076164000","0.1224","98787.21","61023.32"
"41.177.124.47","13533","244.3.160.239","80","11","2358","5","1642","6","716","191.148337000","0.1222","107471.28","46863.24"
"244.3.160.239","61702","117.246.95.43","80","12","2928","7","984","5","1944","59.885988000","0.1221","64493.93","127414.84"
"244.3.181.123","9358","244.3.160.239","80","15","5647","7","1518","8","4129","1.040185000","0.1218","99670.88","271107.43"
"244.3.160.239","61799","43.106.84.231","80","13","1933","7","1221","6","712","78.435781000","0.1214","80455.98","46916.18"
"244.3.160.239","62330","85.241.98.37","80","12","3100","7","1177","5","1923","154.161502000","0.1212","77706.44","126957.93"
"145.95.31.210","4849","244.3.160.239","80","49","39624","18","1906","31","37718","88.715478000","0.1212","125840.77","2490273.91"
"244.3.160.239","61801","43.106.84.231","80","13","1946","7","1117","6","829","78.437528000","0.1208","73972.29","54899.75"
"244.3.160.239","61802","43.106.84.231","80","13","1885","7","1117","6","768","78.437593000","0.1207","74015.17","50889.57"
"244.3.160.239","62419","94.2.202.98","80","10","1933","6","1121","4","812","164.231355000","0.1207","74316.54","53831.43"
"244.3.160.239","61247","85.241.98.37","80","12","3359","7","1599","5","1760","1.422597000","0.1206","106108.36","116792.20"
"244.3.164.46","9595","244.3.160.239","80","10","2583","5","1725","5","858","152.659900000","0.1205","114513.32","56957.93"
"244.3.160.239","61391","43.106.84.108","80","10","1970","6","1275","4","695","24.270148000","0.1205","84652.22","46143.76"
"253.37.253.121","2849","253.160.108.127","80","5","935","3","805","2","130","77.821666000","0.1204","53478.16","8636.22"
"244.3.160.239","61249","85.241.98.37","80","12","3536","7","1613","5","1923","1.519355000","0.1204","107183.20","127782.58"
"68.33.110.176","15897","244.3.160.239","80","10","2092","5","1142","5","950","121.595498000","0.1202","76023.10","63241.63"
"244.3.160.239","61803","43.106.84.231","80","13","1871","7","1115","6","756","78.438338000","0.1200","74324.04","50393.70"
"41.177.83.247","8211","244.3.160.239","80","121","108860","42","4061","79","104799","55.555504000","0.1200","270780.72","6987822.87"
"244.3.160.239","62329","85.241.98.37","80","12","2923","7","1163","5","1760","154.069087000","0.1200","77554.66","117365.61"
"244.3.164.46","16374","244.3.160.239","80","17","7691","7","1197","10","6494","153.833314000","0.1198","79943.90","433714.02"
"41.177.168.181","4835","244.3.160.239","80","11","1930","5","1005","6","925","78.526551000","0.1196","67209.47","61859.46"
"244.3.164.46","4079","244.3.160.239","80","14","5660","6","1133","8","4527","153.421968000","0.1195","75877.31","303174.39"
"244.3.155.77","2257","244.3.160.239","80","14","3105","8","1496","6","1609","87.627388000","0.1194","100241.22","107812.92"
"41.177.168.181","12793","244.3.160.239","80","12","1756","6","1058","6","698","78.526349000","0.1193","70930.54","46795.39"
"244.3.160.239","62173","244.3.31.75","443","18","3868","10","2133","8","1735","120.344762000","0.1188","143624.27","116825.18"
"41.177.211.185","2271","244.3.160.239","80","12","2930","6","1346","6","1584","177.783538000","0.1185","90844.67","106907.84"
"244.3.31.117","56944","41.177.98.220","7000","5","2246","3","470","2","1776","16.362953000","0.1184","31761.85","120019.26"
"41.177.124.47","15086","244.3.160.239","80","12","2286","6","1612","6","674","225.387802000","0.1181","109211.32","45662.80"
"244.3.160.239","61232","85.241.98.37","80","10","2397","6","1485","4","912","0.633956000","0.1181","100631.91","61802.23"
"244.3.164.46","14130","244.3.160.239","80","14","5255","6","1126","8","4129","153.710982000","0.1180","76359.04","280005.76"
"244.3.160.239","62520","197.154.128.197","80","10","2273","6","1596","4","677","191.152637000","0.1179","108289.65","45934.90"
"90.218.193.20","4481","244.3.160.239","80","16","6428","7","1517","9","4911","101.329511000","0.1178","102980.98","333381.42"
"90.218.241.186","39829","244.3.210.197","80","7","3269","4","1011","3","2258","73.355736000","0.1177","68716.49","153473.63"
"244.3.160.239","61863","117.246.95.43","80","10","1724","6","940","4","784","87.973797000","0.1176","63933.07","53322.90"
"244.3.160.239","61727","41.43.180.128","80","17","4791","9","2684","8","2107","63.750742000","0.1176","182602.11","143346.74"
"41.177.124.47","9006","244.3.160.239","80","13","4721","6","1607","7","3114","225.388689000","0.1175","109404.39","212000.78"
"244.3.160.239","61313","43.106.84.108","80","10","2116","6","1260","4","856","6.583748000","0.1175","85788.69","58281.84"
"244.3.160.239","61379","94.2.202.197","80","10","1831","6","1487","4","344","20.744795000","0.1171","101624.84","23509.71"
"145.67.149.81","49515","41.177.98.176","80","89","66719","43","3818","46","62901","180.687245000","0.1170","261164.74","4302651.49"
"253.160.251.90","1434","253.37.253.43","446","7","1688","0","0","7","1688","68.243117000","0.1169","N/A","115521.49"
"244.3.160.239","61685","117.246.95.43","80","12","3459","7","980","5","2479","59.610645000","0.1168","67107.77","169755.28"
"244.3.160.239","62485","244.3.31.75","80","11","2832","6","1239","5","1593","177.785666000","0.1168","84851.39","109094.64"
"244.3.160.239","61696","117.246.95.43","80","10","1569","6","921","4","648","59.810956000","0.1166","63177.39","44450.54"
"244.3.160.239","62769","41.43.180.128","80","11","2512","6","1524","5","988","231.294465000","0.1165","104650.56","67844.33"
"151.77.185.176","13878","244.3.160.239","80","13","2267","7","1493","6","774","39.859576000","0.1164","102602.87","53191.31"
"41.177.124.47","14931","244.3.160.239","80","12","2284","6","1607","6","677","225.390483000","0.1160","110785.56","46671.95"
"253.213.108.230","1775","253.37.253.43","23","3","194","0","0","3","194","155.448296000","0.1158","N/A","13399.29"
"41.177.3.203","32954","41.177.230.68","2049","7","1280","4","646","3","634","1.107926000","0.1157","44649.88","43820.47"
"244.3.181.123","13989","244.3.160.239","80","12","3382","6","1850","6","1532","117.596515000","0.1148","128912.00","106753.07"
"244.3.3.145","13546","244.3.160.239","80","26","16423","11","1344","15","15079","203.016614000","0.1146","93857.21","1053030.37"
"41.177.3.224","51362","41.177.117.184","1618","37","17342","19","7912","18","9430","97.117667000","0.1144","553325.41","659486.68"
"244.3.181.123","6648","244.3.160.239","80","12","3250","6","1800","6","1450","135.632888000","0.1142","126079.11","101563.73"
"41.177.124.47","2490","244.3.160.239","80","12","2779","6","1614","6","1165","225.392885000","0.1141","113181.75","81695.62"
"244.3.160.239","61255","85.241.98.37","80","12","3480","7","1534","5","1946","1.616525000","0.1140","107678.40","136598.55"
"244.3.160.239","62748","197.154.128.197","80","10","2060","6","1502","4","558","225.391754000","0.1137","105688.13","39263.63"
"244.3.160.239","61697","117.246.95.43","80","10","1635","6","928","4","707","59.814417000","0.1133","65508.39","49907.79"
"244.3.160.239","61698","117.246.95.43","80","10","2418","6","918","4","1500","59.815024000","0.1132","64901.55","106048.29"
"244.3.153.34","58094","244.3.31.117","443","22","3832","13","1970","9","1862","122.198697000","0.1131","139308.76","131671.53"
"244.3.160.239","62749","197.154.128.197","80","12","4559","7","1561","5","2998","225.394001000","0.1119","111569.73","214276.78"
"41.177.211.185","14689","244.3.160.239","80","28","16036","11","1957","17","14079","160.460340000","0.1119","139946.90","1006802.48"
"41.177.168.181","6355","244.3.160.239","80","12","3273","5","1004","7","2269","78.937364000","0.1118","71874.72","162434.00"
"41.177.168.181","10418","244.3.160.239","80","11","1699","5","1000","6","699","78.826173000","0.1117","71640.29","50076.57"
"41.177.211.185","12760","244.3.160.239","80","12","1978","6","1307","6","671","160.542666000","0.1114","93827.12","48169.85"
"244.3.160.239","61710","117.246.95.43","80","10","2287","6","917","4","1370","60.076282000","0.1114","65843.92","98370.96"
"41.177.168.181","13133","244.3.160.239","80","12","1800","6","1068","6","732","78.826395000","0.1114","76702.10","52571.10"
"244.3.155.77","8981","244.3.160.239","80","14","2326","8","1483","6","843","60.213297000","0.1111","106813.60","60717.37"
"244.3.160.239","61617","41.177.26.15","80","194","214578","38","4958","156","209620","55.559536000","0.1110","357262.52","15104754.01"
"244.3.160.239","61711","117.246.95.43","80","13","4400","7","986","6","3414","60.076474000","0.1109","71107.26","246207.10"
"41.177.168.181","12495","244.3.160.239","80","12","2210","6","943","6","1267","78.826105000","0.1109","68032.00","91406.72"
"41.177.241.34","44121","40.193.71.79","25","14","1026","6","434","8","592","184.475781000","0.1108","31326.69","42731.34"
"244.3.160.239","61724","41.43.180.128","80","11","3126","6","1811","5","1315","60.595387000","0.1107","130905.81","95053.08"
"244.3.155.77","12655","244.3.160.239","80","14","3477","8","1485","6","1992","59.964611000","0.1104","107568.75","144294.24"
"244.3.160.239","62751","197.154.128.197","80","10","2553","6","1504","4","1049","225.396213000","0.1102","109147.65","76127.58"
"244.3.160.239","62750","197.154.128.197","80","10","2058","6","1497","4","561","225.396119000","0.1101","108727.43","40745.55"
"244.3.160.239","61515","41.43.180.128","80","11","2498","6","1510","5","988","44.710907000","0.1101","109728.40","71795.80"
"244.3.160.239","62159","244.3.31.108","80","11","3202","6","1732","5","1470","117.600592000","0.1098","126147.12","107064.82"
"244.3.160.248","50021","41.177.26.193","80","55","44204","21","2973","34","41231","233.123479000","0.1095","217161.85","3011705.41"
"244.3.160.239","62251","244.3.31.108","80","11","3070","6","1682","5","1388","135.636710000","0.1094","122950.97","101460.13"
"244.3.155.77","4301","244.3.160.239","80","14","2466","7","1432","7","1034","87.334796000","0.1092","104935.33","75770.34"
"244.3.160.239","61687","117.246.95.43","80","10","1574","6","917","4","657","59.667975000","0.1092","67199.18","48145.98"
"168.91.64.164","63605","244.3.210.255","80","15","12645","6","435","9","12210","191.429786000","0.1089","31955.63","896961.46"
"41.177.211.185","2571","244.3.160.239","80","11","2085","5","1243","6","842","160.766609000","0.1088","91374.38","61896.40"
"244.3.160.239","61694","117.246.95.43","80","10","1554","6","921","4","633","59.768538000","0.1088","67733.66","46553.10"
"90.218.193.20","7572","244.3.160.239","80","14","6746","6","1298","8","5448","105.581940000","0.1087","95525.46","400942.01"
"90.218.193.20","7074","244.3.160.239","80","12","3019","6","1300","6","1719","105.581944000","0.1077","96584.26","127714.11"
"90.218.193.20","14914","244.3.160.239","80","11","2072","5","1226","6","846","105.582129000","0.1075","91200.73","62932.97"
"244.3.155.77","2261","244.3.160.239","80","14","2326","8","1483","6","843","60.187044000","0.1074","110453.21","62786.28"
"244.3.160.239","61704","117.246.95.43","80","10","2290","6","918","4","1372","59.960516000","0.1070","68614.35","102547.81"
"168.91.64.164","1254","244.3.210.255","80","16","12709","6","435","10","12274","98.188228000","0.1069","32539.18","918128.44"
"244.3.3.145","12944","244.3.160.239","80","12","1892","6","1023","6","869","202.627057000","0.1069","76523.17","65003.55"
"77.194.20.202","38149","244.3.210.197","80","8","3504","5","1234","3","2270","189.838455000","0.1069","92373.05","169924.49"
"244.3.160.239","61780","43.106.84.231","80","16","5112","8","1275","8","3837","76.971059000","0.1067","95638.15","287814.57"
"244.3.160.239","61705","117.246.95.43","80","10","2272","6","918","4","1354","59.961130000","0.1065","68968.11","101724.20"
"68.33.110.176","16176","244.3.160.239","80","10","1980","5","1049","5","931","164.217616000","0.1062","79023.69","70134.47"
"151.77.185.176","11386","244.3.160.239","80","16","5329","8","1460","8","3869","39.490921000","0.1060","110208.43","292052.35"
"244.3.155.77","2983","244.3.160.239","80","11","2850","6","1352","5","1498","0.191194000","0.1054","102621.52","113703.43"
"145.67.223.161","10533","244.3.160.239","80","15","6510","7","1579","8","4931","75.724555000","0.1054","119900.53","374432.86"
"244.3.164.46","9287","244.3.160.239","80","10","2256","5","1103","5","1153","153.958028000","0.1053","83823.35","87623.14"
"244.3.160.239","61707","117.246.95.43","80","12","3764","7","984","5","2780","59.992033000","0.1053","74782.69","211276.30"
"244.3.160.239","61688","117.246.95.43","80","10","1637","6","922","4","715","59.672614000","0.1051","70160.09","54408.31"
"41.177.241.23","21720","40.193.71.79","25","14","1026","6","434","8","592","201.289476000","0.1050","33064.78","45102.18"
"244.3.160.239","61691","117.246.95.43","80","10","1633","6","918","4","715","59.742841000","0.1050","69960.18","54489.68"
"244.3.160.239","61716","117.246.95.43","80","10","1690","6","919","4","771","60.153187000","0.1048","70163.38","58863.95"
"244.3.160.239","61715","117.246.95.43","80","10","2406","6","918","4","1488","60.153087000","0.1047","70145.28","113699.53"
"244.3.160.239","61389","177.124.75.164","80","15","4352","8","2356","7","1996","23.852712000","0.1044","180474.17","152897.47"
"244.3.155.77","8599","244.3.160.239","80","14","2422","8","1485","6","937","59.880484000","0.1041","114087.06","71986.25"
"244.3.155.77","2214","244.3.160.239","80","14","2312","8","1486","6","826","59.910351000","0.1041","114197.89","63477.43"
"244.3.160.239","61717","117.246.95.43","80","10","2406","6","918","4","1488","60.153519000","0.1040","70634.40","114492.36"
"41.177.168.181","15626","244.3.160.239","80","12","1717","6","952","6","765","78.438558000","0.1039","73302.66","58903.93"
"41.177.168.181","13331","244.3.160.239","80","12","1754","6","943","6","811","78.543666000","0.1037","72746.21","62563.28"
"244.3.160.239","61699","117.246.95.43","80","10","1569","6","921","4","648","59.843898000","0.1034","71241.41","50124.25"
"244.3.160.239","61692","117.246.95.43","80","10","2147","6","916","4","1231","59.744819000","0.1030","71166.36","95639.51"
"244.3.160.239","61693","117.246.95.43","80","10","1639","6","919","4","720","59.745451000","0.1028","71498.04","56015.87"
"244.3.155.77","6898","244.3.160.239","80","14","2422","8","1485","6","937","59.882011000","0.1028","115606.94","72945.25"
"244.3.160.239","61725","41.43.180.128","80","14","5897","7","1648","7","4249","62.324149000","0.1027","128425.17","331115.64"
"122.155.141.12","2623","244.3.160.239","80","12","3354","6","1306","6","2048","160.095356000","0.1025","101974.49","159910.99"
"244.3.181.123","14577","244.3.160.239","80","10","1806","5","1310","5","496","27.393885000","0.1023","102436.78","38785.22"
"244.3.160.239","62764","41.43.180.128","80","13","4072","7","2301","6","1771","230.514019000","0.1021","180219.69","138708.86"
"244.3.155.77","13570","244.3.160.239","80","14","3545","8","1485","6","2060","59.883691000","0.1017","116783.15","162002.22"
"244.3.181.123","11257","244.3.160.239","80","10","2050","5","1554","5","496","112.915643000","0.1017","122264.73","39024.01"
"253.94.153.215","2966","253.37.253.167","22","2","154","1","90","1","64","131.243117000","0.1017","N/A","N/A"
"244.3.160.239","61686","117.246.95.43","80","10","1652","6","917","4","735","59.655775000","0.1016","72234.59","57897.95"
"244.3.160.239","61397","177.124.75.164","80","13","2891","7","2221","6","670","24.903777000","0.1010","175872.04","53054.60"
"168.91.64.164","2398","244.3.210.255","80","15","12645","6","435","9","12210","17.303025000","0.1009","34497.80","968317.54"
"151.77.185.176","5075","244.3.160.239","80","19","10555","8","1473","11","9082","38.896722000","0.1008","116952.33","721086.95"
"244.3.164.46","15533","244.3.160.239","80","12","1847","6","1135","6","712","154.725414000","0.0999","90927.30","57039.86"
"41.177.3.203","58765","244.3.31.68","4888","20","2716","10","1534","10","1182","66.986578000","0.0998","122930.21","94721.97"
"244.3.160.239","61396","177.124.75.164","80","13","2891","7","2221","6","670","24.884108000","0.0998","178036.07","53707.41"
"77.194.20.202","38179","244.3.210.197","80","8","3493","5","1233","3","2260","190.170176000","0.0996","99015.27","181487.84"
"244.3.48.41","6412","244.3.160.239","80","10","2196","5","1335","5","861","18.861381000","0.0992","107623.32","69410.99"
"244.3.160.239","62412","244.3.31.75","80","13","3281","7","1355","6","1926","163.064091000","0.0990","109450.73","155573.51"
"244.3.160.239","61689","117.246.95.43","80","10","1632","6","921","4","711","59.679216000","0.0990","74434.77","57462.67"
"244.3.181.123","12162","244.3.160.239","80","10","2584","5","1431","5","1153","1.299399000","0.0987","115993.72","93459.65"
"77.194.20.202","38160","244.3.210.197","80","8","3509","5","1234","3","2275","189.945492000","0.0984","100293.61","184901.10"
"122.155.141.12","14534","244.3.160.239","80","11","2810","6","1612","5","1198","159.680060000","0.0983","131174.22","97485.56"
"244.3.160.239","61493","197.154.128.197","80","13","4909","7","1238","6","3671","39.496581000","0.0976","101459.82","300855.40"
"244.3.155.77","10803","244.3.160.239","80","13","2393","7","1435","6","958","87.971137000","0.0975","117773.79","78625.29"
"244.3.160.239","61729","41.43.180.128","80","11","2559","6","1571","5","988","64.145879000","0.0966","130161.46","81858.38"
"90.218.193.20","6434","244.3.160.239","80","11","2606","5","1040","6","1566","101.821471000","0.0962","86516.16","130273.38"
"244.3.160.239","61855","117.246.95.43","80","12","2983","7","1007","5","1976","87.370771000","0.0961","83790.98","164420.04"
"244.3.155.77","11037","244.3.160.239","80","15","4146","8","1481","7","2665","59.608417000","0.0960","123360.13","221981.59"
"244.3.164.46","14906","244.3.160.239","80","10","2028","5","1092","5","936","153.321747000","0.0960","90989.57","77991.06"
"244.3.155.77","11865","244.3.160.239","80","14","2308","8","1486","6","822","59.808654000","0.0959","124016.77","68601.47"
"244.3.160.239","61856","117.246.95.43","80","10","1647","6","936","4","711","87.372553000","0.0950","78836.82","59885.66"
"244.3.153.48","1492","41.177.230.119","524","2","128","1","64","1","64","120.976551000","0.0949","N/A","N/A"
"244.3.153.48","1491","41.177.230.252","524","2","128","1","64","1","64","120.976546000","0.0947","N/A","N/A"
"41.177.135.193","9414","244.3.160.239","80","12","3857","6","1569","6","2288","102.537011000","0.0947","132607.89","193375.94"
"244.3.160.239","61857","117.246.95.43","80","10","1623","6","938","4","685","87.373642000","0.0940","79796.68","58273.69"
"244.3.160.248","47780","41.177.26.193","80","14","3424","7","2524","7","900","64.550570000","0.0939","215034.98","76676.50"
"68.33.110.176","5468","244.3.160.239","80","12","2478","6","1225","6","1253","44.319822000","0.0939","104373.02","106758.69"
"41.177.168.181","4260","244.3.160.239","80","12","1769","6","954","6","815","78.433873000","0.0939","81298.73","69453.32"
"41.177.168.181","12021","244.3.160.239","80","12","1708","6","954","6","754","78.434068000","0.0938","81394.11","64330.35"
"41.177.192.117","10865","244.3.160.239","80","30","19367","13","1566","17","17801","163.886260000","0.0937","133650.53","1519229.33"
"41.177.168.181","2717","244.3.160.239","80","12","1694","6","952","6","742","78.434550000","0.0935","81444.96","63479.16"
"68.159.161.215","59837","244.3.210.197","80","9","1528","5","604","4","924","39.881763000","0.0935","51690.20","79075.74"
"244.3.160.239","61708","117.246.95.43","80","10","1705","6","916","4","789","60.023743000","0.0935","78396.97","67527.52"
"244.3.160.239","61709","117.246.95.43","80","13","4400","7","986","6","3414","60.024322000","0.0934","84447.63","292397.79"
"244.3.48.41","2310","244.3.160.239","80","10","2035","5","1335","5","700","24.265934000","0.0932","114534.52","60055.55"
"77.197.210.186","1774","41.177.26.176","80","12","7471","7","448","5","7023","0.038887000","0.0930","38545.51","604252.48"
"244.3.164.46","8550","244.3.160.239","80","12","3110","6","1141","6","1969","154.251549000","0.0929","98224.47","169503.93"
"244.3.155.77","15668","244.3.160.239","80","14","3157","8","1483","6","1674","59.812469000","0.0929","127714.09","144162.76"
"244.3.155.77","13443","244.3.160.239","80","14","2374","8","1493","6","881","59.812062000","0.0929","128576.66","75871.42"
"41.177.168.181","6063","244.3.160.239","80","11","1692","5","994","6","698","78.432918000","0.0926","85880.29","60306.28"
"41.177.192.117","10923","244.3.160.239","80","15","5257","7","1188","8","4069","163.883691000","0.0923","102949.62","352611.11"
"244.3.181.123","13924","244.3.160.239","80","12","3410","6","1463","6","1947","2.497209000","0.0923","126850.63","168816.25"
"168.91.64.164","3981","244.3.210.230","80","16","14163","6","435","10","13728","191.620963000","0.0922","37730.94","1190736.40"
"244.3.153.34","58040","244.3.31.117","443","21","3756","12","1894","9","1862","0.526120000","0.0920","164659.86","161877.85"
"244.3.181.123","3630","244.3.160.239","80","12","3311","6","1534","6","1777","1.418321000","0.0920","133397.10","154528.46"
"244.3.160.239","61714","117.246.95.43","80","10","1690","6","919","4","771","60.135395000","0.0919","79987.81","67106.21"
"244.3.155.77","2210","244.3.160.239","80","15","5029","8","1487","7","3542","60.072649000","0.0918","129536.67","308553.38"
"244.3.48.41","3626","244.3.160.239","80","10","2181","5","1320","5","861","6.577495000","0.0918","115001.36","75012.25"
"244.3.160.239","61745","117.246.95.43","80","10","1646","6","927","4","719","68.128739000","0.0916","80966.00","62798.87"
"244.3.155.77","11568","244.3.160.239","80","14","3026","8","1482","6","1544","60.073311000","0.0915","129548.29","134967.98"
"244.3.3.145","11348","244.3.160.239","80","198","138936","70","5107","128","133829","202.376386000","0.0907","450303.10","11800198.39"
"244.3.181.123","2498","244.3.160.239","80","12","3488","6","1548","6","1940","1.515775000","0.0906","136623.90","171221.16"
"244.3.253.224","9094","244.3.160.239","80","10","1823","5","1402","5","421","217.832535000","0.0906","123809.21","37178.09"
"41.177.98.43","38634","41.177.26.155","8010","14","4396","8","2418","6","1978","223.453326000","0.0903","214238.25","175253.62"
"244.3.155.77","2050","244.3.160.239","80","14","2313","8","1482","6","831","59.665678000","0.0888","133545.10","74882.57"
"90.218.193.20","3971","244.3.160.239","80","10","1991","5","1236","5","755","104.932813000","0.0886","111575.00","68154.63"
"244.3.160.239","61746","117.246.95.43","80","10","1638","6","927","4","711","68.129744000","0.0886","83704.87","64200.82"
"244.3.164.46","10168","244.3.160.239","80","10","2861","5","1142","5","1719","154.066920000","0.0884","103313.36","155512.84"
"244.3.181.123","12967","244.3.160.239","80","195","139127","67","5298","128","133829","115.174339000","0.0884","479381.09","12109303.96"
"244.3.160.239","61953","244.3.31.75","80","50","40802","19","2001","31","38801","102.229883000","0.0883","181291.05","3515379.39"
"244.3.155.77","3797","244.3.160.239","80","14","2293","8","1486","6","807","59.766143000","0.0883","134683.80","73142.55"
"68.157.168.41","2955","244.3.160.239","80","10","1469","5","556","5","913","155.537526000","0.0883","50396.56","82755.50"
"90.218.241.186","39827","244.3.210.197","80","7","3531","4","1012","3","2519","73.267048000","0.0881","91851.78","228631.07"
"244.3.160.239","61747","117.246.95.43","80","10","1640","6","926","4","714","68.130783000","0.0881","84091.04","64839.09"
"77.197.210.67","57758","41.177.26.176","80","7","3480","4","256","3","3224","0.023178000","0.0881","23254.23","292857.95"
"68.157.168.41","9733","244.3.160.239","80","10","1469","5","556","5","913","3.380539000","0.0880","50541.43","82993.40"
"41.177.211.185","15405","244.3.160.239","80","11","2659","5","1236","6","1423","160.454347000","0.0880","112419.85","129428.35"
"90.218.193.20","3866","244.3.160.239","80","13","4461","6","1283","7","3178","103.697625000","0.0878","116855.47","289451.81"
"244.3.160.239","61748","117.246.95.43","80","10","1644","6","928","4","716","68.131813000","0.0876","84734.35","65376.93"
"145.95.176.246","11955","244.3.160.239","80","15","6310","6","1399","9","4911","112.547334000","0.0875","127853.05","448810.80"
"244.3.164.46","10724","244.3.160.239","80","11","3096","5","1156","6","1940","154.159600000","0.0875","105693.84","177375.48"
"244.3.160.239","61356","244.3.31.75","80","23","16320","10","1321","13","14999","15.599403000","0.0875","120825.47","1371885.90"
"244.3.160.239","62722","41.43.180.128","80","17","5035","9","2727","8","2308","222.402677000","0.0873","249833.95","211447.29"
"41.177.199.139","16027","244.3.160.239","80","194","138897","67","5126","127","133771","57.724796000","0.0870","471464.70","12303610.03"
"244.3.160.239","61552","117.246.95.43","80","10","1489","6","1003","4","486","46.102684000","0.0866","92609.91","44873.79"
"253.160.251.90","1664","253.37.253.43","446","8","5532","0","0","8","5532","166.500292000","0.0865","N/A","511476.32"
"41.177.98.43","38635","41.177.26.155","8010","14","5324","8","3112","6","2212","225.175745000","0.0863","288478.70","205049.77"
"244.3.155.77","10124","244.3.160.239","80","14","3029","8","1483","6","1546","59.958189000","0.0862","137614.25","143460.31"
"244.3.155.77","15165","244.3.160.239","80","14","3011","8","1483","6","1528","59.958805000","0.0860","138001.63","142189.14"
"244.3.181.123","13750","244.3.160.239","80","15","5181","7","1506","8","3675","114.986483000","0.0858","140386.86","342577.49"
"244.3.160.239","61487","197.154.128.197","80","58","52043","22","2214","36","49829","38.965729000","0.0852","207821.47","4677297.10"
"145.67.149.81","49527","41.177.98.176","80","51","33315","26","2640","25","30675","180.863917000","0.0851","248271.97","2884751.02"
"244.3.253.224","9548","244.3.160.239","80","10","1834","5","1413","5","421","218.103700000","0.0849","133119.79","39662.73"
"41.177.3.224","52547","41.177.117.184","1618","60","28345","31","17166","29","11179","70.497546000","0.0848","1618784.92","1054199.97"
"168.91.64.164","63611","244.3.210.230","80","15","12645","6","435","9","12210","17.493209000","0.0847","41067.76","1152729.59"
"244.3.155.77","14964","244.3.160.239","80","15","4451","8","1485","7","2966","59.989732000","0.0847","140304.47","280231.01"
"244.3.155.77","6048","244.3.160.239","80","14","3145","8","1483","6","1662","60.149906000","0.0845","140379.11","157323.05"
"41.177.211.185","6927","244.3.160.239","80","194","138970","66","5141","128","133829","160.086617000","0.0845","486860.17","12673800.84"
"244.3.155.77","2464","244.3.160.239","80","14","2376","8","1487","6","889","59.670288000","0.0844","140884.44","84227.48"
"244.3.155.77","8810","244.3.160.239","80","14","3145","8","1483","6","1662","60.150395000","0.0844","140520.44","157481.43"
"244.3.155.77","10938","244.3.160.239","80","14","2429","8","1484","6","945","60.150830000","0.0843","140756.90","89632.93"
"244.3.155.77","12484","244.3.160.239","80","14","2372","8","1483","6","889","59.740494000","0.0839","141339.05","84727.19"
"244.3.181.123","13709","244.3.160.239","80","12","3488","6","1519","6","1969","1.613083000","0.0835","145505.05","188610.57"
"41.177.211.185","2171","244.3.160.239","80","14","6759","6","1315","8","5444","160.572650000","0.0834","126151.19","522256.33"
"168.91.64.164","3977","244.3.210.230","80","16","14163","6","435","10","13728","98.388634000","0.0834","41739.63","1317245.18"
"244.3.213.210","7590","244.3.160.239","80","15","6561","6","1654","9","4907","26.567413000","0.0832","158998.33","471707.86"
"145.67.149.81","49518","41.177.98.176","80","27","13433","14","1800","13","11633","180.721103000","0.0831","173303.97","1120025.03"
"244.3.181.123","16180","244.3.160.239","80","10","2406","5","1470","5","936","0.629701000","0.0831","141582.69","90150.61"
"244.3.155.77","4792","244.3.160.239","80","14","2308","8","1486","6","822","59.841633000","0.0828","143552.34","79407.82"
"244.3.181.123","8134","244.3.160.239","80","16","7753","7","1511","9","6242","114.987907000","0.0828","146041.49","603303.09"
"41.177.124.47","5246","244.3.160.239","80","148","106057","50","4401","98","101656","224.957409000","0.0827","425546.32","9829433.38"
"244.3.155.77","9749","244.3.160.239","80","14","2886","8","1481","6","1405","59.742414000","0.0825","143671.33","136298.60"
"244.3.213.252","6566","244.3.160.239","80","10","1566","5","1165","5","401","20.742298000","0.0822","113335.12","39010.63"
"244.3.155.77","13623","244.3.160.239","80","14","2378","8","1484","6","894","59.742984000","0.0822","144426.47","87006.24"
"77.197.128.31","58557","41.177.26.176","80","9","5075","4","256","5","4819","0.018681000","0.0822","24926.06","469213.64"
"244.3.160.248","47962","41.177.26.55","80","11","1633","6","1122","5","511","79.220519000","0.0822","109256.89","49759.60"
"77.197.128.55","54531","41.177.26.176","80","5","624","3","494","2","130","234.317493000","0.0821","48165.17","12675.04"
"77.197.128.193","53732","41.177.26.176","80","5","670","3","540","2","130","234.209741000","0.0820","52704.78","12688.19"
"244.3.153.34","58093","244.3.31.117","443","40","17044","20","2460","20","14584","122.198096000","0.0819","240184.53","1423923.26"
"90.218.193.20","4020","244.3.160.239","80","30","18322","12","1667","18","16655","103.699668000","0.0819","162779.06","1626325.88"
"77.197.210.48","11922","41.177.26.91","8000","6","4746","3","192","3","4554","72.978506000","0.0816","18825.61","446519.84"
"77.197.210.231","53422","41.177.26.91","8000","6","4746","3","192","3","4554","13.815232000","0.0815","18848.24","447056.80"
"41.177.98.252","13079","244.3.160.239","80","10","1832","5","1203","5","629","24.896354000","0.0814","118184.50","61793.89"
"244.3.3.145","2070","244.3.160.239","80","83","58364","31","2532","52","55832","202.260913000","0.0814","248872.73","5487781.20"
"244.3.253.224","6398","244.3.160.239","80","10","1835","5","1414","5","421","218.107604000","0.0812","139243.47","41457.92"
"244.3.41.252","50109","41.177.3.224","5666","15","3706","9","1904","6","1802","183.319462000","0.0811","187852.25","177788.74"
"244.3.155.77","9781","244.3.160.239","80","14","2391","8","1482","6","909","59.653543000","0.0810","146359.53","89771.13"
"244.3.160.239","62784","41.43.180.128","80","13","3727","7","1545","6","2182","234.277690000","0.0806","153294.72","216497.79"
"68.33.110.176","13661","244.3.160.239","80","12","4367","5","1353","7","3014","187.523566000","0.0804","134703.94","300072.18"
"144.154.4.18","15660","41.177.98.127","210","5","322","3","194","2","128","131.692269000","0.0803","19325.12","12750.59"
"90.218.193.20","7587","244.3.160.239","80","10","2275","5","1223","5","1052","104.427348000","0.0800","122296.94","105197.37"
"145.67.149.81","49523","41.177.98.176","80","32","18270","16","1932","16","16338","180.807039000","0.0799","193495.08","1636295.35"
"244.3.160.239","62706","41.43.180.128","80","11","2517","6","1500","5","1017","218.893427000","0.0798","150334.49","101926.79"
"244.3.160.239","62718","41.43.180.128","80","11","2440","6","1564","5","876","221.381086000","0.0797","156965.07","87916.50"
"244.3.160.239","62782","41.43.180.128","80","13","3723","7","1543","6","2180","233.869939000","0.0797","154888.58","218831.56"
"77.197.128.41","26123","41.177.26.176","80","5","650","3","520","2","130","233.876836000","0.0793","52448.43","13112.11"
"244.3.160.239","61765","41.43.180.128","80","11","2534","6","1643","5","891","73.846322000","0.0792","165959.60","90000.00"
"244.3.3.145","3718","244.3.160.239","80","21","13066","9","1215","12","11851","203.456954000","0.0792","122747.42","1197267.23"
"244.3.160.239","62711","41.43.180.128","80","11","2438","6","1562","5","876","219.409467000","0.0791","157989.23","88603.43"
"244.3.160.239","62712","41.43.180.128","80","11","2439","6","1563","5","876","219.851278000","0.0791","158144.36","88633.69"
"244.3.160.239","62780","41.43.180.128","80","13","3719","7","1541","6","2178","233.505688000","0.0790","156030.88","220529.05"
"244.3.160.239","62781","41.43.180.128","80","13","3721","7","1542","6","2179","233.664771000","0.0789","156270.59","220825.94"
"244.3.160.239","62783","41.43.180.128","80","13","3725","7","1544","6","2181","233.999410000","0.0789","156570.46","221165.91"
"77.197.128.117","31837","41.177.26.91","8000","6","4746","3","192","3","4554","183.571600000","0.0788","19488.43","462241.17"
"244.3.160.239","62387","244.3.31.75","80","16","6854","8","1336","8","5518","160.575653000","0.0787","135755.11","560701.13"
"244.3.160.239","61411","244.3.31.75","80","14","6139","7","1608","7","4531","26.571601000","0.0786","163576.71","460924.19"
"244.3.160.239","62721","41.43.180.128","80","11","2441","6","1565","5","876","221.872033000","0.0786","159313.88","89175.05"
"244.3.160.248","49751","41.177.26.55","80","23","15701","10","1387","13","14314","202.092074000","0.0785","141289.12","1458120.05"
"244.3.160.239","62708","41.43.180.128","80","11","2517","6","1502","5","1015","219.016818000","0.0785","153112.97","103468.49"
"244.3.160.239","62710","41.43.180.128","80","11","2296","6","1503","5","793","219.213017000","0.0785","153218.82","80840.00"
"244.3.160.239","62727","41.43.180.128","80","11","1948","6","1497","5","451","222.821452000","0.0783","152864.29","46053.30"
"244.3.160.239","62735","197.154.128.197","80","108","103704","39","3587","69","100117","224.961541000","0.0782","367050.40","10244768.48"
"244.3.155.77","15597","244.3.160.239","80","14","2371","8","1486","6","885","59.677049000","0.0782","152061.30","90561.40"
"41.177.199.139","3414","244.3.160.239","443","22","7725","10","1861","12","5864","57.318680000","0.0781","190524.94","600342.97"
"244.3.160.239","62694","41.43.180.128","80","11","1965","6","1516","5","449","217.811183000","0.0781","155339.81","46007.63"
"77.197.210.224","20380","41.177.26.91","8000","2","1582","1","64","1","1518","75.047435000","0.0780","N/A","N/A"
"253.160.251.90","1719","253.37.253.43","446","7","3824","0","0","7","3824","180.111415000","0.0780","N/A","392300.69"
"244.3.160.239","62702","41.43.180.128","80","11","2455","6","1559","5","896","218.429617000","0.0779","160026.69","91971.72"
"244.3.160.239","62703","41.43.180.128","80","11","2436","6","1560","5","876","218.653640000","0.0779","160133.44","89921.09"
"244.3.160.239","62707","41.43.180.128","80","11","2437","6","1561","5","876","219.015133000","0.0778","160477.01","90056.29"
"244.3.160.239","62725","41.43.180.128","80","11","2442","6","1566","5","876","222.516936000","0.0777","161179.51","90161.72"
"244.3.160.239","61409","244.3.31.75","443","21","6202","11","2149","10","4053","26.467047000","0.0777","221301.14","417372.50"
"244.3.160.239","62690","41.43.180.128","80","11","1973","6","1500","5","473","217.321225000","0.0776","154597.34","48749.69"
"244.3.160.239","62728","41.43.180.128","80","11","1964","6","1515","5","449","222.821923000","0.0776","156280.22","46316.71"
"244.3.160.239","61690","117.246.95.43","80","10","2248","6","914","4","1334","59.710360000","0.0774","94525.24","137961.35"
"244.3.160.239","62131","244.3.31.108","80","14","5009","7","1382","7","3627","114.993943000","0.0772","143253.26","375962.06"
"244.3.160.239","62729","41.43.180.128","80","11","1961","6","1511","5","450","222.822683000","0.0770","156970.70","46748.39"
"41.177.98.252","8522","244.3.160.239","80","12","3195","6","1274","6","1921","23.849545000","0.0769","132501.30","199791.99"
"244.3.160.239","62688","41.43.180.128","80","11","2006","6","1532","5","474","217.319671000","0.0769","159433.86","49328.75"
"244.3.160.239","62700","41.43.180.128","80","11","1978","6","1530","5","448","218.149624000","0.0768","159399.91","46673.96"
"244.3.160.239","61675","117.246.95.43","80","10","1482","6","997","4","485","59.296988000","0.0767","103948.91","50566.92"
"244.3.160.239","62692","41.43.180.128","80","11","2006","6","1533","5","473","217.489541000","0.0764","160552.98","49537.87"
"77.13.122.26","2173","41.177.98.127","210","5","322","3","194","2","128","52.375899000","0.0763","20330.63","13414.03"
"244.3.155.77","8032","244.3.160.239","80","13","3530","7","1438","6","2092","87.367844000","0.0762","151064.30","219768.10"
"244.3.160.239","62699","41.43.180.128","80","11","1977","6","1527","5","450","218.132733000","0.0760","160764.34","47376.52"
"244.3.160.239","62691","41.43.180.128","80","11","1991","6","1516","5","475","217.489062000","0.0760","159660.88","50025.67"
"244.3.160.239","62696","41.43.180.128","80","11","1965","6","1516","5","449","217.841217000","0.0759","159705.03","47300.50"
"244.3.160.239","62132","244.3.31.108","80","16","7646","8","1451","8","6195","114.994740000","0.0759","152903.83","652818.21"
"244.3.160.239","62693","41.43.180.128","80","11","2010","6","1536","5","474","217.490238000","0.0758","162215.68","50058.75"
"244.3.160.239","61491","197.154.128.197","80","25","18096","11","1506","14","16590","39.451431000","0.0757","159072.60","1752333.67"
"244.3.160.239","62724","41.43.180.128","80","11","1951","6","1501","5","450","222.481711000","0.0757","158548.66","47532.91"
"244.3.160.239","62689","41.43.180.128","80","11","1984","6","1509","5","475","217.319772000","0.0757","159461.07","50194.84"
"244.3.160.239","62698","41.43.180.128","80","11","1977","6","1528","5","449","218.132350000","0.0756","161684.57","47510.71"
"41.177.192.117","9494","244.3.160.239","80","11","2954","5","1112","6","1842","164.438616000","0.0755","117827.81","195178.81"
"41.177.3.203","58775","244.3.31.68","4888","20","2716","10","1534","10","1182","187.274740000","0.0755","162616.28","125301.46"
"244.3.155.77","15193","244.3.160.239","80","14","2386","7","1431","7","955","87.368942000","0.0754","151729.62","101259.11"
"244.3.160.239","62383","244.3.31.75","80","22","14468","10","1786","12","12682","160.463198000","0.0754","189543.78","1345909.45"
"244.3.155.77","4618","244.3.160.239","80","14","2362","7","1433","7","929","87.369512000","0.0753","152329.32","98753.62"
"244.3.160.239","61524","117.246.95.43","80","10","1501","6","1017","4","484","45.614249000","0.0750","108412.06","51594.33"
"244.3.160.239","61670","117.246.95.43","80","10","1479","6","994","4","485","59.235189000","0.0747","106436.80","51933.45"
"244.3.160.239","61671","117.246.95.43","80","10","1475","6","990","4","485","59.235924000","0.0746","106227.45","52040.72"
"244.3.160.239","61534","117.246.95.43","80","10","1487","6","1002","4","485","45.809307000","0.0745","107575.66","52070.05"
"244.3.181.123","14766","244.3.160.239","80","98","83918","37","3382","61","80536","115.423040000","0.0744","363455.62","8655015.38"
"244.3.160.239","61669","117.246.95.43","80","10","1474","6","989","4","485","59.234806000","0.0744","106312.65","52135.12"
"244.3.160.239","61533","117.246.95.43","80","10","1496","6","1011","4","485","45.809172000","0.0744","108693.61","52142.83"
"244.3.160.239","61523","117.246.95.43","80","10","1501","6","1017","4","484","45.614096000","0.0742","109658.46","52187.51"
"244.3.160.239","61549","117.246.95.43","80","10","1489","6","1004","4","485","46.094698000","0.0740","108508.28","52416.85"
"244.3.160.239","61539","117.246.95.43","80","10","1485","6","1000","4","485","45.926820000","0.0740","108106.65","52431.72"
"244.3.160.239","61525","117.246.95.43","80","10","1507","6","1009","4","498","45.615252000","0.0739","109228.69","53910.69"
"244.3.160.239","61680","117.246.95.43","80","10","1486","6","1001","4","485","59.553584000","0.0737","108658.19","52646.58"
"244.3.160.239","61668","117.246.95.43","80","10","1480","6","995","4","485","59.210494000","0.0737","108012.76","52649.43"
"244.3.160.239","61526","117.246.95.43","80","10","1505","6","1007","4","498","45.667159000","0.0737","109321.36","54063.59"
"244.3.160.239","61543","117.246.95.43","80","10","1491","6","1006","4","485","45.985437000","0.0737","109214.28","52653.01"
"244.3.160.239","61554","117.246.95.43","80","10","1486","6","1001","4","485","46.169605000","0.0737","108700.96","52667.30"
"145.67.149.81","49520","41.177.98.176","80","24","12108","12","1669","12","10439","180.738332000","0.0736","181297.27","1133949.79"
"41.177.124.47","7759","244.3.160.239","80","12","2795","6","1610","6","1185","214.884140000","0.0736","174931.07","128753.62"
"244.3.160.239","62415","41.177.254.197","80","13","5264","7","1304","6","3960","163.886706000","0.0736","141712.17","430352.92"
"244.3.160.239","61657","117.246.95.43","80","10","1491","6","1007","4","484","58.925578000","0.0736","109449.09","52605.12"
"244.3.160.239","61560","117.246.95.43","80","10","1492","6","1007","4","485","46.240725000","0.0735","109578.61","52776.19"
"244.3.160.239","61679","117.246.95.43","80","10","1486","6","1001","4","485","59.536982000","0.0735","108970.17","52797.74"
"244.3.153.30","1789","41.177.230.83","631","10","1795","5","979","5","816","45.414987000","0.0734","106652.14","88894.94"
"41.177.124.47","13839","244.3.160.239","80","18","11071","8","1736","10","9335","225.318263000","0.0734","189137.66","1017050.72"
"244.3.160.239","61545","117.246.95.43","80","10","1497","6","1012","4","485","46.037480000","0.0734","110344.83","52882.65"
"41.177.98.141","65262","197.48.26.167","113","2","134","1","70","1","64","50.296042000","0.0733","N/A","N/A"
"244.3.160.239","61535","117.246.95.43","80","10","1486","6","1001","4","485","45.810274000","0.0733","109269.04","52942.54"
"244.3.160.239","61540","117.246.95.43","80","10","1484","6","999","4","485","45.927369000","0.0733","109058.16","52946.15"
"244.3.160.239","61555","117.246.95.43","80","10","1485","6","1000","4","485","46.170045000","0.0733","109203.09","52963.50"
"244.3.160.239","61529","117.246.95.43","80","10","1505","6","1007","4","498","45.684389000","0.0732","110021.58","54409.88"
"244.3.160.239","61684","117.246.95.43","80","10","1479","6","993","4","486","59.607967000","0.0732","108592.83","53148.15"
"244.3.160.239","61559","117.246.95.43","80","10","1492","6","1007","4","485","46.240081000","0.0731","110137.40","53045.32"
"244.3.155.77","11254","244.3.160.239","80","14","2444","8","1481","6","963","60.021346000","0.0731","161997.35","105336.56"
"244.3.160.239","61327","244.3.31.75","80","25","18065","11","1385","14","16680","7.443259000","0.0731","151560.75","1825294.78"
"244.3.160.239","61678","117.246.95.43","80","10","1480","6","995","4","485","59.536601000","0.0731","108899.38","53081.61"
"244.3.160.239","61656","117.246.95.43","80","10","1497","6","999","4","498","58.925553000","0.0730","109419.50","54545.45"
"244.3.160.239","61667","117.246.95.43","80","10","1476","6","991","4","485","59.145401000","0.0730","108550.69","53125.21"
"244.3.160.239","61532","117.246.95.43","80","10","1500","6","1015","4","485","45.808183000","0.0729","111319.80","53192.22"
"244.3.160.239","61665","117.246.95.43","80","10","1486","6","1001","4","485","59.144292000","0.0729","109787.36","53193.68"
"244.3.160.239","61550","117.246.95.43","80","10","1489","6","1004","4","485","46.095017000","0.0729","110148.11","53209.00"
"244.3.160.239","61666","117.246.95.43","80","10","1490","6","1005","4","485","59.145015000","0.0729","110265.38","53212.64"
"244.3.155.77","7926","244.3.160.239","80","15","5029","8","1487","7","3542","60.021765000","0.0729","163171.25","388670.19"
"244.3.160.239","61672","117.246.95.43","80","10","1476","6","991","4","485","59.267450000","0.0728","108833.83","53263.78"
"244.3.160.239","61663","117.246.95.43","80","10","1492","6","994","4","498","59.061578000","0.0728","109259.28","54739.56"
"244.3.160.239","61659","117.246.95.43","80","10","1498","6","1000","4","498","58.978450000","0.0727","109965.64","54762.89"
"244.3.160.239","61537","117.246.95.43","80","10","1489","6","1004","4","485","45.925143000","0.0727","110484.47","53371.48"
"244.3.160.239","61682","117.246.95.43","80","10","1479","6","994","4","485","59.594219000","0.0727","109390.05","53374.42"
"244.3.160.239","61713","117.246.95.43","80","10","1483","6","998","4","485","60.094909000","0.0727","109868.03","53392.78"
"244.3.160.239","61547","117.246.95.43","80","10","1496","6","1011","4","485","46.042970000","0.0727","111312.96","53399.39"
"244.3.160.239","61561","117.246.95.43","80","10","1490","6","1005","4","485","46.267504000","0.0726","110754.48","53448.68"
"244.3.160.239","61553","117.246.95.43","80","10","1487","6","1002","4","485","46.158721000","0.0726","110428.43","53450.89"
"244.3.160.239","61562","117.246.95.43","80","10","1490","6","1005","4","485","46.280545000","0.0726","110777.37","53459.73"
"244.3.160.239","61528","117.246.95.43","80","10","1505","6","1007","4","498","45.683871000","0.0725","111045.25","54916.12"
"244.3.160.239","61681","117.246.95.43","80","10","1479","6","994","4","485","59.554278000","0.0725","109644.95","53498.79"
"244.3.160.239","61522","117.246.95.43","80","10","1502","6","1004","4","498","45.612937000","0.0725","110772.46","54944.90"
"244.3.160.239","61658","117.246.95.43","80","10","1495","6","997","4","498","58.976219000","0.0725","110000.14","54944.90"
"244.3.160.239","61655","117.246.95.43","80","10","1492","6","994","4","498","58.924453000","0.0725","109670.66","54945.66"
"244.3.160.239","61542","117.246.95.43","80","10","1494","6","1009","4","485","45.985018000","0.0725","111339.47","53517.98"
"244.3.160.239","61673","117.246.95.43","80","10","1481","6","996","4","485","59.291739000","0.0725","109917.09","53523.89"
"244.3.160.239","61548","117.246.95.43","80","10","1496","6","1011","4","485","46.044617000","0.0724","111649.48","53560.83"
"244.3.160.239","61530","117.246.95.43","80","10","1501","6","1003","4","498","45.723107000","0.0724","110772.12","54999.52"
"151.77.185.176","10989","244.3.160.239","80","15","2299","8","1479","7","820","39.476604000","0.0724","163436.70","90613.99"
"244.3.160.239","61654","117.246.95.43","80","10","1491","6","1007","4","484","58.920978000","0.0723","111355.31","53521.32"
"244.3.253.224","2125","244.3.160.239","80","10","1822","5","1401","5","421","222.808493000","0.0723","154962.88","46566.29"
"244.3.160.239","61558","117.246.95.43","80","10","1493","6","1008","4","485","46.225483000","0.0723","111513.68","53654.89"
"244.3.160.239","61323","244.3.31.75","80","25","18065","11","1385","14","16680","7.265442000","0.0723","153265.18","1845821.86"
"244.3.160.239","61664","117.246.95.43","80","10","1477","6","992","4","485","59.143667000","0.0723","109798.28","53681.62"
"244.3.160.239","61538","117.246.95.43","80","10","1490","6","1005","4","485","45.926275000","0.0722","111306.47","53715.06"
"244.3.160.239","61676","117.246.95.43","80","10","1487","6","1002","4","485","59.351280000","0.0722","110992.65","53723.99"
"244.3.160.239","61661","117.246.95.43","80","10","1495","6","997","4","498","58.992363000","0.0722","110473.97","55181.58"
"244.3.160.239","61683","117.246.95.43","80","10","1479","6","994","4","485","59.594857000","0.0722","110149.18","53744.82"
"244.3.160.239","61541","117.246.95.43","80","10","1486","6","1001","4","485","45.981521000","0.0722","110971.00","53767.17"
"244.3.160.239","61546","117.246.95.43","80","10","1490","6","1005","4","485","46.040726000","0.0721","111440.69","53779.84"
"244.3.160.239","61527","117.246.95.43","80","10","1508","6","1010","4","498","45.675137000","0.0721","112009.09","55228.25"
"244.3.160.239","61551","117.246.95.43","80","10","1489","6","1004","4","485","46.099009000","0.0721","111399.29","53813.40"
"244.3.160.239","61674","117.246.95.43","80","10","1484","6","999","4","485","59.296243000","0.0721","110864.50","53823.11"
"244.3.160.239","61712","117.246.95.43","80","10","1482","6","997","4","485","60.081216000","0.0720","110776.24","53888.14"
"244.3.160.239","61563","117.246.95.43","80","10","1492","6","1007","4","485","46.295476000","0.0720","111890.44","53889.64"
"244.3.160.239","62425","41.177.254.197","80","12","3097","7","1306","5","1791","164.441394000","0.0720","145119.17","199011.06"
"244.3.160.239","61544","117.246.95.43","80","10","1492","6","1007","4","485","45.990625000","0.0720","111918.42","53903.11"
"244.3.160.239","61662","117.246.95.43","80","10","1491","6","993","4","498","59.031327000","0.0720","110370.12","55351.78"
"244.3.160.239","61531","117.246.95.43","80","10","1502","6","1004","4","498","45.729557000","0.0720","111626.87","55368.71"
"244.3.160.239","61556","117.246.95.43","80","10","1492","6","1007","4","485","46.184671000","0.0719","111991.55","53938.33"
"244.3.160.239","61557","117.246.95.43","80","10","1493","6","1008","4","485","46.213425000","0.0719","112155.77","53963.84"
"244.3.160.239","61660","117.246.95.43","80","10","1495","6","997","4","498","58.980336000","0.0718","111012.14","55450.40"
"244.3.153.48","1490","41.177.230.40","524","2","128","1","64","1","64","22.287080000","0.0717","N/A","N/A"
"145.67.149.81","49507","41.177.98.176","80","17","7506","9","1455","8","6051","180.597080000","0.0714","163027.49","677992.69"
"244.3.155.77","11762","244.3.160.239","80","14","2429","8","1484","6","945","60.133134000","0.0714","166388.70","105955.07"
"244.3.160.239","61512","244.3.31.75","80","11","2368","6","1111","5","1257","44.333812000","0.0711","125061.56","141496.29"
"244.3.160.239","62417","41.177.254.197","80","28","19375","12","1618","16","17757","163.889091000","0.0711","182135.42","1998874.32"
"41.177.192.117","15083","244.3.160.239","80","13","3800","6","1171","7","2629","161.824447000","0.0711","131848.95","296012.72"
"90.218.241.186","39694","244.3.210.197","80","10","6305","5","1656","5","4649","53.124695000","0.0707","187309.13","525845.49"
"244.3.155.77","12430","244.3.160.239","80","13","2315","7","1422","6","893","68.124718000","0.0704","161494.56","101416.77"
"244.3.155.77","10323","244.3.160.239","80","14","2379","7","1421","7","958","68.125782000","0.0702","161925.79","109166.01"
"244.3.155.77","6217","244.3.160.239","80","14","2377","7","1422","7","955","68.125381000","0.0702","162099.77","108864.48"
"244.3.155.77","3759","244.3.160.239","80","14","2383","8","1493","6","890","68.126200000","0.0702","170207.91","101463.53"
"68.33.110.176","4368","244.3.160.239","80","12","4333","5","1353","7","2980","170.379705000","0.0701","154300.13","339848.04"
"41.177.192.117","10376","244.3.160.239","80","15","6602","7","1183","8","5419","161.672461000","0.0701","134968.63","618254.42"
"68.33.110.176","9264","244.3.160.239","80","12","4355","5","1353","7","3002","117.581730000","0.0699","154854.22","343586.37"
"90.218.193.20","15955","244.3.160.239","80","14","5847","6","1290","8","4557","104.287863000","0.0697","147963.35","522689.15"
"145.67.149.81","49519","41.177.98.176","80","17","7257","9","1448","8","5809","180.734055000","0.0697","166295.81","667135.62"
"15.186.110.142","53319","41.177.26.176","80","5","834","3","682","2","152","233.475758000","0.0692","78861.02","17576.06"
"244.3.253.224","8513","244.3.160.239","80","15","4729","7","2555","8","2174","222.398124000","0.0689","296627.39","252394.50"
"145.67.149.81","49513","41.177.98.176","80","22","10094","11","1577","11","8517","180.687240000","0.0689","183196.35","989399.70"
"41.177.192.117","13697","244.3.160.239","80","12","1984","6","1361","6","623","168.912182000","0.0687","158488.48","72548.36"
"41.177.124.47","10658","244.3.160.239","80","14","7191","6","1625","8","5566","225.320555000","0.0686","189421.54","648812.47"
"145.67.149.81","49524","41.177.98.176","80","25","11895","13","1720","12","10175","180.807043000","0.0686","200662.07","1187056.13"
"244.3.160.239","62680","197.154.128.197","80","10","2604","6","1500","4","1104","214.888901000","0.0685","175205.50","128951.25"
"244.3.160.239","61945","244.3.31.75","80","52","42453","20","2062","32","40391","101.507058000","0.0684","241169.59","4724093.57"
"244.3.253.224","14669","244.3.160.239","80","10","1804","5","1383","5","421","222.817723000","0.0681","162564.83","49486.47"
"244.3.155.77","14465","244.3.160.239","80","11","2019","6","1428","5","591","46.100389000","0.0681","167861.76","69472.20"
"41.177.124.47","10309","244.3.160.239","80","15","5722","7","1689","8","4033","225.319082000","0.0680","198700.04","474456.63"
"244.3.160.239","62744","197.154.128.197","80","13","5496","7","1579","6","3917","225.323541000","0.0675","187118.56","464182.02"
"244.3.160.239","62410","41.177.254.197","80","19","10583","9","1436","10","9147","161.923110000","0.0673","170624.84","1086842.22"
"41.177.199.139","3825","244.3.160.239","80","95","83566","35","3088","60","80478","58.147552000","0.0670","368986.27","9616346.28"
"253.37.253.43","2000","253.213.108.203","515","11","1334","11","1334","0","0","74.413884000","0.0669","159583.69","N/A"
"244.3.253.224","11403","244.3.160.239","80","10","1818","5","1397","5","421","222.814975000","0.0666","167717.15","50543.25"
"244.3.160.248","49299","41.177.26.193","80","160","151749","56","5202","104","146547","170.003535000","0.0665","625738.64","17627858.72"
"41.177.98.98","36206","244.3.31.26","7980","7","1551","4","1130","3","421","206.264701000","0.0659","137240.02","51131.02"
"244.3.160.239","62445","41.177.254.197","80","10","1939","6","1427","4","512","168.916152000","0.0652","175000.77","62789.34"
"90.218.193.20","9704","244.3.160.239","80","15","8469","6","1289","9","7180","105.050932000","0.0645","159871.01","890515.02"
"244.3.253.224","3960","244.3.160.239","80","10","2308","5","1420","5","888","218.889076000","0.0643","176768.07","110542.29"
"244.3.253.224","4924","244.3.160.239","80","10","1823","5","1402","5","421","217.804949000","0.0640","175195.25","52608.56"
"244.3.160.239","61937","244.3.31.75","80","14","5962","7","1431","7","4531","101.356454000","0.0637","179765.40","569194.29"
"41.177.124.47","5667","244.3.160.239","80","11","2222","5","1548","6","674","225.324256000","0.0632","195967.97","85324.56"
"244.3.160.239","62743","197.154.128.197","80","18","10973","9","1690","9","9283","225.322269000","0.0632","214073.09","1175881.94"
"194.224.157.64","38578","41.177.98.127","210","6","401","3","192","3","209","0.065270000","0.0630","24370.12","26527.89"
"244.3.181.123","12219","244.3.160.239","80","13","3859","6","1449","7","2410","114.950912000","0.0630","183947.44","305944.33"
"244.3.253.224","6510","244.3.160.239","80","10","1839","5","1418","5","421","217.313895000","0.0627","180904.84","53710.11"
"244.3.160.239","62746","197.154.128.197","80","10","2060","6","1502","4","558","225.328768000","0.0627","191694.72","71215.48"
"244.3.253.224","9974","244.3.160.239","80","10","2088","5","1423","5","665","219.208918000","0.0623","182646.64","85354.90"
"41.177.124.47","12904","244.3.160.239","80","11","2223","5","1549","6","674","225.324909000","0.0623","199033.10","86603.17"
"151.77.185.176","15563","244.3.160.239","80","13","2686","7","1435","6","1251","39.414912000","0.0622","184420.63","160773.67"
"244.3.253.224","16024","244.3.160.239","80","10","2308","5","1422","5","886","219.013548000","0.0622","182840.98","113922.02"
"244.3.253.224","15484","244.3.160.239","80","10","1837","5","1416","5","421","218.141850000","0.0619","182995.98","54407.70"
"244.3.160.239","61772","244.3.31.75","80","14","5958","7","1427","7","4531","75.739514000","0.0619","184554.70","585996.73"
"244.3.3.145","7939","244.3.160.239","80","18","10189","8","1149","10","9040","202.567843000","0.0615","149567.99","1176757.73"
"244.3.253.224","10322","244.3.160.239","80","10","1843","5","1422","5","421","217.484185000","0.0614","185231.62","54840.02"
"151.77.108.208","7919","244.3.160.239","80","17","6560","8","1559","9","5001","186.491952000","0.0613","203388.72","652435.54"
"244.3.160.248","48059","41.177.26.55","80","20","12796","9","1079","11","11717","86.199917000","0.0611","141318.23","1534592.84"
"41.177.4.139","57628","244.3.41.84","9992","9","711","5","431","4","280","182.039304000","0.0609","56621.12","36784.03"
"41.177.98.43","38630","41.177.26.155","8010","14","4624","8","2798","6","1826","220.322695000","0.0608","368024.73","240176.25"
"151.77.185.176","12488","244.3.160.239","80","18","5558","9","1539","9","4019","39.496330000","0.0608","202573.30","529007.21"
"244.3.3.145","9420","244.3.160.239","80","23","13495","10","1278","13","12217","202.955634000","0.0607","168299.07","1608849.53"
"244.3.160.239","62745","197.154.128.197","80","15","7157","8","1643","7","5514","225.324968000","0.0605","217191.58","728907.10"
"145.67.149.81","49522","41.177.98.176","80","17","7624","9","1443","8","6181","180.807034000","0.0605","190756.32","817092.72"
"41.177.3.224","9802","244.3.176.149","2391","28","8720","13","3220","15","5500","85.903671000","0.0604","426285.39","728127.22"
"244.3.253.224","13442","244.3.160.239","80","10","1807","5","1386","5","421","217.317237000","0.0604","183500.21","55738.52"
"90.218.193.20","8381","244.3.160.239","80","11","3217","5","1223","6","1994","105.157334000","0.0604","162035.04","264184.69"
"145.67.149.81","49516","41.177.98.176","80","17","7709","9","1444","8","6265","180.687249000","0.0602","191814.03","832212.54"
"253.37.253.167","43948","253.160.239.39","1521","2","132","1","64","1","68","30.215127000","0.0602","N/A","N/A"
"244.3.253.224","11651","244.3.160.239","80","10","1840","5","1419","5","421","217.486414000","0.0600","189149.56","56118.37"
"244.3.160.239","61960","244.3.31.75","443","20","5899","11","1973","9","3926","103.024491000","0.0594","265598.71","528505.08"
"244.3.180.219","55202","41.177.98.176","80","4","256","2","128","2","128","4.773870000","0.0594","17253.00","17253.00"
"244.3.181.123","4362","244.3.160.239","80","18","9081","8","1574","10","7507","115.077872000","0.0593","212376.25","1012902.46"
"244.3.160.239","62402","41.177.254.197","80","15","6737","8","1363","7","5374","161.676176000","0.0592","184189.19","726216.22"
"244.3.153.34","58039","244.3.31.117","443","43","17254","22","2600","21","14654","0.524847000","0.0592","351458.21","1980872.56"
"244.3.253.224","11060","244.3.160.239","80","10","1816","5","1395","5","421","217.315419000","0.0589","189354.73","57145.77"
"145.95.31.210","10920","244.3.160.239","80","16","6319","7","1408","9","4911","87.252612000","0.0587","192051.29","669860.70"
"244.3.253.224","3963","244.3.160.239","80","10","1823","5","1402","5","421","217.485208000","0.0582","192701.53","57865.44"
"41.177.199.139","12363","244.3.160.239","80","12","2526","6","964","6","1562","56.726172000","0.0581","132686.42","214996.04"
"41.177.132.22","11491","244.3.160.239","80","15","6210","7","1367","8","4843","212.630547000","0.0580","188532.22","667930.90"
"244.3.160.239","62747","197.154.128.197","80","10","2061","6","1503","4","558","225.329036000","0.0579","207625.36","77082.47"
"244.3.160.239","62127","244.3.31.108","80","13","3751","7","1389","6","2362","114.956338000","0.0578","192199.26","326835.60"
"151.77.205.22","50047","41.177.98.176","80","12","7427","6","1565","6","5862","224.880469000","0.0578","216560.29","811167.04"
"244.3.160.239","62404","41.177.254.197","80","13","4968","7","1308","6","3660","161.677649000","0.0577","181254.44","507179.85"
"41.177.192.117","3516","244.3.160.239","80","12","2714","6","1173","6","1541","161.897558000","0.0576","162978.92","214109.56"
"244.3.155.77","11464","244.3.160.239","80","11","2021","6","1432","5","589","58.919290000","0.0575","199189.75","81929.30"
"244.3.181.123","5860","244.3.160.239","80","13","3225","6","1129","7","2096","115.553863000","0.0574","157478.12","292359.73"
"244.3.155.77","13963","244.3.160.239","80","11","2027","6","1424","5","603","58.918966000","0.0573","198747.36","84160.58"
"244.3.41.252","50060","41.177.3.203","5666","15","3706","9","1904","6","1802","180.379882000","0.0573","266042.55","251790.27"
"244.3.155.77","6981","244.3.160.239","80","11","2015","6","1425","5","590","45.922532000","0.0572","199133.59","82448.30"
"41.177.24.154","43422","244.3.31.46","25","51","25713","31","24229","20","1484","219.747021000","0.0572","3388908.32","207566.96"
"244.3.155.77","11818","244.3.160.239","80","13","2917","7","1409","6","1508","59.708013000","0.0570","197664.22","211552.63"
"244.3.160.239","62405","41.177.254.197","80","15","6051","8","1372","7","4679","161.678498000","0.0569","192950.69","658029.36"
"244.3.253.224","8137","244.3.160.239","80","10","1808","5","1387","5","421","222.478050000","0.0568","195451.90","59326.06"
"244.3.155.77","11766","244.3.160.239","80","11","2012","6","1422","5","590","59.294303000","0.0567","200804.91","83315.68"
"244.3.160.239","61620","244.3.31.75","80","11","2453","6","882","5","1571","56.728043000","0.0566","124726.01","222159.37"
"145.67.149.81","49521","41.177.98.176","80","13","3851","7","1320","6","2531","180.783185000","0.0565","187041.69","358638.28"
"244.3.84.23","3246","244.3.210.197","80","21","15898","10","1509","11","14389","9.447044000","0.0565","213845.39","2039112.87"
"90.218.193.20","12893","244.3.160.239","80","10","2624","5","1468","5","1156","103.319598000","0.0563","208737.69","164373.82"
"244.3.155.77","10598","244.3.160.239","80","11","2031","6","1442","5","589","45.610719000","0.0562","205424.08","83907.62"
"151.77.205.22","50046","41.177.98.176","80","20","14350","9","1775","11","12575","224.880350000","0.0561","253141.99","1793386.22"
"244.3.155.77","8720","244.3.160.239","80","11","2022","6","1419","5","603","58.918533000","0.0558","203320.62","86400.52"
"41.177.192.117","11633","244.3.160.239","80","21","10576","9","1320","12","9256","161.920059000","0.0557","189733.55","1330434.63"
"244.3.160.239","62134","244.3.31.108","80","17","8909","8","1450","9","7459","115.081205000","0.0556","208498.09","1072542.96"
"244.3.155.77","8748","244.3.160.239","80","11","2031","6","1442","5","589","45.610273000","0.0556","207519.34","84763.45"
"244.3.155.77","11869","244.3.160.239","80","11","2016","6","1426","5","590","45.805682000","0.0556","205238.92","84916.52"
"244.3.155.77","12838","244.3.160.239","80","11","2037","6","1434","5","603","45.611042000","0.0556","206494.35","86831.31"
"244.3.155.77","12413","244.3.160.239","80","11","2005","6","1415","5","590","59.232598000","0.0554","204251.02","85164.74"
"244.3.155.77","15312","244.3.160.239","80","11","2016","6","1426","5","590","46.164940000","0.0554","205842.55","85166.27"
"244.3.155.77","10003","244.3.160.239","80","11","2014","6","1424","5","590","45.922844000","0.0553","206137.81","85408.22"
"151.77.185.176","6156","244.3.160.239","80","37","26164","12","1756","25","24408","39.376752000","0.0553","254248.64","3533998.15"
"244.3.155.77","9032","244.3.160.239","80","11","2004","6","1414","5","590","59.231825000","0.0552","204860.73","85479.37"
"244.3.155.77","10597","244.3.160.239","80","11","2015","6","1425","5","590","46.165397000","0.0552","206555.42","85521.19"
"244.3.160.239","62502","244.3.31.75","80","14","5868","7","1337","7","4531","186.495532000","0.0552","193877.00","657035.65"
"244.3.155.77","15158","244.3.160.239","80","11","2009","6","1419","5","590","59.232201000","0.0551","205846.09","85587.87"
"244.3.155.77","8568","244.3.160.239","80","11","2010","6","1420","5","590","59.206680000","0.0551","206230.48","85687.31"
"244.3.155.77","9035","244.3.160.239","80","11","2019","6","1429","5","590","46.091186000","0.0550","207763.88","85780.75"
"244.3.160.239","61853","244.3.31.75","80","14","5837","7","1306","7","4531","87.255270000","0.0549","190202.25","659882.40"
"244.3.155.77","3544","244.3.160.239","80","11","2026","6","1436","5","590","45.805831000","0.0548","209570.02","86104.68"
"244.3.155.77","5728","244.3.160.239","80","11","2017","6","1427","5","590","45.806631000","0.0546","208931.19","86383.60"
"244.3.160.239","62098","244.3.31.75","80","14","5908","7","1377","7","4531","112.554919000","0.0545","202250.90","665503.88"
"244.3.160.239","62149","244.3.31.108","80","13","3198","7","1094","6","2104","115.556669000","0.0543","161267.74","310152.94"
"244.3.155.77","5377","244.3.160.239","80","11","2020","6","1430","5","590","45.922072000","0.0542","211190.90","87134.71"
"244.3.155.77","4549","244.3.160.239","80","11","2022","6","1432","5","590","46.236073000","0.0541","211619.10","87189.43"
"244.3.160.239","62409","41.177.254.197","80","10","2670","6","1239","4","1431","161.900771000","0.0541","183311.14","211717.71"
"244.3.155.77","16025","244.3.160.239","80","11","2020","6","1430","5","590","59.141439000","0.0540","211722.47","87354.02"
"145.67.149.81","49509","41.177.98.176","80","12","2394","7","1314","5","1080","180.601067000","0.0540","194713.54","160038.53"
"244.3.155.77","3617","244.3.160.239","80","11","2006","6","1416","5","590","59.141806000","0.0539","209987.77","87494.90"
"244.3.155.77","14504","244.3.160.239","80","11","2035","6","1432","5","603","45.664550000","0.0536","213599.84","89944.62"
"145.67.149.81","49506","41.177.98.176","80","12","2803","7","1324","5","1479","180.597076000","0.0536","197652.50","220791.58"
"244.3.155.77","3543","244.3.160.239","80","11","2016","6","1426","5","590","59.141099000","0.0536","212923.21","88095.86"
"244.3.155.77","10568","244.3.160.239","80","11","2019","6","1429","5","590","45.921814000","0.0536","213474.75","88138.63"
"203.210.244.128","64394","244.3.210.197","80","7","3910","4","810","3","3100","135.054215000","0.0535","121012.92","463135.88"
"244.3.155.77","11286","244.3.160.239","80","11","2021","6","1431","5","590","45.982825000","0.0535","213809.46","88153.45"
"253.37.253.167","47385","253.160.239.39","1521","2","132","1","64","1","68","16.711848000","0.0535","N/A","N/A"
"244.3.155.77","14971","244.3.160.239","80","11","2030","6","1440","5","590","45.805145000","0.0535","215254.68","88194.63"
"244.3.155.77","3249","244.3.160.239","80","11","2016","6","1426","5","590","59.534438000","0.0535","213333.33","88265.54"
"244.3.155.77","10673","244.3.160.239","80","11","2035","6","1432","5","603","45.681692000","0.0534","214455.53","90304.95"
"244.3.155.77","4152","244.3.160.239","80","11","2032","6","1429","5","603","45.609761000","0.0533","214379.48","90462.44"
"244.3.155.77","3753","244.3.160.239","80","11","2010","6","1420","5","590","59.534225000","0.0533","213073.24","88530.43"
"244.3.155.77","3654","244.3.160.239","80","11","2022","6","1432","5","590","46.238241000","0.0532","215196.77","88663.47"
"244.3.155.77","12357","244.3.160.239","80","11","2019","6","1429","5","590","46.092388000","0.0532","214790.32","88681.80"
"244.3.155.77","13122","244.3.160.239","80","11","2024","6","1434","5","590","45.982149000","0.0531","215996.38","88868.81"
"244.3.155.77","13188","244.3.160.239","80","11","2027","6","1437","5","590","46.034768000","0.0531","216525.72","88900.61"
"244.3.155.77","10560","244.3.160.239","80","11","2028","6","1425","5","603","58.975815000","0.0531","214758.02","90876.55"
"244.3.155.77","12854","244.3.160.239","80","11","2020","6","1430","5","590","46.038290000","0.0530","215690.34","88991.12"
"244.3.155.77","7361","244.3.160.239","80","11","2006","6","1416","5","590","59.265095000","0.0529","213961.92","89150.80"
"244.3.155.77","15606","244.3.160.239","80","11","2021","6","1432","5","589","58.918097000","0.0528","216887.54","89208.63"
"244.3.155.77","13323","244.3.160.239","80","11","2026","6","1436","5","590","46.042042000","0.0528","217691.20","89441.37"
"244.3.155.77","6937","244.3.160.239","80","11","2007","6","1417","5","590","59.140608000","0.0528","214823.10","89446.46"
"244.3.155.77","13100","244.3.160.239","80","11","2025","6","1422","5","603","58.973632000","0.0527","215683.30","91460.64"
"244.3.155.77","13615","244.3.160.239","80","11","2013","6","1423","5","590","60.092233000","0.0526","216392.94","89720.19"
"244.3.155.77","3949","244.3.160.239","80","11","2035","6","1432","5","603","45.681366000","0.0526","217869.23","91742.42"
"244.3.155.77","6255","244.3.160.239","80","11","2020","6","1430","5","590","46.278083000","0.0526","217585.64","89773.09"
"244.3.155.77","2178","244.3.160.239","80","11","2022","6","1432","5","590","45.988025000","0.0526","217894.10","89774.80"
"244.3.155.77","8069","244.3.160.239","80","11","2011","6","1421","5","590","59.289117000","0.0526","216253.23","89788.46"
"244.3.155.77","12837","244.3.160.239","80","11","2026","6","1436","5","590","46.040462000","0.0526","218540.15","89790.17"
"244.3.155.77","5804","244.3.160.239","80","11","2009","6","1419","5","590","59.591772000","0.0526","215989.95","89805.55"
"244.3.155.77","10858","244.3.160.239","80","11","2009","6","1418","5","591","59.605565000","0.0525","215903.47","89985.15"
"41.177.192.117","4208","244.3.160.239","80","15","5369","7","1238","8","4131","164.393875000","0.0525","188586.55","629281.95"
"244.3.160.239","61448","244.3.31.75","80","11","2512","6","1301","5","1211","31.434189000","0.0525","198206.09","184494.68"
"244.3.155.77","2359","244.3.160.239","80","11","2016","6","1426","5","590","59.551273000","0.0525","217282.82","89899.62"
"244.3.155.77","2183","244.3.160.239","80","11","2009","6","1419","5","590","59.551767000","0.0525","216228.57","89904.76"
"244.3.155.77","2387","244.3.160.239","80","11","2022","6","1419","5","603","59.059192000","0.0525","216261.53","91899.72"
"244.3.155.77","13414","244.3.160.239","80","11","2009","6","1419","5","590","59.592225000","0.0525","216376.94","89966.45"
"244.3.160.239","62505","244.3.31.75","80","13","4275","7","1367","6","2908","187.539907000","0.0524","208547.07","443639.28"
"244.3.155.77","6288","244.3.160.239","80","11","2031","6","1428","5","603","45.720647000","0.0524","217857.28","91994.36"
"244.3.155.77","4369","244.3.160.239","80","11","2020","6","1430","5","590","46.264963000","0.0524","218308.11","90071.18"
"244.3.155.77","14585","244.3.160.239","80","11","2023","6","1433","5","590","46.222993000","0.0524","218908.13","90129.66"
"244.3.155.77","12168","244.3.160.239","80","11","2017","6","1427","5","590","46.156347000","0.0524","217999.89","90133.10"
"244.3.155.77","7614","244.3.160.239","80","11","2022","6","1432","5","590","46.182201000","0.0523","218993.73","90227.86"
"244.3.155.77","14570","244.3.160.239","80","11","2017","6","1427","5","590","59.348748000","0.0522","218500.58","90340.12"
"244.3.155.77","14621","244.3.160.239","80","11","2023","6","1433","5","590","46.211048000","0.0522","219760.00","90480.39"
"145.67.223.161","3209","244.3.160.239","80","11","2796","6","1598","5","1198","77.100559000","0.0521","245139.02","183777.56"
"244.3.155.77","3593","244.3.160.239","80","11","2038","6","1435","5","603","45.672564000","0.0521","220159.56","92513.04"
"244.3.155.77","10639","244.3.160.239","80","11","2021","6","1418","5","603","59.028757000","0.0521","217726.77","92587.62"
"244.3.155.77","3552","244.3.160.239","80","11","2019","6","1429","5","590","46.096677000","0.0521","219500.02","90626.32"
"244.3.155.77","13847","244.3.160.239","80","11","2022","6","1432","5","590","46.293093000","0.0521","220019.97","90650.69"
"244.3.155.77","2676","244.3.160.239","80","11","2016","6","1426","5","590","45.978945000","0.0520","219266.55","90720.38"
"244.3.155.77","14859","244.3.160.239","80","11","2025","6","1422","5","603","58.977602000","0.0520","218731.37","92753.18"
"244.3.155.77","11889","244.3.160.239","80","11","2025","6","1422","5","603","58.989801000","0.0520","218836.57","92797.78"
"244.3.155.77","13429","244.3.160.239","80","11","2032","6","1429","5","603","45.727153000","0.0520","219947.67","92812.07"
"244.3.155.77","11196","244.3.160.239","80","11","2012","6","1422","5","590","60.078963000","0.0519","219254.12","90970.42"
"41.177.199.139","15295","244.3.160.239","80","12","2201","6","1228","6","973","58.192868000","0.0518","189546.39","150186.19"
"244.3.155.77","3099","244.3.160.239","80","11","2014","6","1424","5","590","59.293840000","0.0518","219922.78","91119.69"
"41.177.192.117","11172","244.3.160.239","80","12","1741","6","1127","6","614","164.395049000","0.0513","175620.40","95679.61"
"145.67.149.81","49511","41.177.98.176","80","12","2501","7","1308","5","1193","180.687195000","0.0511","204642.79","186650.50"
"41.177.3.224","52712","41.177.230.150","515","144","120981","91","117589","53","3392","64.031447000","0.0511","18409597.06","531047.57"
"244.3.160.239","62005","244.3.31.75","80","16","6833","8","1315","8","5518","105.604248000","0.0507","207315.15","869935.36"
"253.37.253.43","2000","253.142.160.113","515","11","1670","11","1670","0","0","125.309875000","0.0505","264554.46","N/A"
"145.95.176.246","4399","244.3.160.239","80","17","8540","7","1308","10","7232","114.417824000","0.0503","208122.84","1150721.99"
"68.33.110.176","6358","244.3.160.239","80","9","1499","4","1007","5","492","190.627519000","0.0503","160267.38","78303.43"
"41.177.199.139","7006","244.3.160.239","80","43","32132","17","1939","26","30193","58.274481000","0.0499","310718.51","4838331.03"
"244.3.160.248","49563","41.177.26.55","80","11","2350","6","1360","5","990","182.284239000","0.0496","219151.59","159529.47"
"244.3.160.239","62154","244.3.31.75","80","14","6046","7","1515","7","4531","116.615372000","0.0493","245991.48","735701.24"
"244.3.160.239","62422","41.177.254.197","80","13","5326","7","1304","6","4022","164.396827000","0.0492","211886.09","653532.11"
"244.3.160.239","61431","244.3.31.75","80","14","5829","7","1298","7","4531","29.502912000","0.0485","214248.87","747890.32"
"244.3.160.239","62423","41.177.254.197","80","10","1746","6","1243","4","503","164.398149000","0.0481","206650.04","83624.27"
"68.33.110.176","13588","244.3.160.239","80","10","1563","5","1071","5","492","10.417656000","0.0478","179130.69","82289.73"
"90.218.241.186","39693","244.3.210.197","80","15","10755","7","2394","8","8361","53.076059000","0.0477","401231.85","1401294.70"
"244.3.3.145","14583","244.3.160.239","80","13","3503","6","1015","7","2488","202.357303000","0.0477","170137.87","417047.31"
"15.205.242.71","2116","244.3.210.197","80","4","256","2","128","2","128","24.517869000","0.0473","21630.30","21630.30"
"145.67.149.81","49525","41.177.98.176","80","12","1988","7","1298","5","690","180.828304000","0.0473","219460.65","116662.44"
"244.3.160.239","62006","244.3.31.75","80","11","2912","6","1189","5","1723","105.608054000","0.0473","201299.39","291706.35"
"253.37.253.43","54735","253.160.108.253","20","9","576","9","576","0","0","101.504616000","0.0470","97988.35","N/A"
"90.218.193.20","5519","244.3.160.239","80","13","8355","5","1251","8","7104","104.940353000","0.0467","214239.84","1216594.60"
"41.177.34.163","45730","41.177.98.176","80","50","36681","21","4639","29","32042","233.086713000","0.0467","794740.56","5489346.21"
"244.3.160.239","62446","244.3.31.75","80","13","4241","7","1367","6","2874","170.392289000","0.0466","234728.48","493496.46"
"244.3.84.23","3245","244.3.210.197","80","40","30816","18","2300","22","28516","9.446784000","0.0466","395027.80","4897657.74"
"244.3.160.248","48206","41.177.26.193","80","13","3015","7","2179","6","836","103.484715000","0.0463","376908.11","144605.41"
"90.218.193.20","5240","244.3.160.239","80","10","2008","5","1223","5","785","104.585349000","0.0462","211875.79","135995.50"
"90.218.193.20","11336","244.3.160.239","80","10","1802","5","1216","5","586","104.529448000","0.0462","210713.28","101544.39"
"253.37.253.43","54760","253.160.108.253","20","3","192","3","192","0","0","121.819577000","0.0456","33684.95","N/A"
"244.3.160.239","62663","244.3.31.75","80","14","5799","7","1268","7","4531","212.635602000","0.0453","224048.06","800600.76"
"41.177.199.139","12385","244.3.160.239","80","12","2663","6","1229","6","1434","58.248991000","0.0453","217267.36","253508.05"
"41.177.83.247","7092","244.3.160.239","80","16","9114","7","1735","9","7379","55.550946000","0.0450","308143.15","1310540.80"
"244.3.160.239","61948","244.3.31.75","80","11","2589","6","1018","5","1571","101.857781000","0.0448","181595.20","280241.71"
"145.95.176.246","2287","244.3.160.239","80","17","8540","7","1308","10","7232","114.239243000","0.0442","236635.01","1308367.25"
"244.3.41.252","49332","41.177.3.203","5666","15","3706","9","1904","6","1802","128.206369000","0.0442","344669.97","326205.51"
"151.77.185.176","4768","244.3.160.239","80","12","3502","6","1356","6","2146","38.940913000","0.0441","246131.51","389526.71"
"90.218.72.197","6686","244.3.160.239","80","10","1926","5","983","5","943","3.101245000","0.0439","179256.90","171962.62"
"41.177.211.185","13324","244.3.160.239","80","12","3327","6","1406","6","1921","189.069180000","0.0435","258372.77","353011.44"
"68.157.168.38","42941","41.177.26.91","80","4","280","2","140","2","140","3.537901000","0.0434","25795.16","25795.16"
"68.157.168.139","32798","41.177.26.176","80","4","280","2","140","2","140","1.734335000","0.0430","26041.06","26041.06"
"244.3.160.239","62158","244.3.31.75","80","13","4263","7","1367","6","2896","117.598174000","0.0430","254278.27","538690.48"
"68.157.168.253","36445","41.177.26.176","80","4","280","2","140","2","140","4.202916000","0.0430","26059.84","26059.84"
"68.157.168.160","37495","41.177.26.176","80","4","280","2","140","2","140","3.157604000","0.0426","26294.78","26294.78"
"244.3.160.248","49984","41.177.26.55","80","11","1499","6","723","5","776","222.919967000","0.0425","136148.58","146129.04"
"41.177.3.224","9408","244.3.41.117","4300","11","3707","6","2335","5","1372","43.510023000","0.0422","443010.96","260304.51"
"68.33.110.176","13991","244.3.160.239","80","9","1499","4","1007","5","492","204.057476000","0.0420","191599.68","93611.76"
"244.3.160.248","49048","41.177.26.193","80","14","3723","7","2191","7","1532","153.976656000","0.0418","419209.80","293121.59"
"41.177.124.47","5497","244.3.160.239","80","78","53524","27","2932","51","50592","224.955350000","0.0418","560987.28","9679900.51"
"253.37.253.43","54742","253.160.108.253","20","8","512","8","512","0","0","116.421299000","0.0417","98253.69","N/A"
"68.33.110.176","10124","244.3.160.239","80","10","2161","5","1159","5","1002","121.549997000","0.0416","222809.63","192627.48"
"244.3.41.252","49867","41.177.3.224","5666","15","3706","9","1904","6","1802","170.171975000","0.0412","369305.37","349521.15"
"40.193.255.164","61527","244.3.210.197","80","14","7891","7","943","7","6948","3.978747000","0.0411","183516.59","1352145.57"
"41.177.211.185","8959","244.3.160.239","80","65","43432","23","2402","42","41030","160.370162000","0.0408","471003.48","8045492.43"
"244.3.160.239","62585","244.3.31.108","80","13","3407","7","968","6","2439","202.362767000","0.0407","190214.19","479269.01"
"244.3.41.252","48757","41.177.3.203","5666","15","3706","9","1904","6","1802","92.351982000","0.0405","375866.75","355731.03"
"68.33.110.176","7189","244.3.160.239","80","9","1499","4","1007","5","492","117.291461000","0.0404","199519.53","97481.24"
"151.77.205.22","50045","41.177.98.176","80","8","3919","4","1425","4","2494","224.880183000","0.0402","283314.28","495849.69"
"244.3.41.252","48690","41.177.3.224","5666","15","3706","9","1904","6","1802","90.334223000","0.0402","378914.90","358615.89"
"215.203.31.218","49225","244.3.210.197","80","6","396","3","198","3","198","43.282960000","0.0401","39458.93","39458.93"
"68.33.110.176","12530","244.3.160.239","80","9","1499","4","1007","5","492","74.079894000","0.0400","201228.96","98316.43"
"145.67.149.81","49528","41.177.98.176","80","12","1999","7","1301","5","698","180.867539000","0.0399","260832.52","139939.35"
"68.33.110.176","3463","244.3.160.239","80","9","1499","4","1007","5","492","22.711659000","0.0398","202315.48","98847.28"
"41.177.230.224","36826","41.177.26.46","80","22","11881","10","721","12","11160","54.979571000","0.0398","144862.75","2242258.33"
"244.3.181.123","7061","244.3.160.239","80","27","15058","11","1768","16","13290","115.136493000","0.0398","355475.13","2672095.30"
"145.67.149.81","49526","41.177.98.176","80","13","3297","7","1303","6","1994","180.855293000","0.0397","262331.39","401449.57"
"244.3.160.239","61490","197.154.128.197","80","10","2331","6","1219","4","1112","39.418716000","0.0396","246542.79","224902.04"
"41.177.98.252","8026","244.3.160.239","80","6","1280","4","1146","2","134","23.554368000","0.0394","232784.89","27219.18"
"46.214.75.153","6894","244.3.210.197","80","4","256","2","128","2","128","50.922019000","0.0388","26414.90","26414.90"
"244.3.160.239","62510","244.3.31.75","80","13","3265","7","1363","6","1902","189.071883000","0.0386","282180.01","393768.44"
"244.3.160.239","62349","244.3.31.75","80","14","5969","7","1438","7","4531","158.228012000","0.0385","298650.05","941017.65"
"253.37.253.43","54738","253.160.108.253","20","7","448","7","448","0","0","115.248201000","0.0384","93238.64","N/A"
"41.177.199.139","4283","244.3.160.239","80","66","43417","24","2387","42","41030","58.074046000","0.0383","499215.73","8580989.23"
"145.95.31.210","10438","244.3.160.239","80","39","31782","14","1649","25","30133","88.719799000","0.0380","346902.28","6339118.54"
"68.33.110.176","4770","244.3.160.239","80","9","1499","4","1007","5","492","220.463507000","0.0379","212279.31","103715.42"
"244.3.160.239","62374","244.3.31.75","80","52","42494","20","2103","32","40391","160.372794000","0.0378","444844.00","8543839.24"
"253.37.253.43","2000","253.213.108.167","515","11","1670","11","1670","0","0","125.292939000","0.0375","355962.91","N/A"
"241.82.197.204","33700","244.3.210.197","80","4","280","2","140","2","140","15.249145000","0.0375","29845.18","29845.18"
"244.3.160.248","49987","41.177.26.193","80","159","151685","56","5202","103","146483","223.538251000","0.0373","1116368.90","31435806.64"
"253.37.253.43","2003","253.142.108.93","515","13","3166","13","3166","0","0","141.303648000","0.0372","681024.98","N/A"
"41.177.34.163","10380","244.3.160.239","80","10","2260","5","1413","5","847","112.089364000","0.0367","308002.51","184627.12"
"90.218.193.20","16365","244.3.160.239","80","13","8355","5","1251","8","7104","104.647304000","0.0366","273106.84","1550880.07"
"41.177.199.139","15764","244.3.160.239","80","64","41542","23","2250","41","39292","56.656307000","0.0366","492408.70","8598987.83"
"145.95.31.210","15061","244.3.160.239","80","12","2569","6","1131","6","1438","88.713200000","0.0364","248441.75","315879.07"
"244.3.160.248","47710","41.177.98.71","33456","11","761","6","391","5","370","55.497326000","0.0364","86023.87","81403.66"
"41.177.34.163","11025","244.3.160.239","80","10","2263","5","1414","5","849","112.088385000","0.0363","311582.43","187081.67"
"68.33.110.176","6662","244.3.160.239","80","10","1563","5","1071","5","492","166.247666000","0.0360","237755.64","109221.08"
"244.3.160.239","62136","244.3.31.108","80","23","14706","10","1580","13","13126","115.139698000","0.0360","351521.22","2920295.90"
"41.177.192.117","2662","244.3.160.239","80","15","5691","7","1192","8","4499","161.816666000","0.0360","265227.79","1001056.91"
"41.177.199.139","10236","244.3.160.239","80","12","1899","6","1228","6","671","58.179347000","0.0357","274881.78","150200.06"
"244.3.160.239","61637","244.3.31.75","80","52","42415","20","2024","32","40391","58.076121000","0.0357","453265.40","9045376.93"
"244.3.139.251","58737","244.3.31.244","443","24","5144","15","2223","9","2921","4.527761000","0.0356","500000.00","656995.05"
"41.177.211.185","4155","244.3.160.239","80","64","41627","23","2335","41","39292","158.676371000","0.0352","530275.07","8923155.53"
"244.3.160.239","62733","197.154.128.197","80","58","52331","22","2502","36","49829","224.960266000","0.0352","568281.19","11317699.17"
"244.3.160.248","47485","41.177.26.55","80","11","1499","6","723","5","776","40.448292000","0.0349","165673.69","177818.52"
"145.95.176.246","9121","244.3.160.239","80","10","2544","5","1394","5","1150","112.498127000","0.0344","323941.21","267239.88"
"244.3.160.248","48379","41.177.26.55","80","11","1499","6","723","5","776","113.498291000","0.0342","168885.77","181266.06"
"253.37.253.43","2000","253.213.108.31","515","13","2628","13","2628","0","0","124.348750000","0.0342","615474.69","N/A"
"90.218.72.197","10565","244.3.160.239","80","10","1828","5","966","5","862","3.161155000","0.0340","227227.29","202763.89"
"68.33.110.176","11048","244.3.160.239","80","10","1563","4","1007","6","556","120.679623000","0.0338","238195.20","131515.92"
"244.3.160.248","47303","41.177.26.193","80","13","3056","7","2220","6","836","35.110967000","0.0338","525148.59","197758.66"
"68.33.110.176","10676","244.3.160.239","80","9","1499","4","1007","5","492","173.467876000","0.0337","238901.57","116722.52"
"244.3.160.248","49290","41.177.26.55","80","11","1499","6","723","5","776","168.819363000","0.0336","172035.34","184646.50"
"68.33.110.176","9908","244.3.160.239","80","10","1563","5","1071","5","492","47.591912000","0.0335","255952.20","117580.28"
"244.3.160.239","61619","244.3.31.75","80","50","40688","19","1887","31","38801","56.659123000","0.0334","451908.40","9292261.64"
"244.3.160.248","49300","41.177.26.193","80","27","16426","12","2394","15","14032","170.021254000","0.0334","573877.09","3363677.22"
"244.3.160.248","47053","41.177.98.71","33456","11","761","6","391","5","370","3.028636000","0.0334","93779.04","88742.32"
"145.95.31.210","4182","244.3.160.239","80","12","1976","6","1130","6","846","88.717762000","0.0333","271251.54","203078.58"
"244.3.160.239","61492","197.154.128.197","80","10","1769","6","1193","4","576","39.494352000","0.0328","291002.23","140500.66"
"244.3.160.239","62353","244.3.31.75","80","50","40767","19","1966","31","38801","158.678524000","0.0328","480185.63","9476949.38"
"244.3.160.248","47759","41.177.26.55","80","11","1499","6","723","5","776","59.057442000","0.0325","177745.00","190774.71"
"244.3.160.248","49561","41.177.26.55","80","11","1637","6","1126","5","511","182.228675000","0.0323","279205.28","126708.61"
"215.203.31.218","49226","244.3.210.197","80","4","268","3","198","1","70","43.295159000","0.0323","49105.62","N/A"
"215.203.31.218","49229","244.3.210.197","80","4","268","3","198","1","70","43.295171000","0.0322","49172.69","N/A"
"215.203.31.218","49228","244.3.210.197","80","4","268","3","198","1","70","43.295167000","0.0322","49204.77","N/A"
"215.203.31.218","49227","244.3.210.197","80","4","268","3","198","1","70","43.295163000","0.0322","49212.41","N/A"
"253.37.253.43","2002","253.142.108.93","515","11","1670","11","1670","0","0","125.325724000","0.0321","415746.07","N/A"
"68.33.110.176","5450","244.3.160.239","80","9","1499","4","1007","5","492","113.689402000","0.0321","250965.73","122616.82"
"244.3.160.248","49182","41.177.26.193","80","14","3491","7","2591","7","900","162.652740000","0.0317","653117.81","226864.54"
"41.177.199.139","4999","244.3.160.239","80","58","38291","21","2180","37","36111","57.882190000","0.0317","549637.57","9104569.81"
"244.3.160.239","61484","197.154.128.197","80","18","10248","9","1379","9","8869","38.945364000","0.0310","356135.20","2290473.58"
"244.3.160.248","47916","41.177.26.193","80","14","3570","7","2670","7","900","72.594873000","0.0305","699204.56","235686.93"
"244.3.160.248","49036","41.177.26.55","80","11","1499","6","723","5","776","151.191540000","0.0304","190300.72","204250.84"
"244.3.160.239","61616","41.177.230.67","80","19","9235","9","1753","10","7482","55.555069000","0.0304","461741.08","1970762.54"
"68.33.110.176","16225","244.3.160.239","80","9","1499","4","1007","5","492","200.641470000","0.0303","265454.07","129695.53"
"48.90.252.46","22254","244.3.210.197","20480","2","196","2","196","0","0","162.716462000","0.0303","51831.28","N/A"
"68.33.110.176","15051","244.3.160.239","80","9","1499","4","1007","5","492","28.773499000","0.0302","266393.31","130154.43"
"244.3.139.251","58742","244.3.31.244","443","22","4430","14","1809","8","2621","4.635943000","0.0302","479252.91","694373.61"
"68.33.110.176","11088","244.3.160.239","80","10","1563","5","1071","5","492","129.273484000","0.0302","283953.07","130443.43"
"244.3.160.248","47943","41.177.26.55","80","11","1499","6","723","5","776","77.362177000","0.0302","191815.35","205876.50"
"68.33.110.176","15344","244.3.160.239","80","9","1499","4","1007","5","492","110.083448000","0.0300","268274.00","131073.30"
"244.3.160.248","49761","41.177.26.55","80","11","1499","6","723","5","776","204.832376000","0.0299","193613.18","207806.12"
"244.3.181.123","15951","244.3.160.239","80","10","1810","5","1393","5","417","133.768596000","0.0298","373633.74","111848.72"
"68.33.110.176","5036","244.3.160.239","80","9","1499","4","1007","5","492","211.782094000","0.0296","272567.33","133170.93"
"244.3.160.239","61770","197.154.128.197","80","12","3245","7","1194","5","2051","74.396937000","0.0295","323478.61","555657.15"
"244.3.160.248","49585","41.177.26.55","80","11","1499","6","723","5","776","187.232404000","0.0295","196220.78","210604.88"
"68.33.110.176","3798","244.3.160.239","80","9","1499","4","1007","5","492","102.442298000","0.0293","274695.67","134210.80"
"244.3.31.108","6599","244.3.160.239","80","17","5562","8","743","9","4819","117.792844000","0.0292","203561.64","1320273.97"
"253.37.253.43","2000","253.142.108.93","515","11","1241","11","1241","0","0","90.777760000","0.0292","340536.46","N/A"
"253.37.253.43","54739","253.160.108.253","20","4","256","4","256","0","0","115.521112000","0.0291","70353.83","N/A"
"68.33.110.176","14454","244.3.160.239","80","9","1499","4","1007","5","492","215.263430000","0.0291","276762.40","135220.56"
"244.3.181.123","3652","244.3.160.239","80","13","4561","6","1387","7","3174","114.954090000","0.0291","381896.40","873928.76"
"244.3.181.123","10653","244.3.160.239","80","58","38457","21","2346","37","36111","115.324794000","0.0290","646303.25","9948276.46"
"244.3.31.108","8369","244.3.160.239","80","17","5562","8","743","9","4819","46.613281000","0.0290","204711.39","1327731.09"
"90.218.241.186","39689","244.3.210.197","80","8","3275","5","1003","3","2272","53.042032000","0.0289","277762.39","629188.59"
"244.3.31.108","8748","244.3.160.239","80","17","5562","8","743","9","4819","85.236791000","0.0289","205959.81","1335828.14"
"244.3.31.108","10580","244.3.160.239","80","17","5562","8","743","9","4819","98.342149000","0.0288","206238.51","1337635.75"
"253.37.253.43","54728","253.160.108.253","20","3","192","3","192","0","0","87.303578000","0.0288","53331.48","N/A"
"253.37.253.43","2001","253.142.108.93","515","11","1264","11","1264","0","0","90.785626000","0.0288","351574.99","N/A"
"244.3.31.108","6619","244.3.160.239","80","17","5562","8","743","9","4819","187.777439000","0.0286","208101.39","1349718.17"
"244.3.31.108","5191","244.3.160.239","80","17","5562","8","743","9","4819","170.890360000","0.0285","208759.18","1353984.48"
"244.3.31.108","5795","244.3.160.239","80","17","5562","8","743","9","4819","43.665950000","0.0284","209096.99","1356175.47"
"41.177.199.139","2803","244.3.160.239","80","12","2279","6","1237","6","1042","58.217342000","0.0284","348193.24","293304.25"
"215.203.31.218","49230","244.3.210.197","80","4","268","3","198","1","70","43.298980000","0.0284","55743.24","N/A"
"215.203.31.218","49231","244.3.210.197","80","4","268","3","198","1","70","43.298984000","0.0284","55743.24","N/A"
"68.33.110.176","14578","244.3.160.239","80","10","2037","5","1091","5","946","164.185578000","0.0284","307172.52","266347.58"
"41.177.199.139","15488","244.3.160.239","80","12","2644","6","1221","6","1423","58.146954000","0.0284","343980.00","400887.42"
"244.3.160.239","61622","244.3.31.75","443","20","5883","11","1957","9","3926","57.365855000","0.0283","552395.74","1108178.67"
"68.33.110.176","6307","244.3.160.239","80","9","1499","4","1007","5","492","38.983551000","0.0282","285198.43","139342.23"
"68.33.110.176","10909","244.3.160.239","80","9","1499","4","1007","5","492","18.765432000","0.0282","286049.07","139757.84"
"68.33.110.176","3584","244.3.160.239","80","10","1563","5","1071","5","492","33.865691000","0.0281","304640.00","139946.67"
"41.177.34.163","6266","244.3.160.239","80","10","2263","5","1414","5","849","66.461846000","0.0281","402892.05","241906.19"
"90.55.40.204","2147","244.3.160.239","80","10","2044","5","1141","5","903","131.265441000","0.0280","325418.89","257540.11"
"90.55.40.204","4419","244.3.160.239","80","10","1982","5","962","5","1020","131.361498000","0.0280","275053.61","291636.88"
"68.33.110.176","8538","244.3.160.239","80","9","1499","4","1007","5","492","44.143486000","0.0279","288311.50","140863.22"
"244.3.160.248","48231","41.177.26.193","80","160","151749","56","5202","104","146547","106.883418000","0.0278","1499081.45","42231043.55"
"41.177.199.139","4133","244.3.160.239","80","10","2168","5","1019","5","1149","95.918792000","0.0277","294434.21","331996.97"
"41.177.211.185","14959","244.3.160.239","80","58","38370","21","2259","37","36111","160.223830000","0.0276","655138.66","10472648.18"
"41.177.199.139","11504","244.3.160.239","80","10","2168","5","1019","5","1149","97.048647000","0.0275","296350.15","334157.34"
"244.3.160.239","61494","197.154.128.197","80","13","4998","7","1247","6","3751","39.500368000","0.0273","364819.89","1097385.26"
"145.95.176.246","12852","244.3.160.239","80","10","2553","5","1397","5","1156","113.612361000","0.0273","408868.08","338333.21"
"41.177.124.47","14257","244.3.160.239","80","42","26402","15","2164","27","24238","225.787609000","0.0271","637713.19","7142741.37"
"244.3.160.239","62406","41.177.254.197","80","13","5698","7","1308","6","4390","161.819566000","0.0269","389546.57","1307423.13"
"244.3.160.248","49136","41.177.26.193","80","19","7946","9","2324","10","5622","159.766132000","0.0268","694353.15","1679713.18"
"244.3.77.193","1447","244.3.41.84","23","2","128","2","128","0","0","227.141562000","0.0268","38257.49","N/A"
"41.177.180.176","4684","244.3.41.152","443","12","1728","12","1728","0","0","214.693784000","0.0264","522745.32","N/A"
"41.177.199.139","3322","244.3.160.239","80","12","2953","6","1238","6","1715","58.240618000","0.0263","376248.91","521217.19"
"253.37.253.251","2864","253.160.108.127","80","11","3345","6","1227","5","2118","137.398846000","0.0263","373885.88","645387.37"
"41.177.211.185","14041","244.3.160.239","80","15","4962","7","1310","8","3652","197.247922000","0.0262","400305.58","1115966.39"
"41.177.180.176","4678","244.3.41.152","443","11","1968","11","1968","0","0","62.582955000","0.0262","601696.86","N/A"
"253.37.253.121","2848","253.160.108.127","80","9","3211","5","1157","4","2054","75.670149000","0.0261","354215.30","628831.66"
"244.3.34.248","61110","244.3.31.124","443","23","3944","14","1653","9","2291","170.389605000","0.0261","506608.44","702141.52"
"68.33.110.176","7408","244.3.160.239","80","9","1499","4","1007","5","492","1.697794000","0.0260","310048.88","151483.66"
"68.33.110.176","12218","244.3.160.239","80","10","1563","5","1071","5","492","207.935557000","0.0259","330313.43","151740.62"
"41.177.199.139","6309","244.3.160.239","80","31","18320","12","1605","19","16715","57.690046000","0.0259","495906.07","5164529.58"
"244.3.160.239","62246","244.3.31.108","80","11","1759","6","1333","5","426","133.771956000","0.0259","412310.55","131766.16"
"244.3.160.248","49738","41.177.26.193","80","160","151779","56","5232","104","146547","200.881614000","0.0258","1620817.84","45398698.88"
"244.3.160.248","49430","41.177.26.55","80","11","2348","6","1358","5","990","176.041581000","0.0257","421935.68","307596.71"
"244.3.160.248","48233","41.177.26.193","80","16","3836","8","2127","8","1709","106.900078000","0.0257","663340.09","532979.88"
"253.37.253.43","2000","253.205.160.160","515","11","1647","11","1647","0","0","125.333979000","0.0255","517172.35","N/A"
"244.3.160.248","47892","41.177.98.71","33456","11","776","6","391","5","385","70.577697000","0.0255","122825.62","120940.83"
"41.177.199.139","12088","244.3.160.239","80","10","1925","5","1174","5","751","58.077569000","0.0254","369385.67","236293.56"
"244.3.160.248","49747","41.177.26.193","80","46","36294","18","2799","28","33495","201.317076000","0.0254","882408.58","10559583.86"
"253.37.253.43","54763","253.160.108.253","20","3","192","3","192","0","0","122.722686000","0.0253","60644.35","N/A"
"244.3.160.248","47902","41.177.26.193","80","159","151685","56","5202","103","146483","71.846518000","0.0253","1648027.88","46406779.66"
"244.3.160.248","47186","41.177.26.55","80","11","1499","6","723","5","776","21.425225000","0.0251","230273.11","247153.44"
"41.177.199.139","12263","244.3.160.239","80","16","6808","7","1300","9","5508","58.239204000","0.0250","415186.23","1759112.14"
"244.3.181.123","9340","244.3.160.239","80","12","2810","6","1387","6","1423","115.427324000","0.0250","443769.00","455287.15"
"244.3.160.248","47048","41.177.26.55","80","11","1499","6","723","5","776","2.043200000","0.0248","233536.56","250656.11"
"244.3.181.123","15585","244.3.160.239","80","12","2481","6","1456","6","1025","115.424619000","0.0248","470322.22","331099.09"
"244.3.160.248","49121","41.177.98.71","33456","11","762","6","391","5","371","157.839185000","0.0247","126455.37","119987.06"
"244.3.160.248","48783","41.177.26.55","80","11","1499","6","723","5","776","131.274888000","0.0245","235687.22","252964.43"
"41.177.224.111","3604","244.3.41.84","23","4","2084","2","148","2","1936","0.126530000","0.0243","48802.61","638390.83"
"244.3.181.123","4956","244.3.160.239","80","12","2445","6","1403","6","1042","115.475346000","0.0240","467549.78","347246.52"
"244.3.3.145","3368","244.3.160.239","80","41","23744","16","1664","25","22080","202.429674000","0.0240","554805.37","7361840.46"
"244.3.160.248","48221","41.177.98.71","33456","11","766","6","391","5","375","105.179632000","0.0239","130687.28","125339.46"
"244.3.160.239","61213","117.246.95.43","80","3","192","2","128","1","64","0.064582000","0.0237","43152.13","N/A"
"68.33.110.176","12222","244.3.160.239","80","9","1499","4","1007","5","492","124.517795000","0.0237","340490.28","166356.72"
"244.3.3.145","10875","244.3.160.239","80","43","25766","17","1725","26","24041","202.352382000","0.0235","586012.14","8167140.86"
"244.3.160.239","61489","197.154.128.197","80","33","25498","14","1702","19","23796","39.380208000","0.0234","581880.34","8135384.62"
"244.3.160.239","61214","117.246.95.43","80","3","192","2","128","1","64","0.064945000","0.0234","43779.39","N/A"
"244.3.160.239","61215","117.246.95.43","80","3","192","2","128","1","64","0.065329000","0.0233","43865.66","N/A"
"244.3.160.239","61216","117.246.95.43","80","3","192","2","128","1","64","0.065698000","0.0233","44041.12","N/A"
"244.3.181.123","14523","244.3.160.239","80","10","1800","5","1383","5","417","133.565508000","0.0230","480959.83","145018.26"
"253.37.253.43","54743","253.160.108.253","20","3","192","3","192","0","0","116.723252000","0.0227","67641.36","N/A"
"244.3.139.251","58792","244.3.31.244","443","24","4678","15","2041","9","2637","25.385473000","0.0226","723374.09","934609.25"
"244.3.160.248","48614","41.177.26.55","80","11","2713","6","1733","5","980","124.558621000","0.0224","617605.13","349251.60"
"244.3.160.239","62752","197.154.128.197","80","33","25786","14","1990","19","23796","225.791183000","0.0222","717375.63","8578226.39"
"145.95.176.246","3662","244.3.160.239","80","10","1775","5","1215","5","560","114.418304000","0.0221","440736.37","203137.75"
"244.3.160.248","47907","41.177.26.193","80","46","36264","18","2769","28","33495","72.245981000","0.0220","1009202.73","12207744.87"
"41.177.211.185","4397","244.3.160.239","80","17","8596","6","1310","11","7286","160.880162000","0.0219","478888.69","2663498.45"
"41.177.199.139","9074","244.3.160.239","80","13","4395","6","1221","7","3174","57.690329000","0.0218","448855.80","1166804.52"
"244.3.181.123","15747","244.3.160.239","80","31","18486","12","1771","19","16715","114.954681000","0.0217","651522.12","6149176.86"
"41.177.98.220","7010","244.3.79.121","1156","4","1916","2","1720","2","196","3.640634000","0.0217","633955.31","72241.42"
"244.3.160.248","47908","41.177.26.193","80","55","44191","21","2960","34","41231","72.248450000","0.0214","1106076.88","15406978.37"
"253.37.253.121","2854","253.160.108.83","80","14","6788","8","2858","6","3930","135.539565000","0.0213","1071616.05","1473565.80"
"244.3.160.239","61648","244.3.31.75","80","16","6775","8","1257","8","5518","58.243420000","0.0213","472223.53","2072974.88"
"244.3.160.248","49748","41.177.26.193","80","55","44221","21","2990","34","41231","201.322511000","0.0213","1123426.64","15491640.05"
"253.37.253.251","2871","253.160.108.83","80","14","6788","8","2857","6","3931","210.173237000","0.0212","1079896.05","1485849.28"
"41.177.98.43","38639","41.177.26.155","8010","14","4372","8","2806","6","1566","231.721209000","0.0211","1063785.42","593687.80"
"253.37.253.31","3967","253.160.108.83","80","14","6799","8","2867","6","3932","38.960084000","0.0208","1101738.88","1511000.10"
"253.37.253.43","54746","253.160.108.253","20","3","192","3","192","0","0","117.628717000","0.0208","73945.70","N/A"
"145.95.176.246","11758","244.3.160.239","80","10","1762","5","1202","5","560","114.596325000","0.0206","466637.55","217401.85"
"253.37.253.43","54748","253.160.108.253","20","3","192","3","192","0","0","118.221817000","0.0206","74621.06","N/A"
"244.3.160.248","49308","41.177.26.193","80","55","44191","21","2960","34","41231","170.440021000","0.0205","1153040.85","16061157.91"
"244.3.181.123","13773","244.3.160.239","80","12","2835","6","1450","6","1385","115.422752000","0.0204","567987.07","542525.58"
"41.177.34.163","10489","244.3.160.239","80","10","2254","5","1411","5","843","113.516682000","0.0203","557211.97","332905.52"
"244.3.160.248","50024","41.177.26.193","80","19","6365","9","2210","10","4155","233.600754000","0.0202","873863.19","1642941.87"
"244.3.139.251","58741","244.3.31.244","443","24","5264","15","2263","9","3001","4.614699000","0.0201","898684.54","1191759.74"
"41.177.180.176","4679","244.3.41.152","443","12","1728","12","1728","0","0","94.442205000","0.0201","688754.92","N/A"
"244.3.160.239","61649","244.3.31.75","80","11","2854","6","1131","5","1723","58.245204000","0.0200","451880.34","688408.33"
"244.3.160.248","49185","41.177.26.193","80","14","2972","7","2106","7","866","162.710619000","0.0195","862937.92","354845.32"
"151.77.108.208","14185","244.3.160.239","80","11","2785","6","1587","5","1198","187.599242000","0.0194","653658.03","493435.62"
"41.177.199.139","11641","244.3.160.239","80","12","2070","6","1228","6","842","58.276950000","0.0194","506339.55","347180.70"
"244.3.160.239","62408","41.177.254.197","80","12","3821","7","1301","5","2520","161.827142000","0.0193","538159.26","1042399.17"
"41.177.199.139","15082","244.3.160.239","80","50","39782","20","2132","30","37650","58.237315000","0.0193","882633.00","15586835.02"
"244.3.160.239","62236","244.3.31.108","80","11","1749","6","1323","5","426","133.568726000","0.0193","548450.62","176598.61"
"41.177.132.22","11880","244.3.160.239","80","10","2444","5","1298","5","1146","212.611091000","0.0191","544634.43","480855.97"
"253.37.253.43","54745","253.160.108.253","20","3","192","3","192","0","0","117.309081000","0.0190","80829.34","N/A"
"244.3.181.123","9905","244.3.160.239","80","36","21306","14","1902","22","19404","115.383322000","0.0190","800926.41","8170965.36"
"41.177.199.139","10496","244.3.160.239","80","18","8603","8","1381","10","7222","64.968944000","0.0190","582915.63","3048382.84"
"41.177.124.47","2308","244.3.160.239","80","15","7039","7","1653","8","5386","224.957660000","0.0189","699904.73","2280512.33"
"41.177.199.139","6260","244.3.160.239","80","10","2789","5","1465","5","1324","69.087533000","0.0189","621651.73","561820.40"
"41.177.199.139","3619","244.3.160.239","80","10","2789","5","1465","5","1324","64.589678000","0.0188","623105.96","563134.67"
"244.3.160.248","49307","41.177.26.193","80","47","36328","18","2769","29","33559","170.420198000","0.0188","1177984.58","14276628.56"
"253.37.253.251","2848","253.160.108.127","80","5","458","2","128","3","330","130.374726000","0.0188","54558.05","140657.47"
"253.37.253.43","54749","253.160.108.253","20","3","192","3","192","0","0","118.568626000","0.0184","83351.42","N/A"
"244.3.3.145","3673","244.3.160.239","80","13","4024","6","1011","7","3013","202.352377000","0.0184","439589.11","1310071.20"
"41.177.132.22","7270","244.3.160.239","80","10","2453","5","1301","5","1152","213.359702000","0.0183","567348.05","502371.22"
"244.3.90.209","2229","41.177.98.197","1521","7","466","4","267","3","199","13.632866000","0.0183","116964.19","87175.56"
"253.37.253.43","54741","253.160.108.253","20","3","192","3","192","0","0","116.127358000","0.0182","84511.69","N/A"
"253.37.253.251","2869","253.160.108.83","80","16","8745","9","2824","7","5921","191.982815000","0.0179","1264737.17","2651738.23"
"41.177.84.66","60015","244.3.31.168","443","19","8332","10","1928","9","6404","194.048695000","0.0177","869790.79","2889076.86"
"244.3.139.251","58807","244.3.31.244","443","24","4921","15","2354","9","2567","25.609224000","0.0176","1072865.04","1169942.46"
"244.3.139.251","58830","244.3.31.244","443","24","4913","15","2346","9","2567","66.043126000","0.0175","1071232.88","1172146.12"
"41.177.132.22","11399","244.3.160.239","80","10","1664","5","1108","5","556","213.757772000","0.0175","506716.97","254273.14"
"253.37.253.31","3965","253.160.108.83","80","16","8737","9","2825","7","5912","15.863706000","0.0174","1301618.38","2723953.23"
"41.177.132.22","2561","244.3.160.239","80","10","5708","4","1244","6","4464","213.732546000","0.0173","574927.79","2063084.92"
"41.177.142.84","50994","244.3.41.84","23","4","289","2","143","2","146","153.471672000","0.0172","66639.48","68037.51"
"253.37.253.121","2853","253.160.108.83","80","16","8737","9","2825","7","5912","128.350022000","0.0172","1316555.98","2755213.79"
"41.177.132.22","5085","244.3.160.239","80","10","1662","5","1106","5","556","213.637559000","0.0172","515647.77","259222.57"
"244.3.139.251","58761","244.3.31.244","443","24","4922","15","2355","9","2567","4.927364000","0.0171","1101303.56","1200444.26"
"253.37.253.43","54744","253.160.108.253","20","3","192","3","192","0","0","117.020587000","0.0171","90029.89","N/A"
"253.37.253.43","54729","253.160.108.253","20","3","192","3","192","0","0","87.597446000","0.0171","90051.01","N/A"
"145.95.31.210","3658","244.3.160.239","80","10","2525","5","1369","5","1156","88.197566000","0.0170","643970.13","543776.09"
"41.177.199.139","11281","244.3.160.239","80","10","2789","5","1465","5","1324","57.449086000","0.0170","690549.14","624086.73"
"244.3.213.210","10146","244.3.160.239","80","10","2795","5","1649","5","1146","26.549139000","0.0170","777509.28","540343.02"
"41.177.132.22","4657","244.3.160.239","80","10","5708","4","1244","6","4464","213.659492000","0.0170","586930.88","2106157.11"
"244.3.213.210","3995","244.3.160.239","80","10","2809","5","1657","5","1152","27.551535000","0.0167","791592.02","550340.38"
"244.3.153.197","50543","41.177.3.145","443","17","4923","10","3293","7","1630","233.567760000","0.0166","1583553.74","783842.27"
"41.177.192.117","8189","244.3.160.239","80","10","1890","5","1213","5","677","161.178160000","0.0166","585318.78","326678.33"
"145.95.48.20","49174","244.3.31.46","993","15","1564","10","917","5","647","28.586448000","0.0162","453091.22","319683.77"
"253.37.253.43","54751","253.160.108.253","20","3","192","3","192","0","0","119.117071000","0.0162","95008.35","N/A"
"244.3.160.239","61730","244.3.31.75","80","11","2830","6","1447","5","1383","64.592089000","0.0161","717936.00","686182.09"
"244.3.160.239","61756","244.3.31.75","80","11","2830","6","1447","5","1383","69.090111000","0.0160","724269.54","692235.50"
"41.177.199.139","3704","244.3.160.239","80","18","8603","8","1381","10","7222","69.471164000","0.0159","695192.55","3635539.89"
"244.3.3.145","6470","244.3.160.239","80","12","3010","6","1028","6","1982","202.393891000","0.0158","519028.08","1000694.23"
"41.177.211.185","4379","244.3.160.239","80","10","2673","5","1485","5","1188","159.879651000","0.0158","752517.89","602014.32"
"253.37.253.43","54747","253.160.108.253","20","3","192","3","192","0","0","117.936929000","0.0158","97301.41","N/A"
"145.95.176.246","11343","244.3.160.239","80","10","1754","5","1192","5","562","111.961502000","0.0157","608629.05","286954.30"
"244.3.253.224","10211","244.3.160.239","80","10","2319","5","1357","5","962","216.807235000","0.0157","693585.48","491694.35"
"253.37.253.43","54740","253.160.108.253","20","4","256","4","256","0","0","115.812981000","0.0156","131164.34","N/A"
"41.177.211.185","12169","244.3.160.239","80","10","2004","5","1253","5","751","160.417761000","0.0155","646042.79","387213.20"
"244.3.160.248","49312","41.177.26.193","80","26","14720","11","2318","15","12402","170.538604000","0.0155","1198165.02","6410544.68"
"68.33.110.176","12659","244.3.160.239","80","5","1246","3","1112","2","134","231.345461000","0.0154","579015.88","69773.50"
"151.77.185.176","5696","244.3.160.239","80","11","2231","6","1198","5","1033","37.649951000","0.0153","624690.39","538652.07"
"41.177.211.185","8165","244.3.160.239","80","10","2234","5","1366","5","868","190.142811000","0.0153","713222.82","453204.54"
"244.3.3.145","5448","244.3.160.239","80","22","10507","9","1209","13","9298","202.454158000","0.0153","632074.24","4861063.91"
"41.177.211.185","7209","244.3.160.239","80","31","18399","12","1684","19","16715","160.055907000","0.0152","883757.54","8771975.86"
"244.3.160.248","47910","41.177.26.193","80","26","14720","11","2318","15","12402","72.347237000","0.0152","1221205.14","6533816.27"
"244.3.139.251","58784","244.3.31.244","443","24","4909","15","2342","9","2567","5.269586000","0.0151","1239809.42","1358920.06"
"244.3.160.248","49746","41.177.26.193","80","17","5633","8","2186","9","3447","201.268198000","0.0150","1164701.96","1836563.44"
"244.3.213.210","9172","244.3.160.239","80","10","1984","5","1428","5","556","27.848677000","0.0149","764914.63","297823.90"
"253.37.253.43","54750","253.160.108.253","20","3","192","3","192","0","0","118.815766000","0.0149","103163.41","N/A"
"244.3.160.248","47930","41.177.26.193","80","13","2908","7","2106","6","802","74.416504000","0.0149","1132867.13","431414.74"
"41.177.84.66","59860","244.3.31.168","443","19","8332","10","1928","9","6404","74.047263000","0.0148","1039143.03","3451593.34"
"41.177.211.185","12211","244.3.160.239","80","19","8732","8","1434","11","7298","160.436169000","0.0148","773410.64","3936088.45"
"244.3.160.239","62156","244.3.31.75","80","11","2031","6","1406","5","625","117.157154000","0.0148","758513.72","337177.15"
"41.177.34.163","11961","244.3.160.239","80","10","2263","5","1414","5","849","111.992610000","0.0148","766239.92","460069.09"
"244.3.167.79","53720","244.3.41.84","23","5","359","3","213","2","146","153.456417000","0.0147","115666.58","79283.19"
"244.3.160.239","62695","197.154.128.255","80","12","3330","7","1430","5","1900","217.816635000","0.0147","777173.91","1032608.70"
"41.177.124.47","3751","244.3.160.239","80","11","3632","5","1544","6","2088","224.956862000","0.0146","843888.78","1141217.46"
"244.3.160.239","61781","244.3.31.75","80","11","2663","6","1452","5","1211","77.120864000","0.0146","794039.24","662246.22"
"244.3.160.248","49991","41.177.26.193","80","47","36328","18","2769","29","33559","223.692405000","0.0146","1514770.24","18358315.10"
"244.3.160.239","62157","244.3.31.75","80","11","1600","6","1046","5","554","117.307434000","0.0146","573897.54","303957.20"
"244.3.160.248","50027","41.177.26.193","80","16","3197","8","2137","8","1060","233.789023000","0.0146","1173047.89","581858.10"
"244.3.160.239","61995","244.3.31.75","80","19","8699","9","1370","10","7329","105.073483000","0.0145","754613.05","4036904.43"
"41.177.211.185","4200","244.3.160.239","80","17","10216","8","3523","9","6693","177.685480000","0.0145","1944126.37","3693453.82"
"244.3.139.251","58738","244.3.31.244","443","24","4865","15","2298","9","2567","4.564522000","0.0145","1272161.10","1421078.13"
"41.177.124.47","6557","244.3.160.239","80","10","2155","5","1545","5","610","224.954550000","0.0144","858333.33","338888.89"
"244.3.139.251","58821","244.3.31.244","443","22","4250","14","1858","8","2392","65.901921000","0.0144","1033083.12","1329997.22"
"41.177.34.163","16095","244.3.160.239","80","10","2266","5","1415","5","851","112.481944000","0.0144","788410.64","474160.75"
"244.3.160.239","61623","244.3.31.75","80","11","2830","6","1447","5","1383","57.451423000","0.0143","807872.15","772140.41"
"244.3.181.123","4635","244.3.160.239","80","10","1803","5","1386","5","417","133.524360000","0.0143","774572.13","233042.26"
"151.77.217.75","7213","244.3.160.239","80","11","2763","6","1342","5","1421","93.198464000","0.0143","751031.83","795243.09"
"244.3.139.251","58739","244.3.31.244","443","22","4430","14","1809","8","2621","4.580660000","0.0143","1015222.73","1470922.48"
"244.3.160.248","48237","41.177.26.193","80","54","44127","21","2960","33","41167","107.310178000","0.0141","1681698.74","23388679.78"
"244.3.160.239","62506","244.3.31.75","80","11","2652","6","1441","5","1211","187.602774000","0.0140","821258.10","690175.96"
"41.177.124.47","8707","244.3.160.239","80","10","2156","5","1546","5","610","24.976238000","0.0139","891837.32","351889.24"
"244.3.160.239","62144","244.3.31.108","80","11","2662","6","1326","5","1336","115.427657000","0.0138","766972.74","772756.85"
"244.3.160.248","49749","41.177.26.193","80","19","6897","9","2230","10","4667","201.389352000","0.0138","1291723.99","2703352.40"
"244.3.160.239","61964","244.3.31.75","80","11","2657","6","1446","5","1211","103.341715000","0.0138","838139.40","701927.26"
"253.37.253.43","54761","253.160.108.253","20","3","192","3","192","0","0","122.131983000","0.0138","111490.16","N/A"
"41.177.211.185","10010","244.3.160.239","80","11","3490","5","1221","6","2269","160.902569000","0.0138","709368.19","1318228.03"
"244.3.160.248","49049","41.177.26.193","80","43","31539","17","2709","26","28830","154.062059000","0.0138","1574084.83","16751888.44"
"41.177.199.139","8005","244.3.160.239","80","11","3501","5","1171","6","2330","58.147979000","0.0138","680566.65","1354159.10"
"244.3.3.145","7491","244.3.160.239","80","10","1803","5","860","5","943","202.225686000","0.0137","501603.97","550014.58"
"244.3.139.251","58810","244.3.31.244","443","24","5282","15","2269","9","3013","65.750813000","0.0136","1331865.87","1768581.70"
"41.177.98.121","6389","244.3.47.239","3954","10","2346","5","1687","5","659","83.890880000","0.0136","991332.45","387248.42"
"244.3.160.248","47304","41.177.26.193","80","11","2521","6","1783","5","738","35.193944000","0.0136","1047744.97","433671.22"
"41.177.199.139","16040","244.3.160.239","80","14","7882","6","1253","8","6629","69.385386000","0.0136","737438.39","3901419.85"
"145.95.176.246","3276","244.3.160.239","80","10","1762","5","1202","5","560","114.195613000","0.0136","708883.16","330261.70"
"151.77.217.75","6550","244.3.160.239","80","11","2734","6","1394","5","1340","93.213755000","0.0136","822297.60","790443.89"
"41.177.132.22","15673","244.3.160.239","80","10","1654","5","1096","5","558","212.251175000","0.0135","647706.29","329762.87"
"244.3.139.251","58744","244.3.31.244","443","24","5264","15","2263","9","3001","4.684060000","0.0135","1345022.29","1783655.27"
"244.3.139.251","58819","244.3.31.244","443","24","5282","15","2269","9","3013","65.875146000","0.0134","1350293.83","1793052.15"
"244.3.139.251","58806","244.3.31.244","443","24","5264","15","2263","9","3001","25.594810000","0.0134","1348629.32","1788438.62"
"41.177.3.224","9501","41.177.143.106","3734","9","822","4","378","5","444","120.703729000","0.0133","226856.71","266466.62"
"244.3.139.251","58805","244.3.31.244","443","24","4506","15","2102","9","2404","25.580464000","0.0133","1264075.77","1445688.94"
"244.3.139.251","58750","244.3.31.244","443","24","5264","15","2263","9","3001","4.768946000","0.0133","1365721.18","1811104.41"
"41.177.83.247","8875","244.3.160.239","80","10","2778","5","1595","5","1183","55.498219000","0.0132","963018.87","714264.15"
"244.3.139.251","58773","244.3.31.244","443","24","5276","15","2267","9","3009","5.113075000","0.0132","1373731.25","1823360.10"
"244.3.181.123","7257","244.3.160.239","80","10","1802","5","1385","5","417","133.595288000","0.0132","840030.33","252918.88"
"244.3.139.251","58813","244.3.31.244","443","24","5282","15","2269","9","3013","65.794080000","0.0132","1379855.57","1832307.11"
"244.3.160.239","61985","244.3.31.75","80","11","2312","6","1176","5","1136","104.450780000","0.0131","718661.68","694217.40"
"244.3.139.251","58749","244.3.31.244","443","22","4244","14","1852","8","2392","4.751283000","0.0131","1132115.84","1462214.41"
"244.3.139.251","58829","244.3.31.244","443","24","5282","15","2269","9","3013","66.029085000","0.0131","1389999.23","1845776.86"
"41.177.199.139","6383","244.3.160.239","80","10","1892","5","1034","5","858","96.781262000","0.0131","633772.60","525896.41"
"244.3.139.251","58783","244.3.31.244","443","24","5276","15","2267","9","3009","5.255507000","0.0130","1393683.24","1849842.47"
"244.3.139.251","58825","244.3.31.244","443","22","4250","14","1858","8","2392","65.968348000","0.0130","1142505.76","1470868.56"
"41.177.132.22","5323","244.3.160.239","80","10","1675","5","1119","5","556","213.731843000","0.0130","688827.33","342259.16"
"244.3.139.251","58767","244.3.31.244","443","24","5276","15","2267","9","3009","5.031676000","0.0130","1396043.41","1852975.14"
"244.3.139.251","58828","244.3.31.244","443","24","4512","15","2108","9","2404","66.015047000","0.0130","1298329.36","1480637.46"
"244.3.139.251","58790","244.3.31.244","443","24","5264","15","2263","9","3001","25.358060000","0.0130","1395083.61","1850042.38"
"244.3.139.251","58796","244.3.31.244","443","24","5264","15","2263","9","3001","25.452043000","0.0130","1395191.12","1850184.96"
"244.3.139.251","58740","244.3.31.244","443","22","4244","14","1852","8","2392","4.595933000","0.0130","1142416.53","1475518.54"
"244.3.160.239","62360","244.3.31.75","80","11","2714","6","1467","5","1247","159.882284000","0.0129","906815.02","770823.67"
"244.3.139.251","58760","244.3.31.244","443","24","5264","15","2263","9","3001","4.913484000","0.0129","1403737.30","1861518.18"
"244.3.139.251","58787","244.3.31.244","443","24","5264","15","2263","9","3001","25.315673000","0.0129","1408214.06","1867454.88"
"41.177.192.117","15017","244.3.160.239","80","10","2101","5","1154","5","947","161.112282000","0.0128","719507.44","590445.02"
"145.95.176.246","15424","244.3.160.239","80","10","1764","5","1204","5","560","114.494040000","0.0128","750916.04","349263.27"
"244.3.139.251","58764","244.3.31.244","443","24","5276","15","2267","9","3009","4.989590000","0.0128","1414113.06","1876959.06"
"244.3.160.239","62379","244.3.31.75","80","11","2047","6","1210","5","837","160.419930000","0.0128","757314.97","523861.68"
"41.177.34.163","10097","244.3.160.239","80","10","2254","5","1411","5","843","113.647851000","0.0128","883739.14","527988.73"
"41.177.34.163","15414","244.3.160.239","80","10","2419","5","1532","5","887","131.174549000","0.0127","961254.90","556549.02"
"244.3.160.248","49990","41.177.26.193","80","54","44127","21","2960","33","41167","223.690684000","0.0127","1858420.97","25846491.92"
"244.3.139.251","58759","244.3.31.244","443","24","4506","15","2102","9","2404","4.898632000","0.0127","1319730.03","1509339.19"
"41.177.211.185","11921","244.3.160.239","80","13","5886","6","1358","7","4528","177.628088000","0.0127","854558.33","2849366.79"
"41.177.211.185","10113","244.3.160.239","80","17","10190","8","3497","9","6693","160.358872000","0.0127","2201794.43","4214072.09"
"41.177.211.185","8147","244.3.160.239","80","13","4815","6","1339","7","3476","177.704740000","0.0127","844129.24","2191331.76"
"41.177.199.139","14107","244.3.160.239","80","10","1892","5","1034","5","858","95.637733000","0.0127","652983.90","541837.70"
"244.3.139.251","58795","244.3.31.244","443","22","4244","14","1852","8","2392","25.435081000","0.0127","1171040.15","1512488.14"
"244.3.139.251","58793","244.3.31.244","443","24","4687","15","2087","9","2600","25.409108000","0.0126","1320468.21","1645049.04"
"244.3.160.248","47912","41.177.26.193","80","48","38125","19","2839","29","35286","72.405559000","0.0126","1799683.04","22368304.28"
"244.3.160.248","49336","41.177.26.193","80","50","38567","19","2838","31","35729","172.566002000","0.0126","1799191.70","22650923.21"
"41.177.192.117","15617","244.3.160.239","80","10","1967","5","1176","5","791","161.476170000","0.0126","746015.38","501784.16"
"244.3.160.239","62624","244.3.31.75","80","11","1600","6","1046","5","554","204.069681000","0.0126","664285.15","351829.80"
"244.3.160.239","62211","244.3.31.75","80","11","2019","6","1398","5","621","124.180540000","0.0126","888677.00","394755.66"
"244.3.139.251","58721","244.3.31.244","443","24","5144","15","2223","9","2921","4.311688000","0.0126","1413110.85","1856813.67"
"244.3.181.123","3242","244.3.160.239","80","12","3424","6","1386","6","2038","114.977123000","0.0125","883858.11","1299641.29"
"253.37.253.43","54730","253.160.108.253","20","2","128","2","128","0","0","87.885525000","0.0125","81952.78","N/A"
"244.3.181.123","14923","244.3.160.239","80","12","3442","6","1940","6","1502","117.713236000","0.0125","1242594.08","962049.64"
"244.3.139.251","58782","244.3.31.244","443","24","4510","15","2106","9","2404","5.242023000","0.0125","1350000.00","1541025.64"
"244.3.139.251","58816","244.3.31.244","443","24","4699","15","2093","9","2606","65.832534000","0.0125","1342312.01","1671316.34"
"151.77.185.176","10310","244.3.160.239","80","11","2202","6","1250","5","952","37.666604000","0.0125","802954.87","611530.43"
"244.3.139.251","58812","244.3.31.244","443","22","4250","14","1858","8","2392","65.777036000","0.0125","1193703.82","1536781.24"
"244.3.139.251","58824","244.3.31.244","443","22","4436","14","1815","8","2621","65.954844000","0.0124","1167859.73","1686479.53"
"244.3.139.251","58718","244.3.31.244","443","24","5144","15","2223","9","2921","4.270996000","0.0124","1432460.73","1882239.23"
"244.3.139.251","58804","244.3.31.244","443","22","4244","14","1852","8","2392","25.563540000","0.0124","1194838.71","1543225.81"
"244.3.139.251","58736","244.3.31.244","443","24","4466","15","2062","9","2404","4.514191000","0.0124","1330966.60","1551718.57"
"244.3.181.123","15658","244.3.160.239","80","12","3270","6","1850","6","1420","135.754512000","0.0124","1194415.30","916794.45"
"244.3.139.251","58770","244.3.31.244","443","24","4695","15","2091","9","2604","5.070259000","0.0124","1351757.58","1683393.94"
"244.3.160.239","62145","244.3.31.108","80","11","2309","6","1332","5","977","115.429384000","0.0124","861230.10","631698.05"
"244.3.139.251","58818","244.3.31.244","443","22","4250","14","1858","8","2392","65.858287000","0.0124","1201908.30","1547343.74"
"244.3.139.251","58727","244.3.31.244","443","24","5144","15","2223","9","2921","4.389737000","0.0123","1441166.94","1893679.09"
"244.3.160.248","49316","41.177.26.193","80","49","38189","19","2839","30","35350","170.599948000","0.0123","1841115.43","22924773.02"
"244.3.139.251","58791","244.3.31.244","443","24","4655","15","2034","9","2621","25.372091000","0.0123","1321315.47","1702639.06"
"244.3.139.251","58827","244.3.31.244","443","22","4250","14","1858","8","2392","65.998251000","0.0123","1208062.42","1555266.58"
"244.3.139.251","58743","244.3.31.244","443","22","4244","14","1852","8","2392","4.667425000","0.0123","1205238.75","1556658.26"
"244.3.139.251","58798","244.3.31.244","443","22","4244","14","1852","8","2392","25.477802000","0.0123","1205827.30","1557418.41"
"244.3.160.248","48243","41.177.26.193","80","48","38125","19","2839","29","35286","107.455331000","0.0123","1849812.67","22991366.67"
"244.3.139.251","58747","244.3.31.244","443","24","4687","15","2087","9","2600","4.724573000","0.0123","1361160.93","1695744.33"
"244.3.160.248","47929","41.177.26.193","80","50","38567","19","2838","31","35729","74.325857000","0.0123","1851121.08","23304688.14"
"244.3.139.251","58756","244.3.31.244","443","22","4244","14","1852","8","2392","4.853738000","0.0123","1208778.66","1561230.32"
"244.3.139.251","58779","244.3.31.244","443","22","4248","14","1856","8","2392","5.196456000","0.0122","1212477.54","1562632.70"
"244.3.139.251","58777","244.3.31.244","443","22","4248","14","1856","8","2392","5.168069000","0.0122","1214063.78","1564677.02"
"41.177.211.185","11421","244.3.160.239","80","13","5838","6","1310","7","4528","161.019416000","0.0122","860285.67","2973567.56"
"244.3.139.251","58809","244.3.31.244","443","22","4250","14","1858","8","2392","65.732147000","0.0122","1221464.38","1572520.34"
"244.3.160.239","62736","197.154.128.197","80","15","6962","8","1607","7","5355","224.962562000","0.0122","1056454.93","3520420.74"
"244.3.160.248","49301","41.177.26.193","80","15","3772","8","2127","7","1645","170.037264000","0.0122","1398537.03","1081614.20"
"244.3.139.251","58781","244.3.31.244","443","22","4248","14","1856","8","2392","5.224749000","0.0122","1221153.06","1573813.64"
"244.3.139.251","58822","244.3.31.244","443","22","4436","14","1815","8","2621","65.924115000","0.0122","1194373.61","1724767.62"
"244.3.139.251","58775","244.3.31.244","443","22","4248","14","1856","8","2392","5.139182000","0.0121","1224476.33","1578096.65"
"41.177.211.185","12776","244.3.160.239","80","13","5857","6","1329","7","4528","165.036359000","0.0121","877517.33","2989765.60"
"244.3.139.251","58789","244.3.31.244","443","22","4244","14","1852","8","2392","25.341451000","0.0121","1223148.68","1579790.31"
"145.95.31.210","2542","244.3.160.239","80","12","3121","6","1127","6","1994","88.634376000","0.0121","745925.37","1319765.04"
"244.3.139.251","58786","244.3.31.244","443","22","4244","14","1852","8","2392","25.299367000","0.0121","1227709.65","1585681.14"
"244.3.139.251","58752","244.3.31.244","443","22","4244","14","1852","8","2392","4.796659000","0.0121","1229543.57","1588049.79"
"244.3.139.251","58772","244.3.31.244","443","22","4248","14","1856","8","2392","5.096266000","0.0120","1233017.77","1589104.80"
"244.3.139.251","58745","244.3.31.244","443","24","4655","15","2034","9","2621","4.698598000","0.0120","1352618.45","1742975.89"
"244.3.139.251","58766","244.3.31.244","443","22","4248","14","1856","8","2392","5.015221000","0.0120","1237849.10","1595331.39"
"244.3.139.251","58802","244.3.31.244","443","22","4244","14","1852","8","2392","25.534492000","0.0120","1235696.41","1595996.66"
"244.3.139.251","58763","244.3.31.244","443","22","4248","14","1856","8","2392","4.973630000","0.0120","1239916.49","1597995.82"
"244.3.139.251","58800","244.3.31.244","443","22","4244","14","1852","8","2392","25.506134000","0.0120","1237450.93","1598262.76"
"41.177.199.139","9619","244.3.160.239","80","19","8653","8","1355","11","7298","58.126023000","0.0119","908100.86","4891011.14"
"244.3.160.239","62096","244.3.31.75","80","11","2577","6","1372","5","1205","112.503396000","0.0119","919648.09","807708.42"
"244.3.139.251","58754","244.3.31.244","443","22","4244","14","1852","8","2392","4.825636000","0.0119","1245355.97","1608472.72"
"41.177.211.185","2230","244.3.160.239","80","13","4474","6","1300","7","3174","160.041508000","0.0119","874978.97","2136294.80"
"244.3.139.251","58758","244.3.31.244","443","22","4244","14","1852","8","2392","4.882002000","0.0119","1248083.56","1611995.62"
"244.3.213.210","11914","244.3.160.239","80","10","2017","5","1459","5","558","25.611784000","0.0119","984231.39","376422.97"
"244.3.139.251","58823","244.3.31.244","443","22","4250","14","1858","8","2392","65.937249000","0.0118","1256254.23","1617308.99"
"244.3.139.251","58726","244.3.31.244","443","22","4204","14","1812","8","2392","4.373650000","0.0118","1226499.70","1619087.91"
"244.3.3.145","12998","244.3.160.239","80","15","5634","7","1081","8","4553","202.417292000","0.0118","732695.08","3085995.09"
"41.177.192.117","3278","244.3.160.239","80","10","1900","5","1312","5","588","161.491363000","0.0118","890623.67","399151.46"
"244.3.139.251","58746","244.3.31.244","443","24","4678","15","2041","9","2637","4.711628000","0.0118","1387491.50","1792658.06"
"41.177.124.47","14466","244.3.160.239","80","10","2148","5","1538","5","610","213.619582000","0.0117","1047327.20","415389.85"
"254.71.77.18","36250","244.3.210.197","80","5","350","3","210","2","140","37.540951000","0.0117","143173.68","95449.12"
"244.3.160.248","50000","41.177.26.193","80","49","38503","19","2838","30","35665","225.809808000","0.0117","1938359.09","24359258.94"
"244.3.160.239","61866","244.3.31.75","80","11","2542","6","1331","5","1211","88.200034000","0.0117","913599.31","831231.23"
"244.3.160.239","61410","244.3.31.75","80","11","2808","6","1603","5","1205","26.554304000","0.0116","1103424.54","829461.37"
"244.3.139.251","58724","244.3.31.244","443","24","4607","15","2047","9","2560","4.349219000","0.0116","1409294.32","1762478.49"
"244.3.3.145","5968","244.3.160.239","80","12","3053","6","1015","6","2038","202.381785000","0.0116","702057.76","1409648.97"
"244.3.160.239","62123","244.3.31.75","80","11","1776","6","1155","5","621","114.601293000","0.0116","799446.27","429832.15"
"244.3.90.4","18666","41.177.98.92","5632","105","10290","105","10290","0","0","227.869950000","0.0115","7127889.86","N/A"
"244.3.160.239","62366","244.3.31.75","80","13","3302","7","1224","6","2078","160.142733000","0.0115","849336.46","1441929.05"
"244.3.139.251","58733","244.3.31.244","443","22","4204","14","1812","8","2392","4.469761000","0.0115","1258333.33","1661111.11"
"41.177.34.163","10169","244.3.160.239","80","10","2260","5","1413","5","847","112.016854000","0.0115","984754.77","590295.32"
"244.3.139.251","58717","244.3.31.244","443","22","4204","14","1812","8","2392","4.253852000","0.0115","1263708.48","1668206.78"
"244.3.160.248","48236","41.177.26.193","80","46","36264","18","2769","28","33495","107.309456000","0.0115","1931130.68","23359776.83"
"244.3.160.248","48269","41.177.26.193","80","49","38503","19","2838","30","35665","109.387161000","0.0115","1979424.59","24875326.94"
"244.3.139.251","58729","244.3.31.244","443","22","4204","14","1812","8","2392","4.414443000","0.0114","1266800.66","1672288.74"
"41.177.199.139","9611","244.3.160.239","80","9","3488","5","1189","4","2299","64.883746000","0.0114","835265.19","1615033.37"
"41.177.199.139","6368","244.3.160.239","80","14","5781","6","1228","8","4553","57.935009000","0.0114","864788.73","3206338.03"
"244.3.160.248","48232","41.177.26.193","80","28","16490","12","2394","16","14096","106.884765000","0.0113","1689186.81","9946022.23"
"244.3.139.251","58720","244.3.31.244","443","22","4204","14","1812","8","2392","4.295859000","0.0113","1282604.85","1693151.65"
"244.3.139.251","58803","244.3.31.244","443","22","4430","14","1809","8","2621","25.551285000","0.0113","1282183.04","1857712.41"
"244.3.139.251","58735","244.3.31.244","443","22","4204","14","1812","8","2392","4.498427000","0.0113","1287503.33","1699618.08"
"244.3.160.239","61416","244.3.31.75","80","11","2822","6","1611","5","1211","27.556572000","0.0112","1147129.51","862305.30"
"244.3.92.253","24266","244.3.41.84","23","5","359","3","213","2","146","153.460986000","0.0112","151831.06","104072.00"
"244.3.160.239","62662","244.3.31.75","80","11","2468","6","1263","5","1205","212.616113000","0.0112","901579.37","860176.68"
"41.177.34.163","5938","244.3.160.239","80","10","2254","5","1411","5","843","113.723148000","0.0112","1007857.14","602142.86"
"244.3.139.251","58731","244.3.31.244","443","22","4204","14","1812","8","2392","4.442626000","0.0112","1295095.15","1709639.95"
"244.3.139.251","58815","244.3.31.244","443","24","4678","15","2041","9","2637","65.820350000","0.0112","1461641.75","1888461.19"
"41.177.84.66","60017","244.3.31.168","443","17","3022","10","2040","7","982","194.070233000","0.0112","1462758.81","704131.94"
"244.3.160.239","62111","244.3.31.75","80","11","1600","6","1046","5","554","113.701455000","0.0111","750829.97","397667.12"
"244.3.160.239","61458","244.3.31.75","80","11","1693","6","1072","5","621","32.601814000","0.0111","769700.23","445880.45"
"244.3.77.177","2351","244.3.31.168","443","17","6797","8","1441","9","5356","51.788330000","0.0111","1035759.21","3849775.38"
"244.3.139.251","58769","244.3.31.244","443","24","4678","15","2041","9","2637","5.058172000","0.0111","1470461.10","1899855.91"
"244.3.139.251","58722","244.3.31.244","443","24","4655","15","2034","9","2621","4.325330000","0.0111","1470051.50","1894299.39"
"244.3.139.251","58814","244.3.31.244","443","24","4655","15","2034","9","2621","65.808265000","0.0110","1474046.56","1899447.41"
"244.3.139.251","58826","244.3.31.244","443","22","4436","14","1815","8","2621","65.986170000","0.0110","1315694.09","1899963.75"
"41.177.199.139","14924","244.3.160.239","80","9","3488","5","1189","4","2299","58.075058000","0.0110","862219.00","1667150.11"
"244.3.139.251","58785","244.3.31.244","443","22","4430","14","1809","8","2621","25.287284000","0.0110","1312414.98","1901514.46"
"244.3.139.251","58801","244.3.31.244","443","22","4430","14","1809","8","2621","25.522572000","0.0110","1316593.89","1907569.14"
"244.3.160.248","49739","41.177.26.193","80","27","16456","12","2424","15","14032","200.881933000","0.0109","1774524.16","10272327.96"
"244.3.139.251","58723","244.3.31.244","443","24","4678","15","2041","9","2637","4.337384000","0.0109","1499770.37","1937723.89"
"244.3.160.239","62713","244.3.31.75","80","11","1600","6","1046","5","554","220.481390000","0.0109","769259.05","407427.84"
"244.3.160.239","62399","41.177.254.197","80","10","1925","6","1362","4","563","161.494319000","0.0109","1002484.13","414389.55"
"244.3.77.177","2354","244.3.31.168","443","17","6797","8","1441","9","5356","172.088750000","0.0108","1062586.41","3949488.43"
"244.3.139.251","58788","244.3.31.244","443","22","4430","14","1809","8","2621","25.329643000","0.0108","1336781.82","1936818.77"
"244.3.139.251","58774","244.3.31.244","443","22","4434","14","1813","8","2621","5.127348000","0.0108","1340109.03","1937355.63"
"244.3.139.251","58716","244.3.31.244","443","22","4390","14","1769","8","2621","4.242077000","0.0108","1309521.61","1940223.93"
"244.3.160.239","61419","244.3.31.75","80","11","2004","6","1382","5","622","27.852197000","0.0108","1023135.30","460484.92"
"244.3.160.248","50013","41.177.26.193","80","16","3849","8","2140","8","1709","231.392773000","0.0108","1585331.98","1266043.15"
"244.3.181.123","14752","244.3.160.239","80","15","6011","7","1458","8","4553","115.367899000","0.0108","1081903.35","3378536.31"
"41.177.3.224","9501","41.177.143.106","3735","9","1006","4","470","5","536","120.714073000","0.0108","349344.98","398401.93"
"41.177.34.163","15800","244.3.160.239","80","10","2419","5","1532","5","887","130.767963000","0.0108","1139668.96","659847.50"
"244.3.160.248","49740","41.177.26.193","80","16","3866","8","2157","8","1709","200.895867000","0.0107","1605508.00","1272050.61"
"244.3.164.46","14993","244.3.160.239","80","10","2756","5","1756","5","1000","152.511142000","0.0107","1307155.49","744393.78"
"244.3.160.239","62178","244.3.31.75","80","11","1600","6","1046","5","554","120.691679000","0.0107","779361.09","412778.24"
"244.3.139.251","58808","244.3.31.244","443","22","4436","14","1815","8","2621","65.719382000","0.0107","1352459.02","1953055.14"
"244.3.139.251","58797","244.3.31.244","443","22","4430","14","1809","8","2621","25.466086000","0.0107","1348616.16","1953965.15"
"244.3.139.251","58751","244.3.31.244","443","22","4430","14","1809","8","2621","4.784702000","0.0107","1348867.56","1954329.39"
"41.177.98.43","38636","41.177.26.155","8010","14","4132","8","2566","6","1566","225.687273000","0.0107","1914925.37","1168656.72"
"41.177.135.193","12552","244.3.160.239","80","10","2062","5","974","5","1088","101.821022000","0.0107","727340.61","812470.83"
"244.3.139.251","58765","244.3.31.244","443","22","4434","14","1813","8","2621","5.003471000","0.0107","1354121.93","1957613.67"
"244.3.139.251","58748","244.3.31.244","443","22","4430","14","1809","8","2621","4.739564000","0.0107","1353408.77","1960909.01"
"244.3.160.239","62671","244.3.31.75","80","11","1668","6","1046","5","622","213.641693000","0.0107","782860.89","465525.31"
"244.3.139.251","58730","244.3.31.244","443","22","4390","14","1769","8","2621","4.430792000","0.0107","1324101.80","1961826.35"
"244.3.139.251","58768","244.3.31.244","443","24","4655","15","2034","9","2621","5.045698000","0.0107","1524737.63","1964767.62"
"244.3.160.248","49998","41.177.26.193","80","49","38189","19","2839","30","35350","223.839662000","0.0107","2131381.38","26539039.04"
"244.3.160.239","62451","244.3.31.75","80","11","1600","6","1046","5","554","173.481702000","0.0107","785432.70","415993.99"
"244.3.139.251","58771","244.3.31.244","443","22","4434","14","1813","8","2621","5.084483000","0.0106","1362517.61","1969751.06"
"41.177.239.219","59217","244.3.41.84","23","5","359","3","213","2","146","32.464690000","0.0106","160120.28","109753.81"
"41.177.211.185","2774","244.3.160.239","80","9","3567","5","1268","4","2299","160.304209000","0.0106","954639.56","1730848.86"
"244.3.139.251","58732","244.3.31.244","443","22","4390","14","1769","8","2621","4.458199000","0.0106","1334842.48","1977740.05"
"244.3.139.251","58799","244.3.31.244","443","22","4430","14","1809","8","2621","25.494549000","0.0106","1365283.02","1978113.21"
"244.3.139.251","58734","244.3.31.244","443","22","4390","14","1769","8","2621","4.486847000","0.0106","1335724.40","1979046.72"
"41.177.211.185","13289","244.3.160.239","80","10","2421","5","1270","5","1151","177.722770000","0.0106","961210.97","871144.75"
"41.177.84.66","59862","244.3.31.168","443","17","3022","10","2040","7","982","74.065664000","0.0105","1551773.32","746981.08"
"244.3.139.251","58811","244.3.31.244","443","22","4436","14","1815","8","2621","65.765555000","0.0105","1380753.14","1993914.04"
"41.177.26.214","39491","244.3.160.186","80","15","2715","8","640","7","2075","59.022976000","0.0105","487201.45","1579598.44"
"244.3.139.251","58794","244.3.31.244","443","22","4430","14","1809","8","2621","25.423630000","0.0105","1378154.46","1996762.21"
"244.3.139.251","58755","244.3.31.244","443","22","4430","14","1809","8","2621","4.842090000","0.0105","1379336.64","1998475.03"
"244.3.139.251","58778","244.3.31.244","443","22","4434","14","1813","8","2621","5.184988000","0.0105","1385026.74","2002291.83"
"244.3.160.239","61429","244.3.31.75","80","11","2498","6","1293","5","1205","29.365555000","0.0105","988815.60","921518.02"
"244.3.203.37","54797","244.3.41.84","23","5","359","3","213","2","146","32.468687000","0.0104","163171.50","111845.26"
"244.3.139.251","58780","244.3.31.244","443","22","4434","14","1813","8","2621","5.213349000","0.0104","1389804.52","2009198.93"
"41.177.34.163","16266","244.3.160.239","80","10","2296","5","1425","5","871","67.968378000","0.0104","1092686.67","667880.76"
"41.177.199.139","8570","244.3.160.239","80","10","2209","5","1161","5","1048","57.954335000","0.0104","892647.77","805766.46"
"244.3.139.251","58753","244.3.31.244","443","22","4430","14","1809","8","2621","4.814209000","0.0104","1394085.35","2019843.95"
"244.3.160.248","49306","41.177.26.193","80","17","5603","8","2156","9","3447","170.382250000","0.0104","1661657.03","2656647.40"
"244.3.160.239","62441","244.3.31.75","80","11","1600","6","1046","5","554","166.262225000","0.0104","807566.11","427716.66"
"244.3.139.251","58728","244.3.31.244","443","22","4390","14","1769","8","2621","4.403144000","0.0104","1367078.83","2025502.32"
"244.3.160.239","61473","244.3.31.75","80","11","1552","6","998","5","554","36.502969000","0.0103","772147.00","428626.69"
"244.3.139.251","58725","244.3.31.244","443","22","4390","14","1769","8","2621","4.362372000","0.0103","1369195.05","2028637.77"
"244.3.139.251","58719","244.3.31.244","443","22","4390","14","1769","8","2621","4.284531000","0.0103","1371317.83","2031782.95"
"244.3.160.239","62233","244.3.31.108","80","11","1752","6","1326","5","426","133.527751000","0.0103","1028205.87","330328.58"
"244.3.139.251","58820","244.3.31.244","443","22","4436","14","1815","8","2621","65.889774000","0.0103","1408478.03","2033950.92"
"244.3.139.251","58776","244.3.31.244","443","22","4434","14","1813","8","2621","5.156786000","0.0103","1407198.99","2034345.59"
"41.177.26.214","39477","244.3.160.186","80","15","2715","8","640","7","2075","24.432445000","0.0103","499414.75","1619196.25"
"244.3.153.25","50806","244.3.160.80","443","3","719","2","655","1","64","0.044223000","0.0102","512569.70","N/A"
"244.3.160.239","62357","244.3.31.75","80","11","2677","6","1466","5","1211","159.724918000","0.0102","1147778.43","948130.75"
"244.3.139.251","58817","244.3.31.244","443","22","4436","14","1815","8","2621","65.846893000","0.0102","1422274.46","2053874.03"
"244.3.139.251","58762","244.3.31.244","443","22","4434","14","1813","8","2621","4.962469000","0.0102","1427278.09","2063373.35"
"41.177.124.47","5530","244.3.160.239","80","10","2156","5","1546","5","610","190.388220000","0.0102","1218402.13","480740.81"
"244.3.160.248","49993","41.177.26.193","80","19","6867","9","2200","10","4667","223.752621000","0.0101","1735700.20","3682051.28"
"244.3.139.251","58757","244.3.31.244","443","22","4430","14","1809","8","2621","4.870755000","0.0101","1429474.52","2071118.14"
"244.3.160.239","61996","244.3.31.75","80","13","3318","7","1240","6","2078","105.174092000","0.0101","980818.67","1643662.25"
"41.177.199.139","11462","244.3.160.239","80","9","3488","5","1189","4","2299","57.989469000","0.0101","944400.32","1826052.42"
"244.3.160.239","62675","244.3.31.75","80","11","1670","6","1048","5","622","213.762548000","0.0100","837144.28","496854.72"
"41.177.199.139","13340","244.3.160.239","80","10","1948","5","1036","5","912","95.908170000","0.0100","832044.98","732456.58"
"244.3.181.123","4536","244.3.160.239","80","10","1790","5","1324","5","466","133.515904000","0.0099","1072607.59","377518.99"
"244.3.164.46","14579","244.3.160.239","80","10","2839","5","1740","5","1099","139.766890000","0.0099","1412767.68","892317.06"
"41.177.98.121","6389","244.3.47.145","4592","10","1007","5","408","5","599","110.872441000","0.0098","331875.95","487239.45"
"244.3.160.248","48239","41.177.26.193","80","19","6867","9","2200","10","4667","107.368449000","0.0098","1801617.36","3821885.56"
"41.177.34.163","12852","244.3.160.239","80","10","2260","5","1413","5","847","112.823914000","0.0097","1163561.50","697478.13"
"41.177.211.185","8814","244.3.160.239","80","11","2291","5","1295","6","996","177.894257000","0.0097","1068481.85","821782.18"
"41.177.199.139","13721","244.3.160.239","80","10","2495","5","1364","5","1131","56.356313000","0.0097","1130542.89","937422.30"
"244.3.160.239","61640","244.3.31.75","80","19","8641","9","1312","10","7329","58.128133000","0.0096","1088683.75","6081526.81"
"244.3.181.123","10663","244.3.160.239","80","10","1790","5","1324","5","466","133.513002000","0.0096","1103103.52","388252.45"
"244.3.160.239","62734","197.154.128.197","80","12","3613","7","1562","5","2051","224.960715000","0.0096","1305474.30","1714166.32"
"244.3.160.239","62180","244.3.31.75","80","11","2723","6","1512","5","1211","120.825547000","0.0096","1266596.86","1014450.26"
"244.3.160.239","61766","244.3.31.75","80","11","1600","6","1046","5","554","74.093517000","0.0095","878253.57","465155.33"
"244.3.160.239","62395","244.3.31.75","80","13","3599","7","1242","6","2357","160.904861000","0.0095","1043040.10","1979424.73"
"244.3.181.123","13327","244.3.160.239","80","10","1804","5","1387","5","417","133.765255000","0.0095","1166894.52","350825.53"
"244.3.181.123","5718","244.3.160.239","80","10","1801","5","1384","5","417","133.539282000","0.0095","1165105.76","351047.04"
"41.177.84.66","60016","244.3.31.168","443","18","3092","10","2040","8","1052","194.070039000","0.0095","1721337.41","887670.08"
"244.3.160.239","61568","244.3.31.75","80","11","1600","6","1046","5","554","47.603574000","0.0095","882793.54","467559.87"
"244.3.160.239","62380","244.3.31.75","80","19","8720","9","1391","10","7329","160.438365000","0.0095","1175203.29","6191994.93"
"244.3.160.239","62668","244.3.31.75","80","11","2477","6","1266","5","1211","213.365097000","0.0095","1070839.50","1024318.04"
"244.3.181.123","8501","244.3.160.239","80","10","1790","5","1324","5","466","133.749336000","0.0094","1122747.51","395166.42"
"244.3.160.248","47906","41.177.26.193","80","17","5603","8","2156","9","3447","72.209705000","0.0094","1828668.36","2923664.12"
"244.3.160.239","62237","244.3.31.108","80","11","1751","6","1325","5","426","133.598608000","0.0094","1126102.20","362052.48"
"41.177.34.163","5230","244.3.160.239","80","10","2260","5","1413","5","847","67.125347000","0.0094","1208208.64","724241.13"
"41.177.84.66","59861","244.3.31.168","443","17","3022","10","2040","7","982","74.065463000","0.0093","1749196.14","842015.01"
"41.177.34.163","9489","244.3.160.239","80","10","2260","5","1413","5","847","111.927299000","0.0093","1216661.29","729307.93"
"41.177.199.139","7840","244.3.160.239","80","10","1948","5","1036","5","912","97.037617000","0.0093","893488.57","786545.92"
"41.177.211.185","5702","244.3.160.239","80","10","2391","5","1384","5","1007","158.357929000","0.0093","1194648.25","869227.45"
"41.177.34.163","2699","244.3.160.239","80","10","2254","5","1411","5","843","113.362675000","0.0092","1223101.09","730740.06"
"244.3.160.239","61811","197.154.128.197","80","10","1609","6","1162","4","447","78.624582000","0.0092","1012746.49","389584.92"
"41.177.211.185","14810","244.3.160.239","80","14","5860","6","1307","8","4553","160.262258000","0.0092","1139867.00","3970783.82"
"41.177.34.163","9700","244.3.160.239","80","10","2254","5","1411","5","843","113.593834000","0.0091","1235010.94","737855.58"
"244.3.31.108","5864","244.3.160.239","80","11","1611","6","588","5","1023","43.649087000","0.0091","514998.91","895992.99"
"244.3.160.239","61639","244.3.31.75","80","11","1968","6","1131","5","837","58.079656000","0.0091","992431.72","734452.12"
"41.177.34.163","8256","244.3.160.239","80","10","2260","5","1413","5","847","66.615660000","0.0090","1249336.87","748894.78"
"41.177.34.163","11570","244.3.160.239","80","10","2419","5","1532","5","887","130.906927000","0.0089","1369385.47","792849.16"
"41.177.211.185","5682","244.3.160.239","80","10","2288","5","1240","5","1048","160.274772000","0.0089","1109371.51","937597.85"
"244.3.160.248","50019","41.177.26.193","80","17","5607","8","2160","9","3447","232.964504000","0.0089","1939829.37","3095644.36"
"41.177.34.163","13915","244.3.160.239","80","10","2266","5","1415","5","851","112.306995000","0.0089","1272625.07","765373.81"
"41.177.34.163","14236","244.3.160.239","80","10","2284","5","1421","5","863","67.243542000","0.0089","1281912.49","778529.54"
"41.177.34.163","12780","244.3.160.239","80","10","2266","5","1415","5","851","66.906712000","0.0089","1276643.74","767790.68"
"41.177.211.185","14785","244.3.160.239","80","10","2206","5","1340","5","866","190.399195000","0.0088","1214868.54","785131.46"
"244.3.160.239","62652","244.3.31.75","80","11","1600","6","1046","5","554","211.793656000","0.0088","951233.38","503808.12"
"41.177.192.117","3772","244.3.160.239","80","10","2072","5","1206","5","866","161.126902000","0.0088","1098485.71","788796.54"
"244.3.3.145","7137","244.3.160.239","80","12","2885","6","1013","6","1872","202.372523000","0.0088","922691.56","1705112.15"
"244.3.31.108","10709","244.3.160.239","80","11","1611","6","588","5","1023","170.874251000","0.0088","535641.08","931906.17"
"244.3.160.239","62732","197.154.128.197","80","10","2104","6","1499","4","605","224.958909000","0.0087","1372710.62","554029.30"
"41.177.34.163","5692","244.3.160.239","80","10","2284","5","1421","5","863","113.057318000","0.0087","1313612.20","797781.37"
"244.3.160.239","61339","244.3.31.75","80","11","1600","6","1046","5","554","10.444137000","0.0086","968518.52","512962.96"
"244.3.160.239","62670","197.154.128.197","80","10","2097","6","1492","4","605","213.623184000","0.0086","1384526.16","561419.79"
"244.3.3.145","11302","244.3.160.239","80","10","1774","5","912","5","862","202.239900000","0.0086","848964.39","802420.29"
"244.3.31.108","5998","244.3.160.239","80","11","1611","6","588","5","1023","85.220431000","0.0086","548315.65","953957.34"
"244.3.160.239","62121","244.3.31.75","80","11","1788","6","1168","5","620","114.424595000","0.0086","1090951.55","579100.99"
"41.177.199.139","2895","244.3.160.239","80","12","3258","6","1220","6","2038","57.724527000","0.0085","1145002.35","1912717.03"
"244.3.160.239","62568","244.3.31.75","80","11","1600","6","1046","5","554","200.653786000","0.0085","983198.21","520737.87"
"244.3.160.248","48235","41.177.26.193","80","17","5603","8","2156","9","3447","107.273651000","0.0085","2027506.76","3241565.77"
"41.177.34.163","7826","244.3.160.239","80","10","2296","5","1425","5","871","68.032185000","0.0085","1343864.20","821407.52"
"244.3.181.123","12126","244.3.160.239","80","10","1796","5","1379","5","417","133.530662000","0.0085","1302633.13","393907.19"
"244.3.160.248","49989","41.177.26.193","80","17","5603","8","2156","9","3447","223.654811000","0.0084","2041666.67","3264204.55"
"244.3.164.46","10705","244.3.160.239","80","12","2932","6","1850","6","1082","139.777661000","0.0084","1759600.52","1029128.52"
"244.3.31.108","5040","244.3.160.239","80","11","1611","6","588","5","1023","187.760427000","0.0084","561135.63","976261.48"
"244.3.31.108","5502","244.3.160.239","80","11","1611","6","588","5","1023","46.595795000","0.0083","564096.41","981412.64"
"244.3.160.248","47914","41.177.26.193","80","16","3506","8","2131","8","1375","72.406624000","0.0083","2045841.83","1320052.80"
"41.177.34.163","5235","244.3.160.239","80","10","2260","5","1413","5","847","67.095412000","0.0083","1364064.20","817666.22"
"41.177.34.163","11966","244.3.160.239","80","10","2266","5","1415","5","851","66.967400000","0.0082","1373786.41","826213.59"
"41.177.98.121","6389","244.3.47.145","4507","10","1007","5","408","5","599","14.873615000","0.0082","397176.93","583110.25"
"41.177.34.163","5433","244.3.160.239","80","10","2263","5","1414","5","849","112.192738000","0.0082","1379343.98","828191.68"
"244.3.3.145","7651","244.3.160.239","80","10","2036","5","963","5","1073","203.455261000","0.0082","939856.04","1047212.39"
"244.3.181.123","12726","244.3.160.239","80","10","1801","5","1335","5","466","133.745615000","0.0082","1307061.56","456247.71"
"41.177.34.163","9912","244.3.160.239","80","10","2263","5","1414","5","849","66.428609000","0.0081","1391732.28","835629.92"
"41.177.199.139","16309","244.3.160.239","80","10","1736","5","1154","5","582","57.968740000","0.0081","1145125.28","577524.19"
"41.177.211.185","14410","244.3.160.239","80","12","3343","6","1305","6","2038","160.076165000","0.0081","1295606.85","2023330.85"
"253.37.253.43","54759","253.160.108.253","20","3","192","3","192","0","0","121.534677000","0.0080","191354.18","N/A"
"244.3.160.248","50028","41.177.26.193","80","16","4128","8","2138","8","1990","234.265831000","0.0080","2145509.28","1996989.46"
"244.3.160.239","61615","41.177.230.67","80","11","2792","6","1549","5","1243","55.502270000","0.0079","1559330.56","1251289.79"
"41.177.34.163","11024","244.3.160.239","80","10","2263","5","1414","5","849","66.628426000","0.0079","1425403.23","855846.77"
"244.3.160.239","61868","244.3.31.75","80","13","3167","7","1089","6","2078","88.636863000","0.0079","1098751.42","2096607.39"
"244.3.160.248","49995","41.177.26.193","80","15","3705","8","2127","7","1578","223.838657000","0.0079","2147942.44","1593536.99"
"244.3.160.239","61423","244.3.31.75","80","11","1728","6","1103","5","625","28.455393000","0.0079","1118661.26","633874.24"
"244.3.31.108","16355","244.3.160.239","80","11","1611","6","588","5","1023","98.326725000","0.0079","596651.45","1038051.75"
"41.177.199.139","9507","244.3.160.239","80","10","2466","5","1416","5","1050","56.366821000","0.0078","1450819.67","1075819.67"
"244.3.213.210","5075","244.3.160.239","80","10","1997","5","1441","5","556","27.866278000","0.0078","1478707.03","570549.00"
"244.3.160.248","49986","41.177.26.193","80","27","16426","12","2394","15","14032","223.524832000","0.0077","2478260.87","14525879.92"
"244.3.160.239","62108","244.3.31.75","80","11","2586","6","1375","5","1211","113.617235000","0.0077","1423763.91","1253947.71"
"41.177.34.163","6606","244.3.160.239","80","10","2263","5","1414","5","849","66.560475000","0.0077","1469854.47","882536.38"
"244.3.160.239","62482","244.3.31.75","80","14","4861","7","1296","7","3565","177.707474000","0.0077","1348595.21","3709677.42"
"244.3.181.123","12080","244.3.160.239","80","10","1902","5","1320","5","582","115.411820000","0.0077","1373926.62","605776.74"
"244.3.160.239","61425","244.3.31.75","80","11","1600","6","1046","5","554","28.785503000","0.0076","1096148.81","580560.65"
"244.3.181.123","14638","244.3.160.239","80","10","1789","5","1323","5","466","133.523513000","0.0076","1387155.96","488597.64"
"244.3.31.108","6810","244.3.160.239","80","11","1638","6","615","5","1023","46.605017000","0.0076","645754.04","1074156.71"
"244.3.160.248","49996","41.177.26.193","80","16","3799","8","2124","8","1675","223.839076000","0.0076","2232558.14","1760609.64"
"41.177.34.163","5580","244.3.160.239","80","10","2260","5","1413","5","847","67.195827000","0.0076","1485413.93","890407.36"
"244.3.160.239","62053","244.3.31.75","80","11","1600","6","1046","5","554","110.095839000","0.0076","1101342.46","583311.40"
"244.3.160.248","47900","41.177.26.193","80","15","3772","8","2127","7","1645","71.833184000","0.0076","2246040.13","1737064.41"
"244.3.160.239","61404","244.3.31.75","80","11","2038","6","1413","5","625","25.615548000","0.0076","1493262.88","660501.98"
"244.3.213.210","8505","244.3.160.239","80","10","1984","5","1428","5","556","27.886308000","0.0076","1512311.36","588827.11"
"244.3.213.210","3046","244.3.160.239","80","10","1986","5","1430","5","556","27.876302000","0.0075","1516235.92","589529.49"
"244.3.160.239","62397","41.177.254.197","80","10","1804","6","1158","4","646","161.183246000","0.0075","1232242.62","687416.87"
"244.3.160.248","47913","41.177.26.193","80","15","3735","8","2124","7","1611","72.405860000","0.0075","2263487.41","1716797.66"
"244.3.160.239","62483","244.3.31.75","80","11","2465","6","1227","5","1238","177.725405000","0.0075","1309149.11","1320885.57"
"151.77.185.176","3392","244.3.160.239","80","11","2214","6","1307","5","907","37.624788000","0.0074","1403866.81","974221.27"
"41.177.211.185","9844","244.3.160.239","80","10","2362","5","1436","5","926","158.367557000","0.0074","1548456.67","998517.32"
"41.177.26.214","39532","244.3.160.186","80","15","2715","8","640","7","2075","233.256953000","0.0074","691051.42","2240518.29"
"244.3.160.248","48241","41.177.26.193","80","25","14656","11","2318","14","12338","107.404600000","0.0074","2508318.68","13351007.71"
"244.3.160.239","62398","41.177.254.197","80","10","1997","6","1171","4","826","161.479514000","0.0073","1276120.42","900149.84"
"41.177.34.163","5822","244.3.160.239","80","10","2254","5","1411","5","843","67.585921000","0.0073","1541234.30","920808.30"
"244.3.160.248","47901","41.177.26.193","80","27","16426","12","2394","15","14032","71.846080000","0.0073","2632215.50","15428257.28"
"41.177.34.163","4441","244.3.160.239","80","10","2284","5","1421","5","863","112.996559000","0.0073","1562396.92","948873.01"
"41.177.34.163","4156","244.3.160.239","80","10","2263","5","1414","5","849","112.160695000","0.0073","1557912.13","935408.35"
"41.177.34.163","10186","244.3.160.239","80","10","2284","5","1421","5","863","67.282597000","0.0072","1575388.03","956762.75"
"41.177.199.139","3999","244.3.160.239","80","10","1942","5","1161","5","781","57.978746000","0.0072","1296844.46","872382.02"
"244.3.181.123","10048","244.3.160.239","80","10","1791","5","1325","5","466","133.644240000","0.0072","1480446.93","520670.39"
"244.3.181.123","9784","244.3.160.239","80","10","1787","5","1321","5","466","133.734086000","0.0071","1482187.94","522861.15"
"244.3.181.123","15598","244.3.160.239","80","10","1806","5","1340","5","466","133.772569000","0.0071","1505406.54","523521.98"
"244.3.160.239","61488","244.3.31.75","80","11","1600","6","1046","5","554","38.995807000","0.0071","1175611.13","622646.81"
"244.3.160.248","49997","41.177.26.193","80","16","3506","8","2131","8","1375","223.839204000","0.0071","2396401.46","1546246.84"
"244.3.160.248","47911","41.177.26.193","80","15","3705","8","2127","7","1578","72.405206000","0.0071","2397632.80","1778779.77"
"244.3.160.239","61486","197.154.128.197","80","12","3325","7","1274","5","2051","38.965597000","0.0071","1437923.25","2314898.42"
"244.3.160.239","61633","244.3.31.75","80","11","2254","6","1118","5","1136","57.956558000","0.0071","1268112.86","1288529.70"
"41.177.26.214","39503","244.3.160.186","80","15","2715","8","640","7","2075","80.821106000","0.0070","728203.67","2360972.83"
"244.3.160.239","61384","244.3.31.75","80","11","1600","6","1046","5","554","22.735720000","0.0070","1191343.96","630979.50"
"41.177.34.163","13450","244.3.160.239","80","10","2254","5","1411","5","843","67.652841000","0.0070","1613262.83","963841.65"
"244.3.181.123","3923","244.3.160.239","80","10","1789","5","1323","5","466","133.691019000","0.0070","1515246.96","533715.10"
"41.177.34.163","8048","244.3.160.239","80","10","2263","5","1414","5","849","112.028814000","0.0070","1625754.53","976142.57"
"244.3.160.248","49311","41.177.26.193","80","19","6867","9","2200","10","4667","170.505933000","0.0069","2532374.10","5372086.33"
"41.177.34.163","8288","244.3.160.239","80","10","2419","5","1532","5","887","130.819325000","0.0069","1764214.77","1021448.11"
"41.177.34.163","4181","244.3.160.239","80","10","2296","5","1425","5","871","114.015278000","0.0069","1641232.36","1003167.29"
"41.177.34.163","15715","244.3.160.239","80","10","2254","5","1411","5","843","113.400754000","0.0069","1626747.37","971897.97"
"41.177.34.163","9869","244.3.160.239","80","10","2266","5","1415","5","851","112.426521000","0.0069","1632535.33","981828.67"
"244.3.160.239","61510","244.3.31.75","80","11","1600","6","1046","5","554","44.155925000","0.0069","1207329.39","639445.97"
"41.177.34.163","15755","244.3.160.239","80","10","2254","5","1411","5","843","113.332372000","0.0069","1628625.02","973019.77"
"244.3.160.248","48245","41.177.26.193","80","15","3442","8","2131","7","1311","107.456220000","0.0069","2474310.60","1522206.10"
"253.37.253.43","54753","253.160.108.253","20","3","192","3","192","0","0","119.709381000","0.0069","223190.93","N/A"
"41.177.34.163","10052","244.3.160.239","80","10","2263","5","1414","5","849","66.654832000","0.0069","1647538.60","989222.25"
"244.3.160.248","49313","41.177.26.193","80","15","3705","8","2127","7","1578","170.596882000","0.0069","2481189.85","1840769.90"
"244.3.160.248","48242","41.177.26.193","80","15","3735","8","2124","7","1611","107.454628000","0.0068","2484210.53","1884210.53"
"244.3.31.108","15767","244.3.160.239","80","11","1638","6","615","5","1023","187.769738000","0.0068","722148.83","1201232.94"
"41.177.43.16","49174","244.3.41.84","23","6","429","3","213","3","216","32.470813000","0.0068","250994.26","254529.39"
"253.37.253.43","54756","253.160.108.253","20","3","192","3","192","0","0","120.609368000","0.0068","226448.47","N/A"
"41.177.34.163","8562","244.3.160.239","80","10","2419","5","1532","5","887","208.939349000","0.0068","1809537.87","1047689.35"
"244.3.181.123","7465","244.3.160.239","80","10","1797","5","1331","5","466","133.707200000","0.0068","1573053.63","550746.05"
"41.177.34.163","2306","244.3.160.239","80","10","2254","5","1411","5","843","67.504911000","0.0067","1672544.08","999259.15"
"244.3.160.248","49994","41.177.26.193","80","25","14656","11","2318","14","12338","223.788455000","0.0067","2748888.23","14631485.32"
"41.177.34.163","13279","244.3.160.239","80","10","2254","5","1411","5","843","113.786301000","0.0067","1674280.63","1000296.65"
"41.177.34.163","12412","244.3.160.239","80","10","2266","5","1415","5","851","112.386426000","0.0067","1679276.07","1009939.18"
"41.177.34.163","6653","244.3.160.239","80","10","2260","5","1413","5","847","112.567880000","0.0067","1680392.45","1007284.08"
"244.3.181.123","12254","244.3.160.239","80","10","1787","5","1321","5","466","133.722034000","0.0067","1572385.06","554679.36"
"253.37.253.43","54757","253.160.108.253","20","3","192","3","192","0","0","120.910957000","0.0067","228775.69","N/A"
"41.177.34.163","13068","244.3.160.239","80","10","2284","5","1421","5","863","112.941235000","0.0067","1693682.96","1028605.48"
"41.177.34.163","13643","244.3.160.239","80","10","2260","5","1413","5","847","112.895513000","0.0067","1688172.04","1011947.43"
"244.3.160.239","61768","197.154.128.197","80","10","1618","6","1171","4","447","74.382064000","0.0067","1403866.33","535890.90"
"244.3.160.239","61642","244.3.31.75","80","13","3611","7","1192","6","2419","58.150053000","0.0067","1430328.48","2902654.87"
"244.3.31.108","11060","244.3.160.239","80","11","1611","6","588","5","1023","117.778739000","0.0066","708220.42","1232158.99"
"41.177.34.163","2427","244.3.160.239","80","10","2419","5","1532","5","887","130.654149000","0.0066","1848567.12","1070286.58"
"244.3.160.239","62085","244.3.31.75","80","11","1770","6","1145","5","625","111.966146000","0.0066","1384103.96","755515.26"
"244.3.160.248","48244","41.177.26.193","80","15","3705","8","2127","7","1578","107.455860000","0.0066","2576230.13","1911279.33"
"41.177.34.163","2933","244.3.160.239","80","10","2419","5","1532","5","887","208.799497000","0.0066","1857532.59","1075477.42"
"41.177.34.163","15040","244.3.160.239","80","10","2260","5","1413","5","847","112.660652000","0.0066","1714545.73","1027756.71"
"253.37.253.43","54752","253.160.108.253","20","3","192","3","192","0","0","119.462434000","0.0066","233151.18","N/A"
"253.37.253.43","54733","253.160.108.253","20","3","192","3","192","0","0","88.781743000","0.0066","233718.81","N/A"
"41.177.34.163","10865","244.3.160.239","80","10","2296","5","1425","5","871","113.951850000","0.0065","1755466.58","1072990.45"
"41.177.34.163","16255","244.3.160.239","80","10","2284","5","1421","5","863","67.397541000","0.0065","1750808.56","1063298.94"
"244.3.160.239","62369","244.3.31.75","80","11","2333","6","1197","5","1136","160.276917000","0.0065","1478005.87","1402685.60"
"244.3.160.239","61822","197.154.128.197","80","10","1607","6","1160","4","447","78.907431000","0.0065","1433204.63","552277.99"
"41.177.34.163","11338","244.3.160.239","80","10","2260","5","1413","5","847","67.163552000","0.0065","1746061.17","1046648.13"
"41.177.34.163","5096","244.3.160.239","80","10","2263","5","1414","5","849","112.042270000","0.0065","1747296.88","1049119.56"
"41.177.34.163","9363","244.3.160.239","80","10","2284","5","1421","5","863","113.225119000","0.0064","1764395.47","1071550.52"
"244.3.160.239","61827","197.154.128.197","80","13","5797","7","1181","6","4616","79.042010000","0.0064","1468677.13","5740401.06"
"41.177.26.214","39511","244.3.160.186","80","15","2715","8","640","7","2075","117.763344000","0.0064","796267.50","2581648.52"
"41.177.34.163","12209","244.3.160.239","80","10","2266","5","1415","5","851","112.273955000","0.0064","1764064.20","1060931.90"
"41.177.34.163","15313","244.3.160.239","80","10","2296","5","1425","5","871","114.080765000","0.0064","1779581.64","1087730.25"
"41.177.34.163","2403","244.3.160.239","80","10","2284","5","1421","5","863","113.110419000","0.0064","1779586.73","1080776.46"
"253.37.253.43","54765","253.160.108.253","20","3","192","3","192","0","0","123.313975000","0.0064","240450.85","N/A"
"244.3.160.239","61823","197.154.128.197","80","10","1609","6","1163","4","446","78.907502000","0.0064","1458307.21","559247.65"
"41.177.34.163","6492","244.3.160.239","80","10","2260","5","1413","5","847","66.539736000","0.0064","1772342.43","1062402.01"
"244.3.77.177","2352","244.3.31.168","443","14","2098","7","1242","7","856","51.800869000","0.0064","1558099.42","1073859.18"
"253.37.253.43","54755","253.160.108.253","20","3","192","3","192","0","0","120.314885000","0.0064","241471.47","N/A"
"253.37.253.43","54731","253.160.108.253","20","3","192","3","192","0","0","88.194299000","0.0064","241509.43","N/A"
"253.37.253.43","54762","253.160.108.253","20","3","192","3","192","0","0","122.412445000","0.0063","242462.51","N/A"
"244.3.160.248","50014","41.177.26.193","80","19","8300","9","2205","10","6095","231.571420000","0.0063","2789373.81","7710309.93"
"253.37.253.43","54736","253.160.108.253","20","3","192","3","192","0","0","101.792135000","0.0063","242922.66","N/A"
"244.3.160.239","62486","244.3.31.75","80","11","2257","6","1252","5","1005","177.897398000","0.0063","1584058.20","1271548.32"
"244.3.160.248","49750","41.177.26.193","80","25","14686","11","2348","14","12338","201.429160000","0.0063","2974034.20","15627612.41"
"253.37.253.43","54754","253.160.108.253","20","3","192","3","192","0","0","120.009275000","0.0063","243770.83","N/A"
"253.37.253.43","54758","253.160.108.253","20","3","192","3","192","0","0","121.210981000","0.0063","244430.30","N/A"
"41.177.211.185","8376","244.3.160.239","80","10","2021","5","1240","5","781","160.295472000","0.0063","1580624.60","995538.56"
"41.177.3.203","58773","41.177.3.184","657","21","3092","11","1638","10","1454","139.168140000","0.0063","2091954.02","1856960.41"
"244.3.160.248","49315","41.177.26.193","80","16","3799","8","2124","8","1675","170.598567000","0.0063","2717850.29","2143314.14"
"41.177.26.214","39506","244.3.160.186","80","15","2715","8","640","7","2075","88.215189000","0.0062","820381.35","2659830.16"
"253.37.253.43","54764","253.160.108.253","20","3","192","3","192","0","0","123.011469000","0.0062","246905.64","N/A"
"244.3.160.239","62658","244.3.31.75","80","11","1661","6","1036","5","625","212.256215000","0.0062","1332475.88","803858.52"
"41.177.34.163","5424","244.3.160.239","80","10","2419","5","1532","5","887","208.705983000","0.0062","1978689.05","1145624.80"
"253.37.253.43","54732","253.160.108.253","20","3","192","3","192","0","0","88.482591000","0.0062","248062.02","N/A"
"244.3.160.239","61455","244.3.31.75","80","11","1694","6","1072","5","622","32.590809000","0.0062","1385908.21","804137.04"
"41.177.34.163","5426","244.3.160.239","80","10","2263","5","1414","5","849","111.953209000","0.0062","1829236.74","1098318.24"
"244.3.160.239","62673","244.3.31.75","80","11","1679","6","1059","5","620","213.736515000","0.0062","1371983.81","803238.87"
"244.3.160.239","62206","244.3.31.75","80","11","2031","6","1411","5","620","123.276598000","0.0062","1834850.46","806241.87"
"41.177.34.163","7750","244.3.160.239","80","10","2284","5","1421","5","863","67.425701000","0.0061","1848455.28","1122601.63"
"41.177.34.163","10291","244.3.160.239","80","10","2260","5","1413","5","847","66.578578000","0.0061","1839245.04","1102505.69"
"244.3.77.177","2356","244.3.31.168","443","14","2099","7","1243","7","856","172.114620000","0.0061","1618489.58","1114583.33"
"151.77.217.75","7708","244.3.160.239","80","11","2620","6","1325","5","1295","93.186902000","0.0061","1728354.80","1689222.24"
"41.177.34.163","7059","244.3.160.239","80","10","2260","5","1413","5","847","66.721359000","0.0061","1843744.90","1105203.07"
"244.3.77.177","2355","244.3.31.168","443","14","2098","7","1242","7","856","172.101007000","0.0061","1620880.91","1117128.87"
"244.3.77.177","2353","244.3.31.168","443","14","2099","7","1243","7","856","51.994808000","0.0061","1622980.25","1117675.86"
"244.3.31.108","12928","244.3.160.239","80","11","1638","6","615","5","1023","43.659036000","0.0061","805237.32","1339443.54"
"244.3.160.239","62515","197.154.128.197","80","10","2105","6","1500","4","605","190.391891000","0.0061","1969149.98","794223.83"
"41.177.34.163","5259","244.3.160.239","80","10","2263","5","1414","5","849","66.522236000","0.0061","1859608.75","1116554.33"
"145.95.48.20","49184","244.3.31.46","993","9","884","6","531","3","353","30.397497000","0.0061","701221.53","466160.45"
"41.177.34.163","16240","244.3.160.239","80","10","2419","5","1532","5","887","131.215636000","0.0061","2025115.66","1172504.96"
"41.177.34.163","5405","244.3.160.239","80","10","2263","5","1414","5","849","112.060005000","0.0060","1870370.37","1123015.87"
"244.3.160.239","62196","244.3.31.75","80","11","2020","6","1398","5","622","122.266700000","0.0060","1851042.70","823568.35"
"41.177.34.163","11587","244.3.160.239","80","10","2254","5","1411","5","843","113.269993000","0.0060","1870112.66","1117296.22"
"41.177.34.163","2405","244.3.160.239","80","10","2296","5","1425","5","871","68.003311000","0.0060","1889607.16","1154980.94"
"41.177.34.163","11519","244.3.160.239","80","10","2263","5","1414","5","849","66.394842000","0.0060","1881883.21","1129928.46"
"244.3.160.248","50022","41.177.26.193","80","19","6880","9","2213","10","4667","233.438098000","0.0060","2957567.66","6237220.18"
"41.177.3.224","52713","41.177.3.184","657","21","3092","11","1638","10","1454","65.378016000","0.0060","2195342.60","1948735.13"
"41.177.98.121","6389","244.3.47.239","4033","10","2167","5","1508","5","659","178.889020000","0.0060","2023821.51","884415.37"
"41.177.34.163","2511","244.3.160.239","80","10","2419","5","1532","5","887","209.029514000","0.0060","2057411.45","1191203.63"
"41.177.34.163","15933","244.3.160.239","80","10","2266","5","1415","5","851","112.338542000","0.0060","1900604.43","1143049.03"
"244.3.160.248","47909","41.177.26.193","80","19","6867","9","2200","10","4667","72.315281000","0.0060","2956989.25","6272849.46"
"244.3.31.108","5617","244.3.160.239","80","11","1638","6","615","5","1023","85.229998000","0.0059","832769.13","1385240.35"
"41.177.34.163","14767","244.3.160.239","80","10","2296","5","1425","5","871","67.868313000","0.0059","1930567.32","1180016.93"
"41.177.34.163","2939","244.3.160.239","80","10","2260","5","1413","5","847","66.658997000","0.0059","1921795.31","1151989.12"
"244.3.160.239","61456","244.3.31.75","80","11","1705","6","1085","5","620","32.594701000","0.0059","1476944.02","843968.01"
"41.177.34.163","7692","244.3.160.239","80","10","2263","5","1414","5","849","112.129385000","0.0059","1930375.43","1159044.37"
"41.177.211.185","3964","244.3.160.239","80","10","1815","5","1233","5","582","160.287872000","0.0058","1698639.57","801790.94"
"41.177.34.163","2244","244.3.160.239","80","10","2419","5","1532","5","887","208.750913000","0.0058","2112739.18","1223237.37"
"244.3.160.248","49985","41.177.26.193","80","16","3836","8","2127","8","1709","223.524518000","0.0058","2939875.60","2362128.54"
"41.177.34.163","14631","244.3.160.239","80","10","2263","5","1414","5","849","66.696527000","0.0058","1955401.90","1174070.87"
"244.3.160.239","61786","197.154.128.197","80","10","1609","6","1163","4","446","77.268024000","0.0058","1609131.79","617087.51"
"41.177.34.163","15018","244.3.160.239","80","10","2254","5","1411","5","843","67.768653000","0.0057","1965865.55","1174503.66"
"41.177.34.163","6039","244.3.160.239","80","10","2284","5","1421","5","863","113.163565000","0.0057","1984290.45","1205096.88"
"244.3.31.108","7589","244.3.160.239","80","11","1638","6","615","5","1023","98.335494000","0.0057","862401.40","1434531.11"
"244.3.31.108","6674","244.3.160.239","80","11","1638","6","615","5","1023","117.786284000","0.0057","864674.87","1438312.83"
"41.177.34.163","10528","244.3.160.239","80","10","2254","5","1411","5","843","67.682384000","0.0057","1985576.08","1186279.68"
"244.3.160.239","62235","244.3.31.108","80","11","1751","6","1324","5","427","133.542570000","0.0057","1869726.39","603000.88"
"244.3.160.248","49314","41.177.26.193","80","16","3506","8","2131","8","1375","170.597315000","0.0057","3014677.28","1945181.26"
"41.177.34.163","10665","244.3.160.239","80","10","2260","5","1413","5","847","66.448930000","0.0057","1999646.21","1198655.58"
"244.3.31.108","12906","244.3.160.239","80","11","1638","6","615","5","1023","170.883850000","0.0056","871567.76","1449778.57"
"41.177.211.185","4037","244.3.160.239","80","10","1847","5","1289","5","558","189.116738000","0.0056","1831941.73","793036.06"
"244.3.160.239","61798","197.154.128.197","80","10","1604","6","1157","4","447","78.325590000","0.0056","1644926.25","635507.38"
"244.3.160.248","50015","41.177.26.193","80","16","3275","8","2140","8","1135","231.711704000","0.0056","3059328.09","1622587.56"
"41.177.34.163","2329","244.3.160.239","80","10","2263","5","1414","5","849","111.910562000","0.0056","2023251.65","1214809.52"
"41.177.34.163","2698","244.3.160.239","80","10","2254","5","1411","5","843","67.794868000","0.0056","2025843.50","1210337.40"
"41.177.34.163","4768","244.3.160.239","80","10","2266","5","1415","5","851","66.939375000","0.0055","2042215.41","1228215.77"
"41.177.34.163","11496","244.3.160.239","80","10","2254","5","1411","5","843","113.303281000","0.0055","2048267.10","1223734.35"
"41.177.34.163","16087","244.3.160.239","80","10","2260","5","1413","5","847","112.737600000","0.0055","2054525.63","1231552.16"
"41.177.34.163","11385","244.3.160.239","80","10","2260","5","1413","5","847","112.157647000","0.0055","2070708.92","1241252.98"
"244.3.160.248","50026","41.177.26.193","80","14","2893","7","2068","7","825","233.777877000","0.0054","3037825.93","1211898.64"
"145.95.48.20","49191","244.3.31.46","993","9","884","6","531","3","353","30.407172000","0.0054","782752.90","520361.16"
"41.177.34.163","9951","244.3.160.239","80","10","2263","5","1414","5","849","111.988625000","0.0054","2090556.27","1255220.85"
"244.3.160.239","62245","244.3.31.108","80","11","1752","6","1327","5","425","133.768747000","0.0054","1963743.99","628930.82"
"41.177.34.163","14141","244.3.160.239","80","10","2254","5","1411","5","843","67.616583000","0.0054","2092695.59","1250278.09"
"41.177.34.163","12846","244.3.160.239","80","10","2263","5","1414","5","849","66.584456000","0.0054","2102211.48","1262218.92"
"41.177.34.163","13004","244.3.160.239","80","10","2263","5","1414","5","849","66.593757000","0.0054","2102602.23","1262453.53"
"41.177.34.163","11300","244.3.160.239","80","10","2260","5","1413","5","847","112.776193000","0.0054","2102678.57","1260416.67"
"41.177.34.163","2807","244.3.160.239","80","10","2296","5","1425","5","871","114.054331000","0.0054","2124883.50","1298788.44"
"41.177.34.163","14798","244.3.160.239","80","10","2254","5","1411","5","843","113.822438000","0.0053","2116235.47","1264341.96"
"41.177.34.163","15557","244.3.160.239","80","10","2296","5","1425","5","871","113.924817000","0.0053","2141247.18","1308790.38"
"41.177.34.163","10124","244.3.160.239","80","10","2284","5","1421","5","863","67.340668000","0.0053","2138852.30","1298965.19"
"41.177.34.163","2185","244.3.160.239","80","10","2254","5","1411","5","843","113.432626000","0.0053","2124600.04","1269339.36"
"41.177.34.163","15436","244.3.160.239","80","10","2254","5","1411","5","843","67.711265000","0.0053","2132628.00","1274135.65"
"41.177.34.163","2320","244.3.160.239","80","10","2254","5","1411","5","843","67.472243000","0.0053","2137878.79","1277272.73"
"244.3.160.239","61992","244.3.31.75","80","11","2026","6","1189","5","837","104.947994000","0.0053","1803564.66","1269624.57"
"244.3.160.239","62209","244.3.31.75","80","11","2022","6","1400","5","622","123.698079000","0.0053","2126447.69","944750.33"
"41.177.34.163","2704","244.3.160.239","80","10","2260","5","1413","5","847","111.973698000","0.0053","2150275.82","1288948.07"
"41.177.34.163","11206","244.3.160.239","80","10","2296","5","1425","5","871","113.983725000","0.0053","2169362.51","1325975.26"
"41.177.34.163","15047","244.3.160.239","80","10","2296","5","1425","5","871","67.912765000","0.0052","2173498.57","1328503.34"
"244.3.160.239","61954","244.3.31.75","80","11","1600","6","1046","5","554","102.457626000","0.0052","1601837.67","848392.04"
"244.3.160.239","61373","244.3.31.75","80","11","1600","6","1046","5","554","18.777815000","0.0052","1603065.13","849042.15"
"41.177.34.163","13093","244.3.160.239","80","10","2419","5","1532","5","887","208.837243000","0.0052","2369224.82","1371737.87"
"41.177.34.163","9577","244.3.160.239","80","10","2260","5","1413","5","847","67.068044000","0.0052","2185192.34","1309878.21"
"244.3.160.239","62116","244.3.31.75","80","11","1777","6","1155","5","622","114.200063000","0.0052","1787234.04","962475.82"
"41.177.3.224","9401","244.3.41.117","4431","9","822","4","378","5","444","183.011232000","0.0052","585026.12","687173.53"
"41.177.34.163","7139","244.3.160.239","80","10","2284","5","1421","5","863","67.368018000","0.0052","2202247.19","1337466.10"
"244.3.210.197","3538","68.83.160.23","1984","2","142","1","78","1","64","193.336762000","0.0052","N/A","N/A"
"41.177.34.163","7668","244.3.160.239","80","10","2266","5","1415","5","851","66.846892000","0.0051","2200622.08","1323483.67"
"41.177.34.163","6378","244.3.160.239","80","10","2266","5","1415","5","851","66.998087000","0.0051","2201049.97","1323741.01"
"244.3.31.108","8602","244.3.160.239","80","11","1468","6","571","5","897","170.867491000","0.0051","889754.58","1397740.55"
"41.177.34.163","11221","244.3.160.239","80","10","2263","5","1414","5","849","111.954198000","0.0051","2205928.24","1324492.98"
"41.177.34.163","13951","244.3.160.239","80","10","2266","5","1415","5","851","66.874005000","0.0051","2239810.05","1347051.84"
"41.177.34.163","6608","244.3.160.239","80","10","2254","5","1411","5","843","67.742196000","0.0051","2233920.44","1334652.68"
"41.177.34.163","6006","244.3.160.239","80","10","2296","5","1425","5","871","67.938993000","0.0050","2257425.74","1379801.98"
"244.3.160.239","61457","244.3.31.75","80","11","1696","6","1074","5","622","32.597840000","0.0050","1703409.99","986518.64"
"41.177.34.163","11048","244.3.160.239","80","10","2260","5","1413","5","847","112.049470000","0.0050","2243302.24","1344711.25"
"41.177.34.163","8395","244.3.160.239","80","10","2254","5","1411","5","843","67.559844000","0.0050","2263485.06","1352316.02"
"41.177.34.163","14093","244.3.160.239","80","10","2260","5","1413","5","847","67.037885000","0.0050","2268512.94","1359823.40"
"41.177.34.163","13808","244.3.160.239","80","10","2254","5","1411","5","843","67.534875000","0.0050","2276265.38","1359951.60"
"41.177.98.121","6389","244.3.47.145","4693","10","1007","5","408","5","599","209.918689000","0.0049","666122.45","977959.18"
"244.3.160.239","62682","244.3.31.75","80","11","1600","6","1046","5","554","215.277365000","0.0049","1717569.79","909688.01"
"41.177.34.163","13652","244.3.160.239","80","10","2263","5","1414","5","849","66.555966000","0.0048","2352256.19","1412351.84"
"41.177.3.224","9401","244.3.41.117","4368","9","822","4","378","5","444","53.072240000","0.0047","642038.22","754140.13"
"41.177.34.163","7574","244.3.160.239","80","10","2263","5","1414","5","849","66.667471000","0.0047","2402208.54","1442344.45"
"244.3.160.239","62234","244.3.31.108","80","11","1745","6","1319","5","426","133.533977000","0.0047","2247976.14","726033.23"
"244.3.160.239","62517","244.3.31.75","80","11","1600","6","1046","5","554","190.647744000","0.0046","1814397.22","960971.38"
"244.3.153.25","50807","244.3.160.80","443","4","3688","1","64","3","3624","18.616105000","0.0045","N/A","6481556.00"
"244.3.160.239","61797","197.154.128.197","80","10","1614","6","1167","4","447","78.291506000","0.0043","2146700.39","822257.99"
"244.3.160.239","62629","244.3.31.75","80","11","1600","6","1046","5","554","207.948379000","0.0042","1974516.28","1045776.31"
"244.3.160.239","61821","197.154.128.197","80","10","1601","6","1154","4","447","78.838689000","0.0042","2178386.03","843794.24"
"244.3.160.239","61257","244.3.31.75","80","11","1600","6","1046","5","554","1.709385000","0.0042","2011538.46","1065384.62"
"244.3.160.239","61451","244.3.31.75","80","11","1552","6","998","5","554","31.668877000","0.0039","2060918.95","1144037.17"
"244.3.160.239","61826","197.154.128.197","80","10","1596","6","1152","4","444","79.010316000","0.0038","2420803.78","933018.12"
"41.177.98.252","12181","244.3.160.239","80","6","1273","4","1139","2","134","24.879107000","0.0038","2411219.90","283672.93"
"244.3.160.239","62122","244.3.31.75","80","11","1779","6","1157","5","622","114.499298000","0.0038","2459086.08","1321997.87"
"244.3.160.239","61794","197.154.128.197","80","10","1610","6","1164","4","446","78.164217000","0.0038","2474621.31","948179.64"
"244.3.31.108","5356","244.3.160.239","80","11","1468","6","571","5","897","85.214573000","0.0037","1219108.62","1915132.11"
"244.3.160.239","61796","197.154.128.197","80","10","1601","6","1154","4","447","78.290901000","0.0037","2467789.36","955894.15"
"244.3.160.239","61399","197.154.128.197","80","10","2105","6","1500","4","605","24.985660000","0.0037","3241491.09","1307401.40"
"41.177.199.139","10813","244.3.160.239","80","10","2352","5","1347","5","1005","56.347613000","0.0036","2972689.66","2217931.03"
"41.177.127.194","1372","253.37.253.43","623","2","174","0","0","2","174","121.196374000","0.0036","N/A","386237.51"
"41.177.211.185","4894","244.3.160.239","80","10","2248","5","1367","5","881","158.350084000","0.0035","3080563.38","1985352.11"
"244.3.160.239","62226","244.3.31.75","80","11","1600","6","1046","5","554","129.289526000","0.0034","2426210.50","1285010.15"
"244.3.160.239","61420","244.3.31.75","80","11","2015","6","1395","5","620","27.870031000","0.0034","3238537.43","1439349.97"
"244.3.160.239","61422","244.3.31.75","80","11","2003","6","1382","5","621","27.889928000","0.0034","3283635.28","1475497.48"
"244.3.160.239","62511","244.3.31.75","80","11","1871","6","1246","5","625","189.118889000","0.0033","3036247.33","1522997.26"
"244.3.160.239","61421","244.3.31.75","80","11","2006","6","1384","5","622","27.880062000","0.0033","3382829.21","1520317.75"
"244.3.160.239","61463","244.3.31.75","80","11","1600","6","1046","5","554","33.879732000","0.0033","2559021.41","1355351.68"
"244.3.31.108","14496","244.3.160.239","80","11","1468","6","571","5","897","187.755937000","0.0032","1429733.96","2246009.39"
"244.3.31.108","11460","244.3.160.239","80","11","1468","6","571","5","897","117.774521000","0.0032","1434673.37","2253768.84"
"244.3.34.239","1544","244.3.41.84","23","3","701","1","66","2","635","189.650121000","0.0032","N/A","1602523.66"
"244.3.31.108","6564","244.3.160.239","80","11","1468","6","571","5","897","46.591609000","0.0032","1444198.55","2268732.22"
"244.3.160.239","62212","244.3.31.75","80","11","1600","6","1046","5","554","124.529582000","0.0031","2657351.54","1407430.93"
"244.3.160.239","61824","197.154.128.197","80","10","1599","6","1152","4","447","78.914482000","0.0031","2943468.54","1142127.12"
"244.3.31.108","12678","244.3.160.239","80","11","1468","6","571","5","897","43.645085000","0.0031","1481193.26","2326848.25"
"244.3.31.108","15877","244.3.160.239","80","11","1468","6","571","5","897","98.322610000","0.0029","1559044.37","2449146.76"
"244.3.41.208","1038","244.3.41.176","23","2","128","0","0","2","128","32.459178000","0.0023","N/A","454303.46"
"41.177.3.224","9401","244.3.41.117","4432","9","1006","4","470","5","536","183.016708000","0.0020","1916411.82","2185524.97"
"41.177.3.224","9301","41.177.143.72","3128","9","1006","4","470","5","536","74.378127000","0.0019","1936148.30","2208032.96"
"41.177.3.224","9301","41.177.143.72","3127","9","822","4","378","5","444","74.376315000","0.0019","1577464.79","1852895.15"
"41.177.3.224","9801","244.3.176.149","2389","9","822","4","378","5","444","85.900439000","0.0018","1643478.26","1930434.78"
"41.177.3.224","9801","244.3.176.149","2379","9","822","4","378","5","444","31.979038000","0.0018","1657894.74","1947368.42"
"41.177.3.224","9401","244.3.41.117","4369","9","1006","4","470","5","536","53.077253000","0.0018","2092376.18","2386199.22"
"246.142.244.205","51121","246.142.244.138","22","2","362","1","64","1","298","172.474484000","0.0018","N/A","N/A"
"41.177.3.224","9801","244.3.176.149","2380","9","1006","4","470","5","536","31.980866000","0.0017","2262334.54","2580024.07"
"41.177.3.224","9801","244.3.176.149","2390","9","1006","4","470","5","536","85.902114000","0.0016","2312423.12","2637146.37"
"244.3.153.48","1880","244.3.160.80","443","3","1099","2","1035","1","64","180.155637000","0.0015","5557046.98","N/A"
"244.3.160.239","62770","244.3.31.75","80","5","1128","3","998","2","130","231.361913000","0.0013","6351630.87","827366.75"
"151.239.66.180","57604","41.177.26.176","80","4","889","2","761","2","128","53.560178000","0.0012","5163698.05","868532.65"
"41.177.3.224","9308","244.3.41.117","4102","4","256","2","128","2","128","144.460290000","0.0009","1137777.78","1137777.78"
"41.177.3.224","9509","244.3.41.117","4107","4","256","2","128","2","128","149.272732000","0.0008","1208972.85","1208972.85"
"244.3.153.30","1785","244.3.160.80","443","2","665","1","601","1","64","45.557116000","0.0007","N/A","N/A"
"244.3.155.77","16109","244.3.160.239","80","2","140","1","70","1","70","0.065674000","0.0006","N/A","N/A"
"41.177.98.43","38534","41.177.26.155","8010","8","560","4","280","4","280","1.804141000","0.0006","3848797.25","3848797.25"
"244.3.155.77","16275","244.3.160.239","80","2","140","1","70","1","70","0.065306000","0.0005","N/A","N/A"
"244.3.155.77","12376","244.3.160.239","80","2","140","1","70","1","70","0.064553000","0.0005","N/A","N/A"
"244.3.155.77","7746","244.3.160.239","80","2","140","1","70","1","70","0.064921000","0.0005","N/A","N/A"
"244.3.160.204","24468","244.3.160.239","8080","2","128","1","64","1","64","8.196396000","0.0005","N/A","N/A"
"244.3.160.204","29141","244.3.160.254","4001","2","128","1","64","1","64","36.199406000","0.0005","N/A","N/A"
"244.3.153.40","2344","41.177.3.117","80","2","130","1","66","1","64","173.313868000","0.0005","N/A","N/A"
"244.3.160.204","43185","244.3.160.239","8080","2","128","1","64","1","64","120.219428000","0.0004","N/A","N/A"
"244.3.160.204","48185","244.3.160.89","2785","2","128","1","64","1","64","150.218166000","0.0004","N/A","N/A"
"198.177.110.202","34127","41.177.26.22","80","2","128","1","64","1","64","75.271762000","0.0004","N/A","N/A"
"77.197.128.225","25643","41.177.26.176","80","2","132","1","66","1","66","234.443861000","0.0004","N/A","N/A"
"244.3.160.204","28133","244.3.160.89","2785","2","128","1","64","1","64","30.195873000","0.0004","N/A","N/A"
"41.177.159.151","1699","41.177.26.91","80","2","128","1","64","1","64","198.535992000","0.0004","N/A","N/A"
"244.3.160.204","33490","244.3.160.239","8080","2","128","1","64","1","64","62.205295000","0.0004","N/A","N/A"
"244.3.160.204","34817","244.3.160.89","2785","2","128","1","64","1","64","70.202815000","0.0003","N/A","N/A"
"41.177.241.120","50340","244.3.210.197","80","5","350","3","210","2","140","59.824048000","0.0003","5201238.39","3467492.26"
"244.3.153.34","58035","41.177.3.145","443","3","241","2","177","1","64","21.725317000","0.0003","4438871.47","N/A"
"165.22.155.38","62196","41.177.26.176","80","2","128","1","64","1","64","167.557986000","0.0003","N/A","N/A"
"41.177.241.120","50339","244.3.210.197","80","5","350","3","210","2","140","59.823726000","0.0003","5401929.26","3601286.17"
"41.177.98.98","43420","244.3.31.26","7930","2","128","1","64","1","64","163.925587000","0.0003","N/A","N/A"
"204.22.67.156","59682","41.177.26.176","80","2","140","1","70","1","70","5.459100000","0.0003","N/A","N/A"
"41.177.241.120","50337","244.3.210.197","80","5","350","3","210","2","140","59.823220000","0.0003","5694915.25","3796610.17"
"41.177.244.77","3577","244.3.210.90","445","2","130","1","66","1","64","218.430716000","0.0003","N/A","N/A"
"244.3.160.204","33154","244.3.160.254","4002","2","128","1","64","1","64","60.204490000","0.0003","N/A","N/A"
"41.177.98.98","43364","244.3.31.26","7930","2","128","1","64","1","64","44.743738000","0.0003","N/A","N/A"
"41.177.241.120","50338","244.3.210.197","80","5","350","3","210","2","140","59.823617000","0.0003","6339622.64","4226415.09"
"244.3.160.204","29142","244.3.160.254","4002","2","128","1","64","1","64","36.199681000","0.0003","N/A","N/A"
"244.3.160.204","41174","244.3.160.254","2048","2","128","1","64","1","64","108.217295000","0.0003","N/A","N/A"
"41.177.98.98","43390","47.167.160.79","7030","2","128","1","64","1","64","76.696648000","0.0002","N/A","N/A"
"41.177.98.98","43395","184.4.77.132","7030","2","128","1","64","1","64","82.907170000","0.0002","N/A","N/A"
"244.3.160.204","48186","244.3.160.89","4000","2","128","1","64","1","64","150.218409000","0.0002","N/A","N/A"
"244.3.160.204","41512","244.3.160.254","2048","2","128","1","64","1","64","110.217902000","0.0002","N/A","N/A"
"244.3.160.204","55879","244.3.160.254","2048","2","128","1","64","1","64","196.225965000","0.0002","N/A","N/A"
"90.38.138.177","52820","41.177.98.176","80","2","140","1","70","1","70","53.105334000","0.0002","N/A","N/A"
"244.3.160.204","55205","244.3.160.89","4002","2","128","1","64","1","64","192.223943000","0.0002","N/A","N/A"
"244.3.160.204","34826","244.3.160.254","4001","2","128","1","64","1","64","70.205122000","0.0002","N/A","N/A"
"244.3.160.204","29139","244.3.160.89","2784","2","128","1","64","1","64","36.198942000","0.0002","N/A","N/A"
"244.150.152.117","3634","41.177.26.176","80","2","128","1","64","1","64","9.673507000","0.0002","N/A","N/A"
"244.3.160.204","50857","244.3.160.89","2785","2","128","1","64","1","64","166.219990000","0.0002","N/A","N/A"
"244.3.160.204","55201","244.3.160.89","2784","2","128","1","64","1","64","192.222942000","0.0002","N/A","N/A"
"244.3.160.248","46958","41.177.26.193","80","2","128","1","64","1","64","8.674361000","0.0002","N/A","N/A"
"244.3.160.204","34818","244.3.160.89","4000","2","128","1","64","1","64","70.203002000","0.0002","N/A","N/A"
"244.3.160.204","25800","244.3.160.254","2784","2","128","1","64","1","64","16.196502000","0.0002","N/A","N/A"
"41.177.244.77","3573","244.3.210.90","445","2","130","1","66","1","64","98.444609000","0.0002","N/A","N/A"
"244.3.160.204","46183","244.3.160.89","4000","2","128","1","64","1","64","138.218600000","0.0002","N/A","N/A"
"244.3.160.204","28134","244.3.160.89","4000","2","128","1","64","1","64","30.196128000","0.0002","N/A","N/A"
"244.3.160.204","44183","244.3.160.254","4002","2","128","1","64","1","64","126.219623000","0.0002","N/A","N/A"
"41.177.3.224","40002","41.177.117.184","1607","2","128","1","64","1","64","144.095902000","0.0002","N/A","N/A"
"244.3.160.204","31143","244.3.160.89","4001","2","128","1","64","1","64","48.205836000","0.0002","N/A","N/A"
"203.68.117.241","50074","41.177.26.91","80","2","128","1","64","1","64","115.098353000","0.0002","N/A","N/A"
"41.177.98.98","40298","244.3.31.26","7930","2","128","1","64","1","64","126.298378000","0.0002","N/A","N/A"
"244.3.160.204","46514","244.3.160.89","4001","2","128","1","64","1","64","140.217834000","0.0001","N/A","N/A"
"41.177.230.224","36708","41.177.3.224","113","2","134","1","70","1","64","1.103838000","0.0001","N/A","N/A"
"177.213.85.47","32862","41.177.98.176","80","2","128","1","64","1","64","88.147474000","0.0001","N/A","N/A"
"244.3.160.204","33818","244.3.160.89","2785","2","128","1","64","1","64","64.202520000","0.0001","N/A","N/A"
"66.55.75.213","2123","41.177.26.151","80","2","128","1","64","1","64","68.322430000","0.0001","N/A","N/A"
"244.3.160.204","36158","244.3.160.254","2784","2","128","1","64","1","64","78.205319000","0.0001","N/A","N/A"
"244.3.160.204","29805","244.3.160.89","2784","2","128","1","64","1","64","40.198522000","0.0001","N/A","N/A"
"244.3.160.204","36152","244.3.160.89","2785","2","128","1","64","1","64","78.203766000","0.0001","N/A","N/A"
"41.177.244.77","3577","244.3.210.90","445","2","130","1","66","1","64","211.963010000","0.0001","N/A","N/A"
"244.3.160.204","33824","244.3.160.254","2784","2","128","1","64","1","64","64.204075000","0.0001","N/A","N/A"
"244.3.160.204","23803","244.3.160.239","8080","2","128","1","64","1","64","4.194908000","0.0001","N/A","N/A"
"244.3.160.204","38833","244.3.160.89","2048","2","128","1","64","1","64","94.207831000","0.0001","N/A","N/A"
"244.3.160.204","23129","244.3.160.254","2785","2","128","1","64","1","64","0.193685000","0.0001","N/A","N/A"
"244.3.160.204","60560","244.3.160.254","2784","2","128","1","64","1","64","224.230490000","0.0001","N/A","N/A"
"244.3.160.204","35159","244.3.160.254","4001","2","128","1","64","1","64","72.206079000","0.0001","N/A","N/A"
"244.3.160.204","23128","244.3.160.254","2784","2","128","1","64","1","64","0.193406000","0.0001","N/A","N/A"
"244.3.31.194","58456","41.177.98.220","7030","2","128","1","64","1","64","47.572749000","0.0001","N/A","N/A"
"244.3.160.204","52197","244.3.160.89","2785","2","128","1","64","1","64","174.221314000","0.0001","N/A","N/A"
"244.3.160.204","41504","244.3.160.89","4002","2","128","1","64","1","64","110.215805000","0.0001","N/A","N/A"
"244.3.160.204","28466","244.3.160.89","2785","2","128","1","64","1","64","32.196581000","0.0001","N/A","N/A"
"244.3.160.204","59889","244.3.160.254","4001","2","128","1","64","1","64","220.229329000","0.0001","N/A","N/A"
"41.177.230.224","36707","41.177.3.203","113","2","134","1","70","1","64","1.053978000","0.0001","N/A","N/A"
"244.3.31.98","58474","41.177.98.220","7030","2","128","1","64","1","64","58.473937000","0.0001","N/A","N/A"
"41.177.98.98","40188","244.3.31.41","7730","2","128","1","64","1","64","126.297621000","0.0001","N/A","N/A"
"244.3.160.204","23125","244.3.160.89","4002","2","128","1","64","1","64","0.192573000","0.0001","N/A","N/A"
"244.3.160.204","61889","244.3.160.89","4002","2","128","1","64","1","64","232.230521000","0.0001","N/A","N/A"
"16.176.93.164","11516","244.3.160.239","80","2","140","1","70","1","70","234.400232000","0.0001","N/A","N/A"
"244.3.160.204","54542","244.3.160.254","2048","2","128","1","64","1","64","188.224800000","0.0001","N/A","N/A"
"244.3.160.204","41514","244.3.160.239","8080","2","128","1","64","1","64","110.218427000","0.0001","N/A","N/A"
"244.3.160.204","51858","244.3.160.89","4001","2","128","1","64","1","64","172.221082000","0.0001","N/A","N/A"
"244.3.160.204","45187","244.3.160.239","8080","2","128","1","64","1","64","132.219924000","0.0001","N/A","N/A"
"244.3.160.248","46884","41.177.26.193","80","2","128","1","64","1","64","8.674410000","0.0001","N/A","N/A"
"244.3.160.204","45513","244.3.160.89","2785","2","128","1","64","1","64","134.217148000","0.0001","N/A","N/A"
"244.3.160.204","58882","244.3.160.89","4000","2","128","1","64","1","64","214.226568000","0.0001","N/A","N/A"
"41.177.244.77","3573","244.3.210.90","445","2","130","1","66","1","64","91.947602000","0.0001","N/A","N/A"
"244.3.160.204","23123","244.3.160.89","4000","2","128","1","64","1","64","0.192109000","0.0001","N/A","N/A"
"244.3.160.204","32810","244.3.160.89","2048","2","128","1","64","1","64","58.200703000","0.0001","N/A","N/A"
"244.3.160.204","30814","244.3.160.254","4001","2","128","1","64","1","64","46.201177000","0.0001","N/A","N/A"
"244.3.160.204","60219","244.3.160.254","2784","2","128","1","64","1","64","222.228893000","0.0001","N/A","N/A"
"244.3.160.248","46956","41.177.26.55","80","2","128","1","64","1","64","6.914372000","0.0001","N/A","N/A"
"244.3.160.204","53198","244.3.160.89","4001","2","128","1","64","1","64","180.221774000","0.0001","N/A","N/A"
"244.3.160.204","53538","244.3.160.254","4001","2","128","1","64","1","64","182.224093000","0.0001","N/A","N/A"
"244.3.160.204","27463","244.3.160.89","2048","2","128","1","64","1","64","26.195317000","0.0001","N/A","N/A"
"244.3.160.204","42171","244.3.160.89","2048","2","128","1","64","1","64","114.215546000","0.0001","N/A","N/A"
"244.3.160.204","61553","244.3.160.89","2785","2","128","1","64","1","64","230.229302000","0.0001","N/A","N/A"
"244.3.160.204","23790","244.3.160.89","4001","2","128","1","64","1","64","4.191502000","0.0001","N/A","N/A"
"244.3.160.204","34147","244.3.160.89","2048","2","128","1","64","1","64","66.207820000","0.0001","N/A","N/A"
"244.3.160.204","59546","244.3.160.89","2048","2","128","1","64","1","64","218.226532000","0.0001","N/A","N/A"
"244.3.160.204","47515","244.3.160.89","2048","2","128","1","64","1","64","146.218535000","0.0001","N/A","N/A"
"244.3.160.204","49186","244.3.160.89","4001","2","128","1","64","1","64","156.219407000","0.0001","N/A","N/A"
"244.3.160.204","51527","244.3.160.89","2048","2","128","1","64","1","64","170.220563000","0.0001","N/A","N/A"
"244.3.160.204","27136","244.3.160.89","4001","2","128","1","64","1","64","24.196678000","0.0001","N/A","N/A"
"244.3.160.204","27797","244.3.160.89","4001","2","128","1","64","1","64","28.195746000","0.0001","N/A","N/A"
"186.181.210.108","2295","41.177.98.176","80","2","128","1","64","1","64","8.788062000","0.0001","N/A","N/A"
"244.3.160.204","43503","244.3.160.89","2048","2","128","1","64","1","64","122.215997000","0.0001","N/A","N/A"
"244.3.160.204","57210","244.3.160.89","4001","2","128","1","64","1","64","204.224491000","0.0001","N/A","N/A"
"244.3.160.204","30135","244.3.160.89","2048","2","128","1","64","1","64","42.198113000","0.0001","N/A","N/A"
"244.3.160.204","27133","244.3.160.89","2784","2","128","1","64","1","64","24.195917000","0.0001","N/A","N/A"
"244.3.160.204","48855","244.3.160.89","2048","2","128","1","64","1","64","154.218629000","0.0001","N/A","N/A"
"244.3.160.204","24791","244.3.160.89","2048","2","128","1","64","1","64","10.192709000","0.0001","N/A","N/A"
"244.3.160.204","32481","244.3.160.89","4002","2","128","1","64","1","64","56.202320000","0.0001","N/A","N/A"
"244.3.160.204","55539","244.3.160.89","2048","2","128","1","64","1","64","194.222994000","0.0001","N/A","N/A"
"244.3.160.204","57541","244.3.160.89","2785","2","128","1","64","1","64","206.225510000","0.0001","N/A","N/A"
"244.3.160.204","58881","244.3.160.89","2785","2","128","1","64","1","64","214.226322000","0.0001","N/A","N/A"
"244.3.160.204","39494","244.3.160.89","2048","2","128","1","64","1","64","98.207008000","0.0001","N/A","N/A"
"244.3.160.239","61200","128.71.90.164","80","3","192","1","64","2","128","0.038675000","0.0001","N/A","10893617.02"
"244.3.160.204","25461","244.3.160.89","2785","2","128","1","64","1","64","14.193165000","0.0001","N/A","N/A"
"177.213.85.47","32887","41.177.98.176","80","2","128","1","64","1","64","88.149313000","0.0001","N/A","N/A"
"244.3.160.204","46845","244.3.160.89","2785","2","128","1","64","1","64","142.218371000","0.0001","N/A","N/A"
"244.3.160.204","61217","244.3.160.89","4001","2","128","1","64","1","64","228.228424000","0.0001","N/A","N/A"
"244.3.160.204","26793","244.3.160.89","2785","2","128","1","64","1","64","22.194174000","0.0001","N/A","N/A"
"244.3.160.204","27806","244.3.160.254","2048","2","128","1","64","1","64","28.198064000","0.0001","N/A","N/A"
"244.3.160.204","30805","244.3.160.89","2785","2","128","1","64","1","64","46.198884000","0.0001","N/A","N/A"
"244.3.160.204","28810","244.3.160.254","2048","2","128","1","64","1","64","34.198332000","0.0001","N/A","N/A"
"244.3.160.248","46970","41.177.26.55","80","2","128","1","64","1","64","2.691753000","0.0001","N/A","N/A"
"244.3.160.204","26126","244.3.160.89","2048","2","128","1","64","1","64","18.193545000","0.0001","N/A","N/A"
"244.3.160.204","32479","244.3.160.89","4000","2","128","1","64","1","64","56.201807000","0.0001","N/A","N/A"
"244.3.160.204","38159","244.3.160.89","2048","2","128","1","64","1","64","90.206039000","0.0001","N/A","N/A"
"244.3.160.204","38829","244.3.160.89","2785","2","128","1","64","1","64","94.206803000","0.0001","N/A","N/A"
"244.3.160.204","31475","244.3.160.89","2048","2","128","1","64","1","64","50.199278000","0.0001","N/A","N/A"
"244.3.160.204","32145","244.3.160.89","2785","2","128","1","64","1","64","54.199730000","0.0001","N/A","N/A"
"244.3.160.204","37489","244.3.160.89","2785","2","128","1","64","1","64","86.206114000","0.0001","N/A","N/A"
"244.3.160.204","37824","244.3.160.89","2784","2","128","1","64","1","64","88.206022000","0.0001","N/A","N/A"
"244.3.160.204","45526","244.3.160.239","8080","2","128","1","64","1","64","134.220554000","0.0001","N/A","N/A"
"244.3.160.204","53529","244.3.160.89","2785","2","128","1","64","1","64","182.221768000","0.0001","N/A","N/A"
"244.3.160.204","31806","244.3.160.89","4001","2","128","1","64","1","64","52.199620000","0.0001","N/A","N/A"
"244.3.160.204","38497","244.3.160.254","4001","2","128","1","64","1","64","92.207812000","0.0001","N/A","N/A"
"244.3.160.204","41501","244.3.160.89","2785","2","128","1","64","1","64","110.215015000","0.0001","N/A","N/A"
"244.3.160.204","44173","244.3.160.89","2785","2","128","1","64","1","64","126.217011000","0.0001","N/A","N/A"
"244.3.160.204","45174","244.3.160.89","4001","2","128","1","64","1","64","132.216575000","0.0001","N/A","N/A"
"244.3.160.204","53533","244.3.160.89","2048","2","128","1","64","1","64","182.222774000","0.0001","N/A","N/A"
"244.3.160.204","57878","244.3.160.89","4000","2","128","1","64","1","64","208.225334000","0.0001","N/A","N/A"
"244.3.160.204","35818","244.3.160.89","4001","2","128","1","64","1","64","76.203865000","0.0001","N/A","N/A"
"244.3.160.204","36162","244.3.160.254","4002","2","128","1","64","1","64","78.206372000","0.0001","N/A","N/A"
"244.3.160.204","39832","244.3.160.89","2048","2","128","1","64","1","64","100.220643000","0.0001","N/A","N/A"
"244.3.160.204","44843","244.3.160.89","2048","2","128","1","64","1","64","130.217062000","0.0001","N/A","N/A"
"244.3.160.204","46181","244.3.160.89","2784","2","128","1","64","1","64","138.218099000","0.0001","N/A","N/A"
"244.3.160.204","47849","244.3.160.89","4001","2","128","1","64","1","64","148.218299000","0.0001","N/A","N/A"
"244.3.160.204","54199","244.3.160.89","2048","2","128","1","64","1","64","186.222803000","0.0001","N/A","N/A"
"244.3.160.204","54869","244.3.160.89","2785","2","128","1","64","1","64","190.222446000","0.0001","N/A","N/A"
"244.3.160.204","56210","244.3.160.254","2784","2","128","1","64","1","64","198.224792000","0.0001","N/A","N/A"
"244.3.160.204","59882","244.3.160.89","4001","2","128","1","64","1","64","220.227468000","0.0001","N/A","N/A"
"244.3.160.204","60887","244.3.160.89","2785","2","128","1","64","1","64","226.229880000","0.0001","N/A","N/A"
"244.3.160.204","41165","244.3.160.89","4001","2","128","1","64","1","64","108.214909000","0.0001","N/A","N/A"
"244.3.160.204","44182","244.3.160.254","4001","2","128","1","64","1","64","126.219361000","0.0001","N/A","N/A"
"244.3.160.204","36819","244.3.160.89","2048","2","128","1","64","1","64","82.204499000","0.0001","N/A","N/A"
"244.3.160.204","46178","244.3.160.89","2048","2","128","1","64","1","64","138.217333000","0.0001","N/A","N/A"
"244.3.160.204","49858","244.3.160.89","2785","2","128","1","64","1","64","160.219776000","0.0001","N/A","N/A"
"244.3.160.204","52862","244.3.160.89","2048","2","128","1","64","1","64","178.221657000","0.0001","N/A","N/A"
"244.3.160.204","57212","244.3.160.89","2048","2","128","1","64","1","64","204.224995000","0.0001","N/A","N/A"
"244.3.160.204","25122","244.3.160.89","4001","2","128","1","64","1","64","12.193350000","0.0001","N/A","N/A"
"244.3.160.204","28803","244.3.160.89","2048","2","128","1","64","1","64","34.196548000","0.0001","N/A","N/A"
"244.3.160.204","29134","244.3.160.89","4001","2","128","1","64","1","64","36.197578000","0.0001","N/A","N/A"
"244.3.160.204","29468","244.3.160.89","2785","2","128","1","64","1","64","38.197364000","0.0001","N/A","N/A"
"244.3.160.204","29479","244.3.160.254","2048","2","128","1","64","1","64","38.200229000","0.0001","N/A","N/A"
"244.3.160.204","42504","244.3.160.89","2048","2","128","1","64","1","64","116.216576000","0.0001","N/A","N/A"
"244.3.160.204","61556","244.3.160.89","4002","2","128","1","64","1","64","230.230093000","0.0001","N/A","N/A"
"244.3.160.204","37158","244.3.160.89","4001","2","128","1","64","1","64","84.204758000","0.0001","N/A","N/A"
"244.3.160.204","56871","244.3.160.89","2048","2","128","1","64","1","64","202.223810000","0.0001","N/A","N/A"
"244.3.160.204","26462","244.3.160.89","4001","2","128","1","64","1","64","20.194598000","0.0001","N/A","N/A"
"244.3.160.204","27468","244.3.160.89","4000","2","128","1","64","1","64","26.196550000","0.0001","N/A","N/A"
"244.3.160.204","54533","244.3.160.89","4001","2","128","1","64","1","64","188.222431000","0.0001","N/A","N/A"
"244.3.160.204","57542","244.3.160.89","4000","2","128","1","64","1","64","206.225764000","0.0001","N/A","N/A"
"244.3.160.204","60213","244.3.160.89","2785","2","128","1","64","1","64","222.227330000","0.0001","N/A","N/A"
"244.3.160.204","60883","244.3.160.89","2048","2","128","1","64","1","64","226.228883000","0.0001","N/A","N/A"
"244.3.160.204","33477","244.3.160.89","2785","2","128","1","64","1","64","62.201804000","0.0001","N/A","N/A"
"244.3.160.204","38172","244.3.160.239","8080","2","128","1","64","1","64","90.209484000","0.0001","N/A","N/A"
"244.3.160.204","42836","244.3.160.89","2785","2","128","1","64","1","64","118.215621000","0.0001","N/A","N/A"
"244.3.160.204","49522","244.3.160.89","4001","2","128","1","64","1","64","158.219141000","0.0001","N/A","N/A"
"244.3.160.204","50526","244.3.160.89","4001","2","128","1","64","1","64","164.219678000","0.0001","N/A","N/A"
"244.3.160.204","25805","244.3.160.239","8080","2","128","1","64","1","64","16.197795000","0.0001","N/A","N/A"
"244.3.160.204","40161","244.3.160.89","2785","2","128","1","64","1","64","102.214495000","0.0001","N/A","N/A"
"244.3.160.204","56204","244.3.160.89","2785","2","128","1","64","1","64","198.223233000","0.0001","N/A","N/A"
"244.3.160.204","25124","244.3.160.89","2048","2","128","1","64","1","64","12.193869000","0.0001","N/A","N/A"
"244.3.160.204","31140","244.3.160.89","2784","2","128","1","64","1","64","48.204842000","0.0001","N/A","N/A"
"244.3.160.204","31488","244.3.160.239","8080","2","128","1","64","1","64","50.202742000","0.0001","N/A","N/A"
"244.3.160.204","33151","244.3.160.89","2784","2","128","1","64","1","64","60.203690000","0.0001","N/A","N/A"
"244.3.160.204","40831","244.3.160.89","2048","2","128","1","64","1","64","106.215412000","0.0001","N/A","N/A"
"244.3.160.204","42502","244.3.160.89","4001","2","128","1","64","1","64","116.216051000","0.0001","N/A","N/A"
"244.3.160.204","42511","244.3.160.254","2048","2","128","1","64","1","64","116.218413000","0.0001","N/A","N/A"
"244.3.160.204","45845","244.3.160.89","2784","2","128","1","64","1","64","136.218006000","0.0001","N/A","N/A"
"244.3.160.204","50187","244.3.160.89","2048","2","128","1","64","1","64","162.219251000","0.0001","N/A","N/A"
"244.3.160.204","60216","244.3.160.89","4002","2","128","1","64","1","64","222.228102000","0.0001","N/A","N/A"
"244.3.160.204","58883","244.3.160.89","4001","2","128","1","64","1","64","214.226801000","0.0001","N/A","N/A"
"244.3.160.204","33817","244.3.160.89","2784","2","128","1","64","1","64","64.202277000","0.0001","N/A","N/A"
"244.3.160.204","38490","244.3.160.89","4001","2","128","1","64","1","64","92.206002000","0.0001","N/A","N/A"
"244.3.160.204","28808","244.3.160.89","4000","2","128","1","64","1","64","34.197814000","0.0001","N/A","N/A"
"244.3.160.204","33146","244.3.160.89","4001","2","128","1","64","1","64","60.202373000","0.0001","N/A","N/A"
"244.3.160.204","47185","244.3.160.89","2784","2","128","1","64","1","64","144.217755000","0.0001","N/A","N/A"
"244.3.160.204","55870","244.3.160.89","4001","2","128","1","64","1","64","196.223542000","0.0001","N/A","N/A"
"244.3.160.204","58211","244.3.160.89","2048","2","128","1","64","1","64","210.225505000","0.0001","N/A","N/A"
"244.3.160.204","58215","244.3.160.89","2785","2","128","1","64","1","64","210.226525000","0.0001","N/A","N/A"
"244.3.160.204","60553","244.3.160.89","2784","2","128","1","64","1","64","224.228721000","0.0001","N/A","N/A"
"244.3.160.204","42837","244.3.160.89","4000","2","128","1","64","1","64","118.215835000","0.0001","N/A","N/A"
"244.3.160.204","43842","244.3.160.89","4001","2","128","1","64","1","64","124.216268000","0.0001","N/A","N/A"
"244.3.160.204","23451","244.3.160.89","2048","2","128","1","64","1","64","2.191235000","0.0001","N/A","N/A"
"244.3.160.204","24121","244.3.160.89","2785","2","128","1","64","1","64","6.193105000","0.0001","N/A","N/A"
"244.3.160.204","30474","244.3.160.89","4001","2","128","1","64","1","64","44.198262000","0.0001","N/A","N/A"
"244.3.160.204","34481","244.3.160.89","4001","2","128","1","64","1","64","68.203101000","0.0001","N/A","N/A"
"244.3.160.204","41170","244.3.160.89","2784","2","128","1","64","1","64","108.216221000","0.0001","N/A","N/A"
"244.3.160.204","49857","244.3.160.89","2784","2","128","1","64","1","64","160.219504000","0.0001","N/A","N/A"
"244.3.160.204","50534","244.3.160.254","4002","2","128","1","64","1","64","164.221768000","0.0001","N/A","N/A"
"244.3.160.204","51192","244.3.160.89","2784","2","128","1","64","1","64","168.220091000","0.0001","N/A","N/A"
"244.3.160.204","58542","244.3.160.89","4001","2","128","1","64","1","64","212.225928000","0.0001","N/A","N/A"
"244.3.160.204","46847","244.3.160.89","4001","2","128","1","64","1","64","142.218879000","0.0001","N/A","N/A"
"244.3.160.204","51865","244.3.160.254","4001","2","128","1","64","1","64","172.222908000","0.0001","N/A","N/A"
"244.3.160.204","57880","244.3.160.89","4002","2","128","1","64","1","64","208.225902000","0.0001","N/A","N/A"
"244.3.160.204","43516","244.3.160.239","8080","2","128","1","64","1","64","122.219394000","0.0001","N/A","N/A"
"244.3.160.204","32151","244.3.160.254","2784","2","128","1","64","1","64","54.201395000","0.0001","N/A","N/A"
"244.3.160.204","27802","244.3.160.89","2784","2","128","1","64","1","64","28.197002000","0.0001","N/A","N/A"
"244.3.160.204","46854","244.3.160.254","4001","2","128","1","64","1","64","142.220783000","0.0001","N/A","N/A"
"244.3.160.204","53200","244.3.160.89","2048","2","128","1","64","1","64","180.222257000","0.0001","N/A","N/A"
"244.3.160.204","53531","244.3.160.89","4001","2","128","1","64","1","64","182.222252000","0.0001","N/A","N/A"
"244.3.160.204","60894","244.3.160.254","2785","2","128","1","64","1","64","226.231752000","0.0001","N/A","N/A"
"244.3.160.204","61562","244.3.160.254","4001","2","128","1","64","1","64","230.231690000","0.0001","N/A","N/A"
"244.3.160.204","36489","244.3.160.89","2784","2","128","1","64","1","64","80.204360000","0.0001","N/A","N/A"
"244.3.160.204","32487","244.3.160.254","4001","2","128","1","64","1","64","56.203917000","0.0001","N/A","N/A"
"244.3.160.204","26794","244.3.160.89","4000","2","128","1","64","1","64","22.194412000","0.0001","N/A","N/A"
"244.3.160.204","34483","244.3.160.89","2048","2","128","1","64","1","64","68.203607000","0.0001","N/A","N/A"
"244.3.160.204","35487","244.3.160.89","2048","2","128","1","64","1","64","74.203415000","0.0001","N/A","N/A"
"244.3.160.204","37496","244.3.160.254","2785","2","128","1","64","1","64","86.207987000","0.0001","N/A","N/A"
"244.3.160.204","42181","244.3.160.254","2784","2","128","1","64","1","64","114.218185000","0.0001","N/A","N/A"
"244.3.160.204","43173","244.3.160.89","2784","2","128","1","64","1","64","120.216296000","0.0001","N/A","N/A"
"244.3.160.204","44508","244.3.160.89","2784","2","128","1","64","1","64","128.217306000","0.0001","N/A","N/A"
"244.3.160.204","45175","244.3.160.89","4002","2","128","1","64","1","64","132.216820000","0.0001","N/A","N/A"
"244.3.160.204","27135","244.3.160.89","4000","2","128","1","64","1","64","24.196408000","0.0001","N/A","N/A"
"244.3.160.204","28465","244.3.160.89","2784","2","128","1","64","1","64","32.196330000","0.0001","N/A","N/A"
"244.3.160.204","34152","244.3.160.89","4000","2","128","1","64","1","64","66.209402000","0.0001","N/A","N/A"
"244.3.160.204","35149","244.3.160.89","2784","2","128","1","64","1","64","72.203374000","0.0001","N/A","N/A"
"244.3.160.204","35820","244.3.160.89","2048","2","128","1","64","1","64","76.204389000","0.0001","N/A","N/A"
"244.3.160.204","36159","244.3.160.254","2785","2","128","1","64","1","64","78.205639000","0.0001","N/A","N/A"
"244.3.160.204","36823","244.3.160.89","2785","2","128","1","64","1","64","82.205559000","0.0001","N/A","N/A"
"244.3.160.204","50858","244.3.160.89","4000","2","128","1","64","1","64","166.220259000","0.0001","N/A","N/A"
"244.3.160.204","56541","244.3.160.89","2784","2","128","1","64","1","64","200.223947000","0.0001","N/A","N/A"
"244.3.160.204","59557","244.3.160.254","2785","2","128","1","64","1","64","218.229350000","0.0001","N/A","N/A"
"244.3.160.204","60565","244.3.160.239","8080","2","128","1","64","1","64","224.231820000","0.0001","N/A","N/A"
"244.3.160.204","39161","244.3.160.89","2784","2","128","1","64","1","64","96.207306000","0.0001","N/A","N/A"
"244.3.160.204","39498","244.3.160.89","2785","2","128","1","64","1","64","98.208013000","0.0001","N/A","N/A"
"244.3.160.204","39830","244.3.160.89","4001","2","128","1","64","1","64","100.220061000","0.0001","N/A","N/A"
"244.3.160.204","41833","244.3.160.89","2784","2","128","1","64","1","64","112.215524000","0.0001","N/A","N/A"
"244.3.160.204","42515","244.3.160.239","8080","2","128","1","64","1","64","116.219493000","0.0001","N/A","N/A"
"244.3.160.204","48192","244.3.160.254","2785","2","128","1","64","1","64","150.219944000","0.0001","N/A","N/A"
"244.3.160.204","48517","244.3.160.89","2784","2","128","1","64","1","64","152.218996000","0.0001","N/A","N/A"
"244.3.160.204","25471","244.3.160.254","4002","2","128","1","64","1","64","14.195765000","0.0001","N/A","N/A"
"244.3.160.204","32477","244.3.160.89","2784","2","128","1","64","1","64","56.201289000","0.0001","N/A","N/A"
"244.3.160.204","41173","244.3.160.254","4002","2","128","1","64","1","64","108.217046000","0.0001","N/A","N/A"
"244.3.160.204","47854","244.3.160.89","2784","2","128","1","64","1","64","148.219560000","0.0001","N/A","N/A"
"244.3.160.204","49520","244.3.160.89","2785","2","128","1","64","1","64","158.218596000","0.0001","N/A","N/A"
"244.3.160.204","53871","244.3.160.89","4000","2","128","1","64","1","64","184.222919000","0.0001","N/A","N/A"
"244.3.160.204","53876","244.3.160.254","2784","2","128","1","64","1","64","184.224214000","0.0001","N/A","N/A"
"244.3.160.204","54879","244.3.160.254","4002","2","128","1","64","1","64","190.224988000","0.0001","N/A","N/A"
"244.3.160.204","62223","244.3.160.89","2048","2","128","1","64","1","64","234.229030000","0.0001","N/A","N/A"
"244.3.160.204","25796","244.3.160.89","4001","2","128","1","64","1","64","16.195371000","0.0001","N/A","N/A"
"244.3.160.204","28806","244.3.160.89","2784","2","128","1","64","1","64","34.197287000","0.0001","N/A","N/A"
"244.3.160.204","29478","244.3.160.254","4002","2","128","1","64","1","64","38.199961000","0.0001","N/A","N/A"
"244.3.160.204","35490","244.3.160.89","2784","2","128","1","64","1","64","74.204111000","0.0001","N/A","N/A"
"244.3.160.204","45179","244.3.160.89","2784","2","128","1","64","1","64","132.217814000","0.0001","N/A","N/A"
"244.3.160.204","46515","244.3.160.89","4002","2","128","1","64","1","64","140.218075000","0.0001","N/A","N/A"
"244.3.160.204","50192","244.3.160.89","4000","2","128","1","64","1","64","162.220508000","0.0001","N/A","N/A"
"244.3.160.204","52198","244.3.160.89","4000","2","128","1","64","1","64","174.221555000","0.0001","N/A","N/A"
"244.3.160.204","52865","244.3.160.89","2784","2","128","1","64","1","64","178.222413000","0.0001","N/A","N/A"
"244.3.160.204","53211","244.3.160.239","8080","2","128","1","64","1","64","180.225202000","0.0001","N/A","N/A"
"244.3.160.204","57543","244.3.160.89","4001","2","128","1","64","1","64","206.226092000","0.0001","N/A","N/A"
"244.3.160.204","23121","244.3.160.89","2784","2","128","1","64","1","64","0.191567000","0.0001","N/A","N/A"
"244.3.160.204","25462","244.3.160.89","4000","2","128","1","64","1","64","14.193411000","0.0001","N/A","N/A"
"244.3.160.204","25793","244.3.160.89","2784","2","128","1","64","1","64","16.194571000","0.0001","N/A","N/A"
"244.3.160.204","27805","244.3.160.254","4002","2","128","1","64","1","64","28.197783000","0.0001","N/A","N/A"
"244.3.160.204","32152","244.3.160.254","2785","2","128","1","64","1","64","54.201531000","0.0001","N/A","N/A"
"244.3.160.204","34157","244.3.160.254","2784","2","128","1","64","1","64","66.211026000","0.0001","N/A","N/A"
"244.3.160.204","34821","244.3.160.89","2048","2","128","1","64","1","64","70.203755000","0.0001","N/A","N/A"
"244.3.160.204","37502","244.3.160.239","8080","2","128","1","64","1","64","86.209590000","0.0001","N/A","N/A"
"244.3.160.204","40163","244.3.160.89","4001","2","128","1","64","1","64","102.214995000","0.0001","N/A","N/A"
"244.3.160.204","50868","244.3.160.254","2048","2","128","1","64","1","64","166.222876000","0.0001","N/A","N/A"
"244.3.160.204","52531","244.3.160.89","4000","2","128","1","64","1","64","176.222415000","0.0001","N/A","N/A"
"244.3.160.204","56884","244.3.160.239","8080","2","128","1","64","1","64","202.227234000","0.0001","N/A","N/A"
"244.3.160.204","34153","244.3.160.254","4002","2","128","1","64","1","64","66.209746000","0.0001","N/A","N/A"
"244.3.160.204","35156","244.3.160.254","2784","2","128","1","64","1","64","72.205288000","0.0001","N/A","N/A"
"244.3.160.204","36161","244.3.160.254","4001","2","128","1","64","1","64","78.206194000","0.0001","N/A","N/A"
"244.3.160.204","37826","244.3.160.89","4000","2","128","1","64","1","64","88.206504000","0.0001","N/A","N/A"
"244.3.160.204","42842","244.3.160.254","2784","2","128","1","64","1","64","118.217097000","0.0001","N/A","N/A"
"244.3.160.204","46846","244.3.160.89","4000","2","128","1","64","1","64","142.218628000","0.0001","N/A","N/A"
"244.3.160.204","50863","244.3.160.254","2784","2","128","1","64","1","64","166.221563000","0.0001","N/A","N/A"
"244.3.160.204","53869","244.3.160.89","2784","2","128","1","64","1","64","184.222397000","0.0001","N/A","N/A"
"244.3.160.204","53881","244.3.160.239","8080","2","128","1","64","1","64","184.225605000","0.0001","N/A","N/A"
"244.3.160.204","54870","244.3.160.89","4000","2","128","1","64","1","64","190.222683000","0.0001","N/A","N/A"
"244.3.160.204","57217","244.3.160.254","4001","2","128","1","64","1","64","204.226327000","0.0001","N/A","N/A"
"244.3.160.204","59215","244.3.160.89","4000","2","128","1","64","1","64","216.227466000","0.0001","N/A","N/A"
"244.3.160.204","62234","244.3.160.254","2785","2","128","1","64","1","64","234.231836000","0.0001","N/A","N/A"
"244.3.160.204","28468","244.3.160.89","4001","2","128","1","64","1","64","32.197061000","0.0001","N/A","N/A"
"244.3.160.204","29469","244.3.160.89","4000","2","128","1","64","1","64","38.197609000","0.0001","N/A","N/A"
"244.3.160.204","32489","244.3.160.239","8080","2","128","1","64","1","64","56.204490000","0.0001","N/A","N/A"
"244.3.160.204","33148","244.3.160.89","2048","2","128","1","64","1","64","60.202894000","0.0001","N/A","N/A"
"244.3.160.204","23454","244.3.160.89","2784","2","128","1","64","1","64","2.192007000","0.0001","N/A","N/A"
"244.3.160.204","23792","244.3.160.89","2048","2","128","1","64","1","64","4.191991000","0.0001","N/A","N/A"
"244.3.160.204","26469","244.3.160.254","4001","2","128","1","64","1","64","20.196487000","0.0001","N/A","N/A"
"244.3.160.204","27466","244.3.160.89","2784","2","128","1","64","1","64","26.196048000","0.0001","N/A","N/A"
"244.3.160.204","34154","244.3.160.254","2048","2","128","1","64","1","64","66.210040000","0.0001","N/A","N/A"
"244.3.160.204","35500","244.3.160.239","8080","2","128","1","64","1","64","74.206828000","0.0001","N/A","N/A"
"244.3.160.204","35827","244.3.160.254","2048","2","128","1","64","1","64","76.206299000","0.0001","N/A","N/A"
"244.3.160.204","37828","244.3.160.89","4002","2","128","1","64","1","64","88.207047000","0.0001","N/A","N/A"
"244.3.160.204","37831","244.3.160.254","2784","2","128","1","64","1","64","88.207813000","0.0001","N/A","N/A"
"244.3.160.204","38830","244.3.160.89","4000","2","128","1","64","1","64","94.207111000","0.0001","N/A","N/A"
"244.3.160.204","39165","244.3.160.89","4002","2","128","1","64","1","64","96.208319000","0.0001","N/A","N/A"
"244.3.160.204","51531","244.3.160.89","2785","2","128","1","64","1","64","170.221571000","0.0001","N/A","N/A"
"244.3.160.204","55883","244.3.160.239","8080","2","128","1","64","1","64","196.227067000","0.0001","N/A","N/A"
"244.3.160.204","57876","244.3.160.89","2784","2","128","1","64","1","64","208.224849000","0.0001","N/A","N/A"
"244.3.160.204","60217","244.3.160.89","2048","2","128","1","64","1","64","222.228338000","0.0001","N/A","N/A"
"244.3.160.204","60555","244.3.160.89","4000","2","128","1","64","1","64","224.229181000","0.0001","N/A","N/A"
"244.3.160.204","35494","244.3.160.254","2048","2","128","1","64","1","64","74.205368000","0.0001","N/A","N/A"
"244.3.160.204","37825","244.3.160.89","2785","2","128","1","64","1","64","88.206257000","0.0001","N/A","N/A"
"244.3.160.204","40171","244.3.160.254","4002","2","128","1","64","1","64","102.217193000","0.0001","N/A","N/A"
"244.3.160.204","42176","244.3.160.89","4000","2","128","1","64","1","64","114.216822000","0.0001","N/A","N/A"
"244.3.160.204","45523","244.3.160.254","4002","2","128","1","64","1","64","134.219867000","0.0001","N/A","N/A"
"244.3.160.204","46188","244.3.160.254","2784","2","128","1","64","1","64","138.220002000","0.0001","N/A","N/A"
"244.3.160.204","46519","244.3.160.89","2784","2","128","1","64","1","64","140.219147000","0.0001","N/A","N/A"
"244.3.160.204","47187","244.3.160.89","4000","2","128","1","64","1","64","144.218246000","0.0001","N/A","N/A"
"244.3.160.204","50200","244.3.160.239","8080","2","128","1","64","1","64","162.222678000","0.0001","N/A","N/A"
"244.3.160.204","50860","244.3.160.89","4002","2","128","1","64","1","64","166.220754000","0.0001","N/A","N/A"
"244.3.160.204","51537","244.3.160.254","2784","2","128","1","64","1","64","170.223134000","0.0001","N/A","N/A"
"244.3.160.204","52529","244.3.160.89","2784","2","128","1","64","1","64","176.221896000","0.0001","N/A","N/A"
"244.3.160.204","55549","244.3.160.254","2784","2","128","1","64","1","64","194.225688000","0.0001","N/A","N/A"
"244.3.160.204","29135","244.3.160.89","4002","2","128","1","64","1","64","36.197849000","0.0001","N/A","N/A"
"244.3.160.204","23791","244.3.160.89","4002","2","128","1","64","1","64","4.191759000","0.0001","N/A","N/A"
"244.3.160.204","24122","244.3.160.89","4000","2","128","1","64","1","64","6.193379000","0.0001","N/A","N/A"
"244.3.160.204","24456","244.3.160.89","2784","2","128","1","64","1","64","8.193160000","0.0001","N/A","N/A"
"244.3.160.204","24804","244.3.160.239","8080","2","128","1","64","1","64","10.196109000","0.0001","N/A","N/A"
"244.3.160.204","25135","244.3.160.239","8080","2","128","1","64","1","64","12.196828000","0.0001","N/A","N/A"
"244.3.160.204","28467","244.3.160.89","4000","2","128","1","64","1","64","32.196820000","0.0001","N/A","N/A"
"244.3.160.204","31142","244.3.160.89","4000","2","128","1","64","1","64","48.205498000","0.0001","N/A","N/A"
"244.3.160.204","31147","244.3.160.254","2784","2","128","1","64","1","64","48.207126000","0.0001","N/A","N/A"
"244.3.160.204","31807","244.3.160.89","4002","2","128","1","64","1","64","52.199868000","0.0001","N/A","N/A"
"244.3.160.204","31811","244.3.160.89","2784","2","128","1","64","1","64","52.200910000","0.0001","N/A","N/A"
"244.3.160.204","33147","244.3.160.89","4002","2","128","1","64","1","64","60.202627000","0.0001","N/A","N/A"
"244.3.160.204","33478","244.3.160.89","4000","2","128","1","64","1","64","62.202053000","0.0001","N/A","N/A"
"244.3.160.204","38169","244.3.160.254","2784","2","128","1","64","1","64","90.208653000","0.0001","N/A","N/A"
"244.3.160.204","39163","244.3.160.89","4000","2","128","1","64","1","64","96.207820000","0.0001","N/A","N/A"
"244.3.160.204","39499","244.3.160.89","4000","2","128","1","64","1","64","98.208259000","0.0001","N/A","N/A"
"244.3.160.204","39507","244.3.160.239","8080","2","128","1","64","1","64","98.210401000","0.0001","N/A","N/A"
"244.3.160.204","40503","244.3.160.89","4000","2","128","1","64","1","64","104.215343000","0.0001","N/A","N/A"
"244.3.160.204","41502","244.3.160.89","4000","2","128","1","64","1","64","110.215284000","0.0001","N/A","N/A"
"244.3.160.204","48858","244.3.160.89","2784","2","128","1","64","1","64","154.219389000","0.0001","N/A","N/A"
"244.3.160.204","50867","244.3.160.254","4002","2","128","1","64","1","64","166.222621000","0.0001","N/A","N/A"
"244.3.160.204","51530","244.3.160.89","2784","2","128","1","64","1","64","170.221300000","0.0001","N/A","N/A"
"244.3.160.204","51532","244.3.160.89","4000","2","128","1","64","1","64","170.221821000","0.0001","N/A","N/A"
"244.3.160.204","53535","244.3.160.254","2784","2","128","1","64","1","64","182.223293000","0.0001","N/A","N/A"
"244.3.160.204","56213","244.3.160.254","4001","2","128","1","64","1","64","198.225649000","0.0001","N/A","N/A"
"244.3.160.204","58885","244.3.160.89","2048","2","128","1","64","1","64","214.227323000","0.0001","N/A","N/A"
"244.3.160.204","61885","244.3.160.89","2784","2","128","1","64","1","64","232.229530000","0.0001","N/A","N/A"
"244.3.160.204","62228","244.3.160.89","4000","2","128","1","64","1","64","234.230250000","0.0001","N/A","N/A"
"244.3.160.204","45852","244.3.160.254","2784","2","128","1","64","1","64","136.219847000","0.0001","N/A","N/A"
"244.3.160.204","46185","244.3.160.254","2048","2","128","1","64","1","64","138.219182000","0.0001","N/A","N/A"
"244.3.160.204","46523","244.3.160.254","2048","2","128","1","64","1","64","140.220263000","0.0001","N/A","N/A"
"244.3.160.204","47520","244.3.160.89","4000","2","128","1","64","1","64","146.219823000","0.0001","N/A","N/A"
"244.3.160.204","48518","244.3.160.89","2785","2","128","1","64","1","64","152.219269000","0.0001","N/A","N/A"
"244.3.160.204","48868","244.3.160.239","8080","2","128","1","64","1","64","154.222118000","0.0001","N/A","N/A"
"244.3.160.204","49869","244.3.160.239","8080","2","128","1","64","1","64","160.222672000","0.0001","N/A","N/A"
"244.3.160.204","50197","244.3.160.254","2784","2","128","1","64","1","64","162.221847000","0.0001","N/A","N/A"
"244.3.160.204","50870","244.3.160.239","8080","2","128","1","64","1","64","166.223448000","0.0001","N/A","N/A"
"244.3.160.204","51193","244.3.160.89","2785","2","128","1","64","1","64","168.220331000","0.0001","N/A","N/A"
"244.3.160.204","51200","244.3.160.254","2785","2","128","1","64","1","64","168.222165000","0.0001","N/A","N/A"
"244.3.160.204","51859","244.3.160.89","4002","2","128","1","64","1","64","172.221329000","0.0001","N/A","N/A"
"244.3.160.204","54534","244.3.160.89","4002","2","128","1","64","1","64","188.222683000","0.0001","N/A","N/A"
"244.3.160.204","57550","244.3.160.254","4001","2","128","1","64","1","64","206.227880000","0.0001","N/A","N/A"
"244.3.160.204","57883","244.3.160.254","2784","2","128","1","64","1","64","208.226653000","0.0001","N/A","N/A"
"244.3.160.204","61218","244.3.160.89","4002","2","128","1","64","1","64","228.228626000","0.0001","N/A","N/A"
"244.3.160.204","62229","244.3.160.254","4002","2","128","1","64","1","64","234.230526000","0.0001","N/A","N/A"
"244.3.160.204","23797","244.3.160.254","4001","2","128","1","64","1","64","4.193311000","0.0001","N/A","N/A"
"244.3.160.204","25801","244.3.160.254","2785","2","128","1","64","1","64","16.196715000","0.0001","N/A","N/A"
"244.3.160.204","26131","244.3.160.89","4000","2","128","1","64","1","64","18.194754000","0.0001","N/A","N/A"
"244.3.160.204","27140","244.3.160.254","2784","2","128","1","64","1","64","24.197744000","0.0001","N/A","N/A"
"244.3.160.204","27141","244.3.160.254","2785","2","128","1","64","1","64","24.198002000","0.0001","N/A","N/A"
"244.3.160.204","28139","244.3.160.254","2784","2","128","1","64","1","64","30.197428000","0.0001","N/A","N/A"
"244.3.160.204","30806","244.3.160.89","4000","2","128","1","64","1","64","46.199098000","0.0001","N/A","N/A"
"244.3.160.204","30808","244.3.160.89","4002","2","128","1","64","1","64","46.199623000","0.0001","N/A","N/A"
"244.3.160.204","30809","244.3.160.89","2048","2","128","1","64","1","64","46.199869000","0.0001","N/A","N/A"
"244.3.160.204","33159","244.3.160.239","8080","2","128","1","64","1","64","60.205908000","0.0001","N/A","N/A"
"244.3.160.204","34150","244.3.160.89","2784","2","128","1","64","1","64","66.208756000","0.0001","N/A","N/A"
"244.3.160.204","34830","244.3.160.239","8080","2","128","1","64","1","64","70.206201000","0.0001","N/A","N/A"
"244.3.160.204","35492","244.3.160.89","4000","2","128","1","64","1","64","74.204604000","0.0001","N/A","N/A"
"244.3.160.204","36154","244.3.160.89","4001","2","128","1","64","1","64","78.204232000","0.0001","N/A","N/A"
"244.3.160.204","36824","244.3.160.89","4000","2","128","1","64","1","64","82.205803000","0.0001","N/A","N/A"
"244.3.160.204","36825","244.3.160.254","4002","2","128","1","64","1","64","82.206089000","0.0001","N/A","N/A"
"244.3.160.204","36829","244.3.160.254","2784","2","128","1","64","1","64","82.207137000","0.0001","N/A","N/A"
"244.3.160.204","37495","244.3.160.254","2784","2","128","1","64","1","64","86.207691000","0.0001","N/A","N/A"
"244.3.160.204","37499","244.3.160.254","4002","2","128","1","64","1","64","86.208786000","0.0001","N/A","N/A"
"244.3.160.204","40174","244.3.160.239","8080","2","128","1","64","1","64","102.217936000","0.0001","N/A","N/A"
"244.3.160.204","40504","244.3.160.89","4001","2","128","1","64","1","64","104.215582000","0.0001","N/A","N/A"
"244.3.160.204","40511","244.3.160.254","4001","2","128","1","64","1","64","104.217450000","0.0001","N/A","N/A"
"244.3.160.204","41841","244.3.160.254","2785","2","128","1","64","1","64","112.217618000","0.0001","N/A","N/A"
"244.3.160.204","43847","244.3.160.89","2784","2","128","1","64","1","64","124.217526000","0.0001","N/A","N/A"
"244.3.160.204","44180","244.3.160.254","2785","2","128","1","64","1","64","126.218832000","0.0001","N/A","N/A"
"244.3.160.204","24127","244.3.160.254","2784","2","128","1","64","1","64","6.194681000","0.0001","N/A","N/A"
"244.3.160.204","24463","244.3.160.254","2784","2","128","1","64","1","64","8.194966000","0.0001","N/A","N/A"
"244.3.160.204","27798","244.3.160.89","4002","2","128","1","64","1","64","28.195993000","0.0001","N/A","N/A"
"244.3.160.204","35151","244.3.160.89","4000","2","128","1","64","1","64","72.203899000","0.0001","N/A","N/A"
"244.3.160.204","45519","244.3.160.254","2784","2","128","1","64","1","64","134.218722000","0.0001","N/A","N/A"
"244.3.160.204","45846","244.3.160.89","2785","2","128","1","64","1","64","136.218252000","0.0001","N/A","N/A"
"244.3.160.204","46182","244.3.160.89","2785","2","128","1","64","1","64","138.218351000","0.0001","N/A","N/A"
"244.3.160.204","47188","244.3.160.89","4001","2","128","1","64","1","64","144.218509000","0.0001","N/A","N/A"
"244.3.160.204","49864","244.3.160.254","2784","2","128","1","64","1","64","160.221370000","0.0001","N/A","N/A"
"244.3.160.204","51204","244.3.160.239","8080","2","128","1","64","1","64","168.223225000","0.0001","N/A","N/A"
"244.3.160.204","52866","244.3.160.89","2785","2","128","1","64","1","64","178.222663000","0.0001","N/A","N/A"
"244.3.160.204","53203","244.3.160.89","2784","2","128","1","64","1","64","180.223026000","0.0001","N/A","N/A"
"244.3.160.204","54202","244.3.160.89","2784","2","128","1","64","1","64","186.223577000","0.0001","N/A","N/A"
"244.3.160.204","54212","244.3.160.239","8080","2","128","1","64","1","64","186.226299000","0.0001","N/A","N/A"
"244.3.160.204","55878","244.3.160.254","4002","2","128","1","64","1","64","196.225695000","0.0001","N/A","N/A"
"244.3.160.204","58549","244.3.160.254","4001","2","128","1","64","1","64","212.227800000","0.0001","N/A","N/A"
"244.3.160.204","59217","244.3.160.89","4002","2","128","1","64","1","64","216.227967000","0.0001","N/A","N/A"
"244.3.160.204","61893","244.3.160.254","2785","2","128","1","64","1","64","232.231627000","0.0001","N/A","N/A"
"244.3.160.204","49859","244.3.160.89","4000","2","128","1","64","1","64","160.220025000","0.0001","N/A","N/A"
"244.3.160.204","52203","244.3.160.254","2784","2","128","1","64","1","64","174.222828000","0.0001","N/A","N/A"
"244.3.160.204","53532","244.3.160.89","4002","2","128","1","64","1","64","182.222525000","0.0001","N/A","N/A"
"244.3.160.204","30138","244.3.160.89","2784","2","128","1","64","1","64","42.198878000","0.0001","N/A","N/A"
"244.3.160.204","30148","244.3.160.239","8080","2","128","1","64","1","64","42.201552000","0.0001","N/A","N/A"
"244.3.160.204","30475","244.3.160.89","4002","2","128","1","64","1","64","44.198532000","0.0001","N/A","N/A"
"244.3.160.204","30818","244.3.160.239","8080","2","128","1","64","1","64","46.202244000","0.0001","N/A","N/A"
"244.3.160.204","32156","244.3.160.254","2048","2","128","1","64","1","64","54.202586000","0.0001","N/A","N/A"
"244.3.160.204","33819","244.3.160.89","4000","2","128","1","64","1","64","64.202749000","0.0001","N/A","N/A"
"244.3.160.204","34486","244.3.160.89","2784","2","128","1","64","1","64","68.204386000","0.0001","N/A","N/A"
"244.3.160.204","36153","244.3.160.89","4000","2","128","1","64","1","64","78.203966000","0.0001","N/A","N/A"
"244.3.160.204","36493","244.3.160.89","4002","2","128","1","64","1","64","80.205398000","0.0001","N/A","N/A"
"244.3.160.204","37493","244.3.160.89","2048","2","128","1","64","1","64","86.207150000","0.0001","N/A","N/A"
"244.3.160.204","38162","244.3.160.89","2784","2","128","1","64","1","64","90.206788000","0.0001","N/A","N/A"
"244.3.160.204","38492","244.3.160.89","2048","2","128","1","64","1","64","92.206518000","0.0001","N/A","N/A"
"244.3.160.204","38503","244.3.160.239","8080","2","128","1","64","1","64","92.209428000","0.0001","N/A","N/A"
"244.3.160.204","39500","244.3.160.254","4002","2","128","1","64","1","64","98.208528000","0.0001","N/A","N/A"
"244.3.160.204","39838","244.3.160.254","4002","2","128","1","64","1","64","100.222606000","0.0001","N/A","N/A"
"244.3.160.204","40167","244.3.160.254","2784","2","128","1","64","1","64","102.216094000","0.0001","N/A","N/A"
"244.3.160.204","40502","244.3.160.89","2785","2","128","1","64","1","64","104.215068000","0.0001","N/A","N/A"
"244.3.160.204","40841","244.3.160.254","2784","2","128","1","64","1","64","106.218026000","0.0001","N/A","N/A"
"244.3.160.204","40844","244.3.160.239","8080","2","128","1","64","1","64","106.218822000","0.0001","N/A","N/A"
"244.3.160.204","43174","244.3.160.89","2785","2","128","1","64","1","64","120.216560000","0.0001","N/A","N/A"
"244.3.160.204","43508","244.3.160.89","4000","2","128","1","64","1","64","122.217246000","0.0001","N/A","N/A"
"244.3.160.204","44186","244.3.160.239","8080","2","128","1","64","1","64","126.220446000","0.0001","N/A","N/A"
"244.3.160.204","25123","244.3.160.89","4002","2","128","1","64","1","64","12.193589000","0.0001","N/A","N/A"
"244.3.160.204","25127","244.3.160.89","2784","2","128","1","64","1","64","12.194605000","0.0001","N/A","N/A"
"244.3.160.204","23795","244.3.160.89","2784","2","128","1","64","1","64","4.192763000","0.0001","N/A","N/A"
"244.3.160.204","24124","244.3.160.89","4002","2","128","1","64","1","64","6.193870000","0.0001","N/A","N/A"
"244.3.160.204","26129","244.3.160.89","2784","2","128","1","64","1","64","18.194267000","0.0001","N/A","N/A"
"244.3.160.204","26803","244.3.160.254","4002","2","128","1","64","1","64","22.196763000","0.0001","N/A","N/A"
"244.3.160.204","27134","244.3.160.89","2785","2","128","1","64","1","64","24.196162000","0.0001","N/A","N/A"
"244.3.160.204","27137","244.3.160.89","4002","2","128","1","64","1","64","24.196938000","0.0001","N/A","N/A"
"244.3.160.204","27799","244.3.160.89","2048","2","128","1","64","1","64","28.196248000","0.0001","N/A","N/A"
"244.3.160.204","28135","244.3.160.89","4001","2","128","1","64","1","64","30.196380000","0.0001","N/A","N/A"
"244.3.160.204","28136","244.3.160.89","4002","2","128","1","64","1","64","30.196627000","0.0001","N/A","N/A"
"244.3.160.204","28140","244.3.160.254","2785","2","128","1","64","1","64","30.197686000","0.0001","N/A","N/A"
"244.3.160.204","29474","244.3.160.254","2784","2","128","1","64","1","64","38.198917000","0.0001","N/A","N/A"
"244.3.160.204","31148","244.3.160.254","2785","2","128","1","64","1","64","48.207439000","0.0001","N/A","N/A"
"244.3.160.204","31815","244.3.160.254","2048","2","128","1","64","1","64","52.202015000","0.0001","N/A","N/A"
"244.3.160.204","38842","244.3.160.239","8080","2","128","1","64","1","64","94.210265000","0.0001","N/A","N/A"
"244.3.160.204","42510","244.3.160.254","4002","2","128","1","64","1","64","116.218117000","0.0001","N/A","N/A"
"244.3.160.204","44174","244.3.160.89","4000","2","128","1","64","1","64","126.217262000","0.0001","N/A","N/A"
"244.3.160.204","44510","244.3.160.89","4000","2","128","1","64","1","64","128.217838000","0.0001","N/A","N/A"
"244.3.160.204","45514","244.3.160.89","4000","2","128","1","64","1","64","134.217399000","0.0001","N/A","N/A"
"244.3.160.204","45849","244.3.160.89","4002","2","128","1","64","1","64","136.219028000","0.0001","N/A","N/A"
"244.3.160.204","46191","244.3.160.239","8080","2","128","1","64","1","64","138.220750000","0.0001","N/A","N/A"
"244.3.160.204","47525","244.3.160.254","2784","2","128","1","64","1","64","146.221159000","0.0001","N/A","N/A"
"244.3.160.204","47528","244.3.160.239","8080","2","128","1","64","1","64","146.221993000","0.0001","N/A","N/A"
"244.3.160.204","48198","244.3.160.239","8080","2","128","1","64","1","64","150.221530000","0.0001","N/A","N/A"
"244.3.160.204","48860","244.3.160.89","4000","2","128","1","64","1","64","154.219883000","0.0001","N/A","N/A"
"244.3.160.204","49199","244.3.160.239","8080","2","128","1","64","1","64","156.222905000","0.0001","N/A","N/A"
"244.3.160.204","49521","244.3.160.89","4000","2","128","1","64","1","64","158.218841000","0.0001","N/A","N/A"
"244.3.160.204","51863","244.3.160.89","2784","2","128","1","64","1","64","172.222364000","0.0001","N/A","N/A"
"244.3.160.204","51871","244.3.160.239","8080","2","128","1","64","1","64","172.224514000","0.0001","N/A","N/A"
"244.3.160.204","52204","244.3.160.254","2785","2","128","1","64","1","64","174.223113000","0.0001","N/A","N/A"
"244.3.160.204","52206","244.3.160.254","4001","2","128","1","64","1","64","174.223634000","0.0001","N/A","N/A"
"244.3.160.204","52536","244.3.160.254","2784","2","128","1","64","1","64","176.223714000","0.0001","N/A","N/A"
"244.3.160.204","54875","244.3.160.254","2784","2","128","1","64","1","64","190.223960000","0.0001","N/A","N/A"
"244.3.160.204","54882","244.3.160.239","8080","2","128","1","64","1","64","190.225840000","0.0001","N/A","N/A"
"244.3.160.204","60220","244.3.160.254","2785","2","128","1","64","1","64","222.229114000","0.0001","N/A","N/A"
"244.3.160.204","60226","244.3.160.239","8080","2","128","1","64","1","64","222.230714000","0.0001","N/A","N/A"
"244.3.160.204","60888","244.3.160.89","4000","2","128","1","64","1","64","226.230152000","0.0001","N/A","N/A"
"244.3.160.204","60889","244.3.160.254","4002","2","128","1","64","1","64","226.230442000","0.0001","N/A","N/A"
"244.3.160.204","61886","244.3.160.89","2785","2","128","1","64","1","64","232.229766000","0.0001","N/A","N/A"
"244.3.160.204","61887","244.3.160.89","4000","2","128","1","64","1","64","232.230013000","0.0001","N/A","N/A"
"244.3.160.204","45516","244.3.160.89","4002","2","128","1","64","1","64","134.217920000","0.0001","N/A","N/A"
"244.3.160.204","46858","244.3.160.239","8080","2","128","1","64","1","64","142.221873000","0.0001","N/A","N/A"
"244.3.160.204","47186","244.3.160.89","2785","2","128","1","64","1","64","144.218001000","0.0001","N/A","N/A"
"244.3.160.204","47518","244.3.160.89","2784","2","128","1","64","1","64","146.219295000","0.0001","N/A","N/A"
"244.3.160.204","48187","244.3.160.89","4001","2","128","1","64","1","64","150.218653000","0.0001","N/A","N/A"
"244.3.160.204","48519","244.3.160.89","4000","2","128","1","64","1","64","152.219529000","0.0001","N/A","N/A"
"244.3.160.204","50528","244.3.160.89","2048","2","128","1","64","1","64","164.220194000","0.0001","N/A","N/A"
"244.3.160.204","50861","244.3.160.89","2048","2","128","1","64","1","64","166.221004000","0.0001","N/A","N/A"
"244.3.160.204","52210","244.3.160.239","8080","2","128","1","64","1","64","174.224687000","0.0001","N/A","N/A"
"244.3.160.204","57547","244.3.160.254","2784","2","128","1","64","1","64","206.227152000","0.0001","N/A","N/A"
"244.3.160.204","57879","244.3.160.89","4001","2","128","1","64","1","64","208.225600000","0.0001","N/A","N/A"
"244.3.160.204","57884","244.3.160.254","2785","2","128","1","64","1","64","208.226914000","0.0001","N/A","N/A"
"244.3.160.204","59216","244.3.160.89","4001","2","128","1","64","1","64","216.227713000","0.0001","N/A","N/A"
"244.3.160.204","59887","244.3.160.89","2784","2","128","1","64","1","64","220.228795000","0.0001","N/A","N/A"
"244.3.160.204","61559","244.3.160.254","2784","2","128","1","64","1","64","230.230878000","0.0001","N/A","N/A"
"244.3.160.204","61895","244.3.160.254","4001","2","128","1","64","1","64","232.232150000","0.0001","N/A","N/A"
"244.3.160.204","29470","244.3.160.89","4001","2","128","1","64","1","64","38.197880000","0.0001","N/A","N/A"
"244.3.160.204","30145","244.3.160.254","2784","2","128","1","64","1","64","42.200748000","0.0001","N/A","N/A"
"244.3.160.204","30816","244.3.160.254","2048","2","128","1","64","1","64","46.201719000","0.0001","N/A","N/A"
"244.3.160.204","36492","244.3.160.89","4001","2","128","1","64","1","64","80.205091000","0.0001","N/A","N/A"
"244.3.160.204","36497","244.3.160.254","2785","2","128","1","64","1","64","80.206465000","0.0001","N/A","N/A"
"244.3.160.204","37160","244.3.160.89","2048","2","128","1","64","1","64","84.205282000","0.0001","N/A","N/A"
"244.3.160.204","38835","244.3.160.254","2784","2","128","1","64","1","64","94.208399000","0.0001","N/A","N/A"
"244.3.160.204","39162","244.3.160.89","2785","2","128","1","64","1","64","96.207574000","0.0001","N/A","N/A"
"244.3.160.204","39168","244.3.160.254","2784","2","128","1","64","1","64","96.209164000","0.0001","N/A","N/A"
"244.3.160.204","39837","244.3.160.254","4001","2","128","1","64","1","64","100.222292000","0.0001","N/A","N/A"
"244.3.160.204","40164","244.3.160.89","4002","2","128","1","64","1","64","102.215279000","0.0001","N/A","N/A"
"244.3.160.204","40837","244.3.160.254","4002","2","128","1","64","1","64","106.216939000","0.0001","N/A","N/A"
"244.3.160.204","44177","244.3.160.89","2048","2","128","1","64","1","64","126.218026000","0.0001","N/A","N/A"
"244.3.160.204","26136","244.3.160.254","2784","2","128","1","64","1","64","18.196091000","0.0001","N/A","N/A"
"244.3.160.204","26799","244.3.160.254","2784","2","128","1","64","1","64","22.195735000","0.0001","N/A","N/A"
"244.3.160.204","23464","244.3.160.239","8080","2","128","1","64","1","64","2.194616000","0.0001","N/A","N/A"
"244.3.160.204","24130","244.3.160.254","4001","2","128","1","64","1","64","6.195511000","0.0001","N/A","N/A"
"244.3.160.204","24458","244.3.160.89","4000","2","128","1","64","1","64","8.193673000","0.0001","N/A","N/A"
"244.3.160.204","24460","244.3.160.89","4002","2","128","1","64","1","64","8.194162000","0.0001","N/A","N/A"
"244.3.160.204","25129","244.3.160.254","4001","2","128","1","64","1","64","12.195236000","0.0001","N/A","N/A"
"244.3.160.204","25474","244.3.160.239","8080","2","128","1","64","1","64","14.196587000","0.0001","N/A","N/A"
"244.3.160.204","27145","244.3.160.239","8080","2","128","1","64","1","64","24.199086000","0.0001","N/A","N/A"
"244.3.160.204","28144","244.3.160.254","2048","2","128","1","64","1","64","30.198802000","0.0001","N/A","N/A"
"244.3.160.204","28472","244.3.160.254","2784","2","128","1","64","1","64","32.198095000","0.0001","N/A","N/A"
"244.3.160.204","29136","244.3.160.89","2048","2","128","1","64","1","64","36.198093000","0.0001","N/A","N/A"
"244.3.160.204","29806","244.3.160.89","2785","2","128","1","64","1","64","40.198763000","0.0001","N/A","N/A"
"244.3.160.204","29817","244.3.160.239","8080","2","128","1","64","1","64","40.201724000","0.0001","N/A","N/A"
"244.3.160.204","31152","244.3.160.239","8080","2","128","1","64","1","64","48.208826000","0.0001","N/A","N/A"
"244.3.160.204","31482","244.3.160.254","2048","2","128","1","64","1","64","50.201129000","0.0001","N/A","N/A"
"244.3.160.204","32478","244.3.160.89","2785","2","128","1","64","1","64","56.201542000","0.0001","N/A","N/A"
"244.3.160.204","33483","244.3.160.254","2784","2","128","1","64","1","64","62.203360000","0.0001","N/A","N/A"
"244.3.160.204","33821","244.3.160.89","4002","2","128","1","64","1","64","64.203264000","0.0001","N/A","N/A"
"244.3.160.204","34488","244.3.160.254","4001","2","128","1","64","1","64","68.204913000","0.0001","N/A","N/A"
"244.3.160.204","35819","244.3.160.89","4002","2","128","1","64","1","64","76.204143000","0.0001","N/A","N/A"
"244.3.160.204","38836","244.3.160.254","2785","2","128","1","64","1","64","94.208661000","0.0001","N/A","N/A"
"244.3.160.204","39497","244.3.160.89","2784","2","128","1","64","1","64","98.207772000","0.0001","N/A","N/A"
"244.3.160.204","39831","244.3.160.89","4002","2","128","1","64","1","64","100.220391000","0.0001","N/A","N/A"
"244.3.160.204","41172","244.3.160.254","4001","2","128","1","64","1","64","108.216779000","0.0001","N/A","N/A"
"244.3.160.204","43175","244.3.160.89","4000","2","128","1","64","1","64","120.216806000","0.0001","N/A","N/A"
"244.3.160.204","44515","244.3.160.254","2784","2","128","1","64","1","64","128.219161000","0.0001","N/A","N/A"
"244.3.160.204","45181","244.3.160.254","4001","2","128","1","64","1","64","132.218328000","0.0001","N/A","N/A"
"244.3.160.204","45847","244.3.160.89","4000","2","128","1","64","1","64","136.218500000","0.0001","N/A","N/A"
"244.3.160.204","46516","244.3.160.89","2048","2","128","1","64","1","64","140.218362000","0.0001","N/A","N/A"
"244.3.160.204","46852","244.3.160.254","2785","2","128","1","64","1","64","142.220213000","0.0001","N/A","N/A"
"244.3.160.204","46855","244.3.160.254","4002","2","128","1","64","1","64","142.221032000","0.0001","N/A","N/A"
"244.3.160.204","47189","244.3.160.89","4002","2","128","1","64","1","64","144.218758000","0.0001","N/A","N/A"
"244.3.160.204","47192","244.3.160.254","2784","2","128","1","64","1","64","144.219568000","0.0001","N/A","N/A"
"244.3.160.204","47197","244.3.160.239","8080","2","128","1","64","1","64","144.220898000","0.0001","N/A","N/A"
"244.3.160.204","47856","244.3.160.254","4001","2","128","1","64","1","64","148.220123000","0.0001","N/A","N/A"
"244.3.160.204","48191","244.3.160.254","2784","2","128","1","64","1","64","150.219671000","0.0001","N/A","N/A"
"244.3.160.204","48529","244.3.160.239","8080","2","128","1","64","1","64","152.222228000","0.0001","N/A","N/A"
"244.3.160.204","49195","244.3.160.254","2048","2","128","1","64","1","64","156.221788000","0.0001","N/A","N/A"
"244.3.160.204","50194","244.3.160.254","2048","2","128","1","64","1","64","162.221068000","0.0001","N/A","N/A"
"244.3.160.204","50527","244.3.160.89","4002","2","128","1","64","1","64","164.219928000","0.0001","N/A","N/A"
"244.3.160.204","50531","244.3.160.89","2784","2","128","1","64","1","64","164.220952000","0.0001","N/A","N/A"
"244.3.160.204","50533","244.3.160.254","4001","2","128","1","64","1","64","164.221508000","0.0001","N/A","N/A"
"244.3.160.204","50859","244.3.160.89","4001","2","128","1","64","1","64","166.220507000","0.0001","N/A","N/A"
"244.3.160.204","51202","244.3.160.254","4001","2","128","1","64","1","64","168.222767000","0.0001","N/A","N/A"
"244.3.160.204","52869","244.3.160.254","2048","2","128","1","64","1","64","178.223468000","0.0001","N/A","N/A"
"244.3.160.204","52875","244.3.160.239","8080","2","128","1","64","1","64","178.225027000","0.0001","N/A","N/A"
"244.3.160.204","53199","244.3.160.89","4002","2","128","1","64","1","64","180.222028000","0.0001","N/A","N/A"
"244.3.160.204","53539","244.3.160.254","4002","2","128","1","64","1","64","182.224351000","0.0001","N/A","N/A"
"244.3.160.204","55209","244.3.160.254","2785","2","128","1","64","1","64","192.225004000","0.0001","N/A","N/A"
"244.3.160.204","56215","244.3.160.254","2048","2","128","1","64","1","64","198.226147000","0.0001","N/A","N/A"
"244.3.160.204","56548","244.3.160.254","2784","2","128","1","64","1","64","200.225839000","0.0001","N/A","N/A"
"244.3.160.204","56878","244.3.160.254","2048","2","128","1","64","1","64","202.225636000","0.0001","N/A","N/A"
"244.3.160.204","57215","244.3.160.89","2784","2","128","1","64","1","64","204.225781000","0.0001","N/A","N/A"
"244.3.160.204","57886","244.3.160.254","4001","2","128","1","64","1","64","208.227429000","0.0001","N/A","N/A"
"244.3.160.204","58221","244.3.160.254","2784","2","128","1","64","1","64","210.228182000","0.0001","N/A","N/A"
"244.3.160.204","58543","244.3.160.89","4002","2","128","1","64","1","64","212.226188000","0.0001","N/A","N/A"
"244.3.160.204","59550","244.3.160.89","2785","2","128","1","64","1","64","218.227505000","0.0001","N/A","N/A"
"244.3.160.204","59551","244.3.160.89","4000","2","128","1","64","1","64","218.227754000","0.0001","N/A","N/A"
"244.3.160.204","59895","244.3.160.239","8080","2","128","1","64","1","64","220.230987000","0.0001","N/A","N/A"
"244.3.160.204","60886","244.3.160.89","2784","2","128","1","64","1","64","226.229633000","0.0001","N/A","N/A"
"244.3.160.204","61222","244.3.160.89","2784","2","128","1","64","1","64","228.229604000","0.0001","N/A","N/A"
"244.3.160.204","61897","244.3.160.239","8080","2","128","1","64","1","64","232.232721000","0.0001","N/A","N/A"
"244.3.160.204","62226","244.3.160.89","2784","2","128","1","64","1","64","234.229823000","0.0001","N/A","N/A"
"244.3.160.204","62233","244.3.160.254","2784","2","128","1","64","1","64","234.231560000","0.0001","N/A","N/A"
"244.3.160.204","50190","244.3.160.89","2784","2","128","1","64","1","64","162.220014000","0.0001","N/A","N/A"
"244.3.160.204","53530","244.3.160.89","4000","2","128","1","64","1","64","182.222031000","0.0001","N/A","N/A"
"244.3.160.204","53542","244.3.160.239","8080","2","128","1","64","1","64","182.225204000","0.0001","N/A","N/A"
"244.3.160.204","53872","244.3.160.89","4001","2","128","1","64","1","64","184.223155000","0.0001","N/A","N/A"
"244.3.160.204","55544","244.3.160.89","4000","2","128","1","64","1","64","194.224260000","0.0001","N/A","N/A"
"244.3.160.204","55871","244.3.160.89","4002","2","128","1","64","1","64","196.223819000","0.0001","N/A","N/A"
"244.3.160.204","56553","244.3.160.239","8080","2","128","1","64","1","64","200.227208000","0.0001","N/A","N/A"
"244.3.160.204","56881","244.3.160.254","2784","2","128","1","64","1","64","202.226431000","0.0001","N/A","N/A"
"244.3.160.204","58224","244.3.160.239","8080","2","128","1","64","1","64","210.229033000","0.0001","N/A","N/A"
"244.3.160.204","59553","244.3.160.254","2048","2","128","1","64","1","64","218.228279000","0.0001","N/A","N/A"
"244.3.160.204","60557","244.3.160.89","4002","2","128","1","64","1","64","224.229675000","0.0001","N/A","N/A"
"244.3.160.204","61219","244.3.160.89","2048","2","128","1","64","1","64","228.228863000","0.0001","N/A","N/A"
"244.3.160.204","61230","244.3.160.239","8080","2","128","1","64","1","64","228.231790000","0.0001","N/A","N/A"
"244.3.160.204","61554","244.3.160.89","4000","2","128","1","64","1","64","230.229584000","0.0001","N/A","N/A"
"244.3.160.204","34827","244.3.160.254","4002","2","128","1","64","1","64","70.205379000","0.0001","N/A","N/A"
"244.3.160.204","35152","244.3.160.89","4001","2","128","1","64","1","64","72.204180000","0.0001","N/A","N/A"
"244.3.160.204","35161","244.3.160.239","8080","2","128","1","64","1","64","72.206650000","0.0001","N/A","N/A"
"244.3.160.204","35823","244.3.160.89","2784","2","128","1","64","1","64","76.205209000","0.0001","N/A","N/A"
"244.3.160.204","36822","244.3.160.89","2784","2","128","1","64","1","64","82.205287000","0.0001","N/A","N/A"
"244.3.160.204","36830","244.3.160.254","2785","2","128","1","64","1","64","82.207411000","0.0001","N/A","N/A"
"244.3.160.204","36832","244.3.160.239","8080","2","128","1","64","1","64","82.207967000","0.0001","N/A","N/A"
"244.3.160.204","38838","244.3.160.254","4001","2","128","1","64","1","64","94.209178000","0.0001","N/A","N/A"
"244.3.160.204","40165","244.3.160.89","2048","2","128","1","64","1","64","102.215531000","0.0001","N/A","N/A"
"244.3.160.204","40505","244.3.160.89","4002","2","128","1","64","1","64","104.215852000","0.0001","N/A","N/A"
"244.3.160.204","41166","244.3.160.89","4002","2","128","1","64","1","64","108.215184000","0.0001","N/A","N/A"
"244.3.160.204","41503","244.3.160.89","4001","2","128","1","64","1","64","110.215533000","0.0001","N/A","N/A"
"244.3.160.204","41505","244.3.160.89","2048","2","128","1","64","1","64","110.216045000","0.0001","N/A","N/A"
"244.3.160.204","41845","244.3.160.239","8080","2","128","1","64","1","64","112.218667000","0.0001","N/A","N/A"
"244.3.160.204","42838","244.3.160.89","4001","2","128","1","64","1","64","118.216073000","0.0001","N/A","N/A"
"244.3.160.204","42843","244.3.160.254","2785","2","128","1","64","1","64","118.217378000","0.0001","N/A","N/A"
"244.3.160.204","43843","244.3.160.89","4002","2","128","1","64","1","64","124.216533000","0.0001","N/A","N/A"
"244.3.160.204","24794","244.3.160.89","2784","2","128","1","64","1","64","10.193425000","0.0001","N/A","N/A"
"244.3.160.204","24796","244.3.160.89","4000","2","128","1","64","1","64","10.193940000","0.0001","N/A","N/A"
"244.3.160.204","24798","244.3.160.254","2048","2","128","1","64","1","64","10.194467000","0.0001","N/A","N/A"
"244.3.160.204","25794","244.3.160.89","2785","2","128","1","64","1","64","16.194827000","0.0001","N/A","N/A"
"244.3.160.204","25795","244.3.160.89","4000","2","128","1","64","1","64","16.195107000","0.0001","N/A","N/A"
"244.3.160.204","26795","244.3.160.89","4001","2","128","1","64","1","64","22.194688000","0.0001","N/A","N/A"
"244.3.160.204","26802","244.3.160.254","4001","2","128","1","64","1","64","22.196482000","0.0001","N/A","N/A"
"244.3.160.204","26806","244.3.160.239","8080","2","128","1","64","1","64","22.197567000","0.0001","N/A","N/A"
"244.3.160.204","27143","244.3.160.254","4001","2","128","1","64","1","64","24.198517000","0.0001","N/A","N/A"
"244.3.160.204","27474","244.3.160.254","2785","2","128","1","64","1","64","26.198114000","0.0001","N/A","N/A"
"244.3.160.204","28477","244.3.160.239","8080","2","128","1","64","1","64","32.199495000","0.0001","N/A","N/A"
"244.3.160.204","28813","244.3.160.254","2784","2","128","1","64","1","64","34.199126000","0.0001","N/A","N/A"
"244.3.160.204","29472","244.3.160.89","2048","2","128","1","64","1","64","38.198374000","0.0001","N/A","N/A"
"244.3.160.204","29475","244.3.160.254","2785","2","128","1","64","1","64","38.199211000","0.0001","N/A","N/A"
"244.3.160.204","29807","244.3.160.89","4000","2","128","1","64","1","64","40.199039000","0.0001","N/A","N/A"
"244.3.160.204","30479","244.3.160.89","2784","2","128","1","64","1","64","44.199539000","0.0001","N/A","N/A"
"244.3.160.204","30481","244.3.160.254","4001","2","128","1","64","1","64","44.200082000","0.0001","N/A","N/A"
"244.3.160.204","30483","244.3.160.254","2048","2","128","1","64","1","64","44.200611000","0.0001","N/A","N/A"
"244.3.160.204","30487","244.3.160.239","8080","2","128","1","64","1","64","44.201718000","0.0001","N/A","N/A"
"244.3.160.204","30811","244.3.160.254","2784","2","128","1","64","1","64","46.200393000","0.0001","N/A","N/A"
"244.3.160.204","31479","244.3.160.89","2785","2","128","1","64","1","64","50.200310000","0.0001","N/A","N/A"
"244.3.160.204","31481","244.3.160.254","4002","2","128","1","64","1","64","50.200869000","0.0001","N/A","N/A"
"244.3.160.204","31485","244.3.160.254","2784","2","128","1","64","1","64","50.201934000","0.0001","N/A","N/A"
"244.3.160.204","31814","244.3.160.254","4002","2","128","1","64","1","64","52.201724000","0.0001","N/A","N/A"
"244.3.160.204","32146","244.3.160.89","4000","2","128","1","64","1","64","54.199979000","0.0001","N/A","N/A"
"244.3.160.204","32149","244.3.160.89","2048","2","128","1","64","1","64","54.200736000","0.0001","N/A","N/A"
"244.3.160.204","32815","244.3.160.89","4000","2","128","1","64","1","64","58.201966000","0.0001","N/A","N/A"
"244.3.160.204","32823","244.3.160.239","8080","2","128","1","64","1","64","58.204130000","0.0001","N/A","N/A"
"244.3.160.204","33481","244.3.160.89","2048","2","128","1","64","1","64","62.202849000","0.0001","N/A","N/A"
"244.3.160.204","23124","244.3.160.89","4001","2","128","1","64","1","64","0.192326000","0.0001","N/A","N/A"
"244.3.160.204","23455","244.3.160.89","2785","2","128","1","64","1","64","2.192241000","0.0001","N/A","N/A"
"244.3.160.204","23458","244.3.160.254","2048","2","128","1","64","1","64","2.193050000","0.0001","N/A","N/A"
"244.3.160.204","23461","244.3.160.254","2784","2","128","1","64","1","64","2.193811000","0.0001","N/A","N/A"
"244.3.160.204","23799","244.3.160.254","2048","2","128","1","64","1","64","4.193848000","0.0001","N/A","N/A"
"244.3.160.204","24128","244.3.160.254","2785","2","128","1","64","1","64","6.194992000","0.0001","N/A","N/A"
"244.3.160.204","25464","244.3.160.89","4002","2","128","1","64","1","64","14.193941000","0.0001","N/A","N/A"
"244.3.160.204","25465","244.3.160.89","2048","2","128","1","64","1","64","14.194181000","0.0001","N/A","N/A"
"244.3.160.204","26464","244.3.160.89","2048","2","128","1","64","1","64","20.195108000","0.0001","N/A","N/A"
"244.3.160.204","27469","244.3.160.254","4002","2","128","1","64","1","64","26.196833000","0.0001","N/A","N/A"
"244.3.160.204","27476","244.3.160.239","8080","2","128","1","64","1","64","26.198633000","0.0001","N/A","N/A"
"244.3.160.204","28137","244.3.160.89","2048","2","128","1","64","1","64","30.196874000","0.0001","N/A","N/A"
"244.3.160.204","28146","244.3.160.239","8080","2","128","1","64","1","64","30.199307000","0.0001","N/A","N/A"
"244.3.160.204","32814","244.3.160.89","2785","2","128","1","64","1","64","58.201711000","0.0001","N/A","N/A"
"244.3.160.204","33827","244.3.160.254","4001","2","128","1","64","1","64","64.204818000","0.0001","N/A","N/A"
"244.3.160.204","34482","244.3.160.89","4002","2","128","1","64","1","64","68.203359000","0.0001","N/A","N/A"
"244.3.160.204","35491","244.3.160.89","2785","2","128","1","64","1","64","74.204401000","0.0001","N/A","N/A"
"244.3.160.204","36496","244.3.160.254","2784","2","128","1","64","1","64","80.206181000","0.0001","N/A","N/A"
"244.3.160.204","37166","244.3.160.254","4002","2","128","1","64","1","64","84.206879000","0.0001","N/A","N/A"
"244.3.160.204","38166","244.3.160.254","2048","2","128","1","64","1","64","90.207846000","0.0001","N/A","N/A"
"244.3.160.204","38498","244.3.160.254","4002","2","128","1","64","1","64","92.208115000","0.0001","N/A","N/A"
"244.3.160.204","39171","244.3.160.254","4001","2","128","1","64","1","64","96.209962000","0.0001","N/A","N/A"
"244.3.160.204","40170","244.3.160.254","4001","2","128","1","64","1","64","102.216859000","0.0001","N/A","N/A"
"244.3.160.204","41167","244.3.160.89","2048","2","128","1","64","1","64","108.215438000","0.0001","N/A","N/A"
"244.3.160.204","41835","244.3.160.89","4000","2","128","1","64","1","64","112.216037000","0.0001","N/A","N/A"
"244.3.160.204","42845","244.3.160.254","4001","2","128","1","64","1","64","118.217888000","0.0001","N/A","N/A"
"244.3.160.204","43507","244.3.160.89","2785","2","128","1","64","1","64","122.216998000","0.0001","N/A","N/A"
"244.3.160.204","43844","244.3.160.89","2048","2","128","1","64","1","64","124.216756000","0.0001","N/A","N/A"
"244.3.160.204","44184","244.3.160.254","2048","2","128","1","64","1","64","126.219896000","0.0001","N/A","N/A"
"244.3.160.204","44509","244.3.160.89","2785","2","128","1","64","1","64","128.217588000","0.0001","N/A","N/A"
"244.3.160.204","44516","244.3.160.254","2785","2","128","1","64","1","64","128.219437000","0.0001","N/A","N/A"
"244.3.160.204","44518","244.3.160.254","4001","2","128","1","64","1","64","128.219945000","0.0001","N/A","N/A"
"244.3.160.204","44520","244.3.160.239","8080","2","128","1","64","1","64","128.220519000","0.0001","N/A","N/A"
"244.3.160.204","44853","244.3.160.254","2784","2","128","1","64","1","64","130.219661000","0.0001","N/A","N/A"
"244.3.160.204","45857","244.3.160.239","8080","2","128","1","64","1","64","136.221177000","0.0001","N/A","N/A"
"244.3.160.204","46189","244.3.160.254","2785","2","128","1","64","1","64","138.220225000","0.0001","N/A","N/A"
"244.3.160.204","46521","244.3.160.254","4001","2","128","1","64","1","64","140.219696000","0.0001","N/A","N/A"
"244.3.160.204","46848","244.3.160.89","4002","2","128","1","64","1","64","142.219139000","0.0001","N/A","N/A"
"244.3.160.204","47850","244.3.160.89","4002","2","128","1","64","1","64","148.218550000","0.0001","N/A","N/A"
"244.3.160.204","47851","244.3.160.89","2048","2","128","1","64","1","64","148.218812000","0.0001","N/A","N/A"
"244.3.160.204","47858","244.3.160.254","2048","2","128","1","64","1","64","148.220642000","0.0001","N/A","N/A"
"244.3.160.204","48189","244.3.160.89","2048","2","128","1","64","1","64","150.219154000","0.0001","N/A","N/A"
"244.3.160.204","48866","244.3.160.254","2785","2","128","1","64","1","64","154.221521000","0.0001","N/A","N/A"
"244.3.160.204","50539","244.3.160.239","8080","2","128","1","64","1","64","164.223162000","0.0001","N/A","N/A"
"244.3.160.204","52199","244.3.160.89","4001","2","128","1","64","1","64","174.221799000","0.0001","N/A","N/A"
"244.3.160.204","52200","244.3.160.89","4002","2","128","1","64","1","64","174.222080000","0.0001","N/A","N/A"
"244.3.160.204","52201","244.3.160.89","2048","2","128","1","64","1","64","174.222310000","0.0001","N/A","N/A"
"244.3.160.204","52207","244.3.160.254","4002","2","128","1","64","1","64","174.223895000","0.0001","N/A","N/A"
"244.3.160.204","52208","244.3.160.254","2048","2","128","1","64","1","64","174.224156000","0.0001","N/A","N/A"
"244.3.160.204","52532","244.3.160.89","4001","2","128","1","64","1","64","176.222656000","0.0001","N/A","N/A"
"244.3.160.204","52537","244.3.160.254","2785","2","128","1","64","1","64","176.223969000","0.0001","N/A","N/A"
"244.3.160.204","52867","244.3.160.89","4000","2","128","1","64","1","64","178.222967000","0.0001","N/A","N/A"
"244.3.160.204","52873","244.3.160.254","2785","2","128","1","64","1","64","178.224499000","0.0001","N/A","N/A"
"244.3.160.204","54538","244.3.160.89","2784","2","128","1","64","1","64","188.223715000","0.0001","N/A","N/A"
"244.3.160.204","54872","244.3.160.89","4002","2","128","1","64","1","64","190.223184000","0.0001","N/A","N/A"
"244.3.160.204","54876","244.3.160.254","2785","2","128","1","64","1","64","190.224227000","0.0001","N/A","N/A"
"244.3.160.204","55208","244.3.160.254","2784","2","128","1","64","1","64","192.224745000","0.0001","N/A","N/A"
"244.3.160.204","55552","244.3.160.239","8080","2","128","1","64","1","64","194.226501000","0.0001","N/A","N/A"
"244.3.160.204","55875","244.3.160.89","2784","2","128","1","64","1","64","196.224848000","0.0001","N/A","N/A"
"244.3.160.204","56206","244.3.160.89","4001","2","128","1","64","1","64","198.223721000","0.0001","N/A","N/A"
"244.3.160.204","56874","244.3.160.89","2784","2","128","1","64","1","64","202.224566000","0.0001","N/A","N/A"
"244.3.160.204","56882","244.3.160.254","2785","2","128","1","64","1","64","202.226676000","0.0001","N/A","N/A"
"244.3.160.204","57218","244.3.160.254","4002","2","128","1","64","1","64","204.226591000","0.0001","N/A","N/A"
"244.3.160.204","58891","244.3.160.254","4002","2","128","1","64","1","64","214.228914000","0.0001","N/A","N/A"
"244.3.160.204","58892","244.3.160.254","2048","2","128","1","64","1","64","214.229243000","0.0001","N/A","N/A"
"244.3.160.204","59223","244.3.160.254","4001","2","128","1","64","1","64","216.229581000","0.0001","N/A","N/A"
"244.3.160.204","59549","244.3.160.89","2784","2","128","1","64","1","64","218.227235000","0.0001","N/A","N/A"
"244.3.160.204","61560","244.3.160.254","2785","2","128","1","64","1","64","230.231155000","0.0001","N/A","N/A"
"244.3.160.204","62227","244.3.160.89","2785","2","128","1","64","1","64","234.230052000","0.0001","N/A","N/A"
"244.3.160.204","62236","244.3.160.239","8080","2","128","1","64","1","64","234.232373000","0.0001","N/A","N/A"
"244.3.160.204","46184","244.3.160.254","4002","2","128","1","64","1","64","138.218890000","0.0001","N/A","N/A"
"244.3.160.204","46527","244.3.160.239","8080","2","128","1","64","1","64","140.221344000","0.0001","N/A","N/A"
"244.3.160.204","51540","244.3.160.239","8080","2","128","1","64","1","64","170.223956000","0.0001","N/A","N/A"
"244.3.160.204","55203","244.3.160.89","4000","2","128","1","64","1","64","192.223449000","0.0001","N/A","N/A"
"244.3.160.204","55213","244.3.160.239","8080","2","128","1","64","1","64","192.226106000","0.0001","N/A","N/A"
"244.3.160.204","55542","244.3.160.89","2784","2","128","1","64","1","64","194.223765000","0.0001","N/A","N/A"
"244.3.160.204","57548","244.3.160.254","2785","2","128","1","64","1","64","206.227400000","0.0001","N/A","N/A"
"244.3.160.204","57554","244.3.160.239","8080","2","128","1","64","1","64","206.229010000","0.0001","N/A","N/A"
"244.3.160.204","33829","244.3.160.239","8080","2","128","1","64","1","64","64.205435000","0.0001","N/A","N/A"
"244.3.160.204","34490","244.3.160.254","2048","2","128","1","64","1","64","68.205519000","0.0001","N/A","N/A"
"244.3.160.204","35498","244.3.160.254","2785","2","128","1","64","1","64","74.206262000","0.0001","N/A","N/A"
"244.3.160.204","38839","244.3.160.254","4002","2","128","1","64","1","64","94.209470000","0.0001","N/A","N/A"
"244.3.160.204","38840","244.3.160.254","2048","2","128","1","64","1","64","94.209729000","0.0001","N/A","N/A"
"244.3.160.204","29481","244.3.160.239","8080","2","128","1","64","1","64","38.200753000","0.0001","N/A","N/A"
"244.3.160.204","29808","244.3.160.89","4001","2","128","1","64","1","64","40.199324000","0.0001","N/A","N/A"
"244.3.160.204","29813","244.3.160.254","2785","2","128","1","64","1","64","40.200640000","0.0001","N/A","N/A"
"244.3.160.204","30139","244.3.160.89","2785","2","128","1","64","1","64","42.199155000","0.0001","N/A","N/A"
"244.3.160.204","30140","244.3.160.89","4000","2","128","1","64","1","64","42.199411000","0.0001","N/A","N/A"
"244.3.160.204","30142","244.3.160.254","2048","2","128","1","64","1","64","42.199937000","0.0001","N/A","N/A"
"244.3.160.204","31141","244.3.160.89","2785","2","128","1","64","1","64","48.205178000","0.0001","N/A","N/A"
"244.3.160.204","31480","244.3.160.89","4000","2","128","1","64","1","64","50.200567000","0.0001","N/A","N/A"
"244.3.160.204","31808","244.3.160.89","2048","2","128","1","64","1","64","52.200148000","0.0001","N/A","N/A"
"244.3.160.204","32147","244.3.160.89","4001","2","128","1","64","1","64","54.200334000","0.0001","N/A","N/A"
"244.3.160.204","32154","244.3.160.254","4001","2","128","1","64","1","64","54.202115000","0.0001","N/A","N/A"
"244.3.160.204","32816","244.3.160.254","4002","2","128","1","64","1","64","58.202239000","0.0001","N/A","N/A"
"244.3.160.204","32820","244.3.160.254","2784","2","128","1","64","1","64","58.203289000","0.0001","N/A","N/A"
"244.3.160.204","24457","244.3.160.89","2785","2","128","1","64","1","64","8.193421000","0.0001","N/A","N/A"
"244.3.160.204","24459","244.3.160.89","4001","2","128","1","64","1","64","8.193915000","0.0001","N/A","N/A"
"244.3.160.204","24464","244.3.160.254","2785","2","128","1","64","1","64","8.195261000","0.0001","N/A","N/A"
"244.3.160.204","24466","244.3.160.254","4001","2","128","1","64","1","64","8.195810000","0.0001","N/A","N/A"
"244.3.160.204","24797","244.3.160.254","4002","2","128","1","64","1","64","10.194209000","0.0001","N/A","N/A"
"244.3.160.204","25131","244.3.160.254","2048","2","128","1","64","1","64","12.195733000","0.0001","N/A","N/A"
"244.3.160.204","25463","244.3.160.89","4001","2","128","1","64","1","64","14.193654000","0.0001","N/A","N/A"
"244.3.160.204","25797","244.3.160.89","4002","2","128","1","64","1","64","16.195622000","0.0001","N/A","N/A"
"244.3.160.204","25803","244.3.160.254","4001","2","128","1","64","1","64","16.197262000","0.0001","N/A","N/A"
"244.3.160.204","26133","244.3.160.254","2048","2","128","1","64","1","64","18.195329000","0.0001","N/A","N/A"
"244.3.160.204","26139","244.3.160.239","8080","2","128","1","64","1","64","18.196903000","0.0001","N/A","N/A"
"244.3.160.204","26470","244.3.160.254","4002","2","128","1","64","1","64","20.196700000","0.0001","N/A","N/A"
"244.3.160.204","26475","244.3.160.239","8080","2","128","1","64","1","64","20.198021000","0.0001","N/A","N/A"
"244.3.160.204","26796","244.3.160.89","4002","2","128","1","64","1","64","22.194916000","0.0001","N/A","N/A"
"244.3.160.204","28142","244.3.160.254","4001","2","128","1","64","1","64","30.198238000","0.0001","N/A","N/A"
"244.3.160.204","29477","244.3.160.254","4001","2","128","1","64","1","64","38.199683000","0.0001","N/A","N/A"
"244.3.160.204","31813","244.3.160.254","4001","2","128","1","64","1","64","52.201464000","0.0001","N/A","N/A"
"244.3.160.204","33479","244.3.160.89","4001","2","128","1","64","1","64","62.202297000","0.0001","N/A","N/A"
"244.3.160.204","33484","244.3.160.254","2785","2","128","1","64","1","64","62.203617000","0.0001","N/A","N/A"
"244.3.160.204","33487","244.3.160.254","4002","2","128","1","64","1","64","62.204411000","0.0001","N/A","N/A"
"244.3.160.204","34160","244.3.160.239","8080","2","128","1","64","1","64","66.212053000","0.0001","N/A","N/A"
"244.3.160.204","34494","244.3.160.239","8080","2","128","1","64","1","64","68.206590000","0.0001","N/A","N/A"
"244.3.160.204","34823","244.3.160.254","2784","2","128","1","64","1","64","70.204294000","0.0001","N/A","N/A"
"244.3.160.204","35153","244.3.160.89","4002","2","128","1","64","1","64","72.204404000","0.0001","N/A","N/A"
"244.3.160.204","36491","244.3.160.89","4000","2","128","1","64","1","64","80.204852000","0.0001","N/A","N/A"
"244.3.160.204","37500","244.3.160.254","2048","2","128","1","64","1","64","86.209118000","0.0001","N/A","N/A"
"244.3.160.204","37832","244.3.160.254","2785","2","128","1","64","1","64","88.208081000","0.0001","N/A","N/A"
"244.3.160.204","38491","244.3.160.89","4002","2","128","1","64","1","64","92.206277000","0.0001","N/A","N/A"
"244.3.160.204","38499","244.3.160.254","2048","2","128","1","64","1","64","92.208346000","0.0001","N/A","N/A"
"244.3.160.204","39504","244.3.160.254","2784","2","128","1","64","1","64","98.209580000","0.0001","N/A","N/A"
"244.3.160.204","40162","244.3.160.89","4000","2","128","1","64","1","64","102.214771000","0.0001","N/A","N/A"
"244.3.160.204","42178","244.3.160.254","2048","2","128","1","64","1","64","114.217444000","0.0001","N/A","N/A"
"244.3.160.204","42184","244.3.160.239","8080","2","128","1","64","1","64","114.218995000","0.0001","N/A","N/A"
"244.3.160.204","43506","244.3.160.89","2784","2","128","1","64","1","64","122.216770000","0.0001","N/A","N/A"
"244.3.160.204","43509","244.3.160.254","4002","2","128","1","64","1","64","122.217516000","0.0001","N/A","N/A"
"244.3.160.204","44176","244.3.160.89","4002","2","128","1","64","1","64","126.217759000","0.0001","N/A","N/A"
"244.3.160.204","44846","244.3.160.89","2784","2","128","1","64","1","64","130.217826000","0.0001","N/A","N/A"
"244.3.160.204","44847","244.3.160.89","2785","2","128","1","64","1","64","130.218069000","0.0001","N/A","N/A"
"244.3.160.204","45515","244.3.160.89","4001","2","128","1","64","1","64","134.217670000","0.0001","N/A","N/A"
"244.3.160.204","45520","244.3.160.254","2785","2","128","1","64","1","64","134.218978000","0.0001","N/A","N/A"
"244.3.160.204","45524","244.3.160.254","2048","2","128","1","64","1","64","134.220029000","0.0001","N/A","N/A"
"244.3.160.204","46849","244.3.160.89","2048","2","128","1","64","1","64","142.219410000","0.0001","N/A","N/A"
"244.3.160.204","47193","244.3.160.254","2785","2","128","1","64","1","64","144.219820000","0.0001","N/A","N/A"
"244.3.160.204","47519","244.3.160.89","2785","2","128","1","64","1","64","146.219552000","0.0001","N/A","N/A"
"244.3.160.204","47522","244.3.160.254","2048","2","128","1","64","1","64","146.220358000","0.0001","N/A","N/A"
"244.3.160.204","47862","244.3.160.239","8080","2","128","1","64","1","64","148.221724000","0.0001","N/A","N/A"
"244.3.160.204","48188","244.3.160.89","4002","2","128","1","64","1","64","150.218885000","0.0001","N/A","N/A"
"244.3.160.204","48194","244.3.160.254","4001","2","128","1","64","1","64","150.220461000","0.0001","N/A","N/A"
"244.3.160.204","48521","244.3.160.89","4002","2","128","1","64","1","64","152.220021000","0.0001","N/A","N/A"
"244.3.160.204","49529","244.3.160.254","4001","2","128","1","64","1","64","158.220924000","0.0001","N/A","N/A"
"244.3.160.204","50535","244.3.160.254","2048","2","128","1","64","1","64","164.222025000","0.0001","N/A","N/A"
"244.3.160.204","51533","244.3.160.254","4002","2","128","1","64","1","64","170.222095000","0.0001","N/A","N/A"
"244.3.160.204","51866","244.3.160.254","4002","2","128","1","64","1","64","172.223166000","0.0001","N/A","N/A"
"244.3.160.204","52533","244.3.160.89","4002","2","128","1","64","1","64","176.222899000","0.0001","N/A","N/A"
"244.3.160.204","52541","244.3.160.239","8080","2","128","1","64","1","64","176.225053000","0.0001","N/A","N/A"
"244.3.160.204","54205","244.3.160.254","4002","2","128","1","64","1","64","186.224374000","0.0001","N/A","N/A"
"244.3.160.204","54206","244.3.160.254","2048","2","128","1","64","1","64","186.224624000","0.0001","N/A","N/A"
"244.3.160.204","54546","244.3.160.239","8080","2","128","1","64","1","64","188.225946000","0.0001","N/A","N/A"
"244.3.160.204","55204","244.3.160.89","4001","2","128","1","64","1","64","192.223694000","0.0001","N/A","N/A"
"244.3.160.204","55211","244.3.160.254","4001","2","128","1","64","1","64","192.225573000","0.0001","N/A","N/A"
"244.3.160.204","56205","244.3.160.89","4000","2","128","1","64","1","64","198.223554000","0.0001","N/A","N/A"
"244.3.160.204","56217","244.3.160.239","8080","2","128","1","64","1","64","198.226683000","0.0001","N/A","N/A"
"244.3.160.204","56543","244.3.160.89","4000","2","128","1","64","1","64","200.224526000","0.0001","N/A","N/A"
"244.3.160.204","56544","244.3.160.89","4001","2","128","1","64","1","64","200.224731000","0.0001","N/A","N/A"
"244.3.160.204","57219","244.3.160.254","2048","2","128","1","64","1","64","204.226850000","0.0001","N/A","N/A"
"244.3.160.204","57545","244.3.160.89","2048","2","128","1","64","1","64","206.226585000","0.0001","N/A","N/A"
"244.3.160.204","58214","244.3.160.89","2784","2","128","1","64","1","64","210.226254000","0.0001","N/A","N/A"
"244.3.160.204","58216","244.3.160.89","4000","2","128","1","64","1","64","210.226774000","0.0001","N/A","N/A"
"244.3.160.204","58218","244.3.160.254","2048","2","128","1","64","1","64","210.227327000","0.0001","N/A","N/A"
"244.3.160.204","58222","244.3.160.254","2785","2","128","1","64","1","64","210.228452000","0.0001","N/A","N/A"
"244.3.160.204","58555","244.3.160.239","8080","2","128","1","64","1","64","212.229437000","0.0001","N/A","N/A"
"244.3.160.204","58884","244.3.160.89","4002","2","128","1","64","1","64","214.227057000","0.0001","N/A","N/A"
"244.3.160.204","59214","244.3.160.89","2785","2","128","1","64","1","64","216.227161000","0.0001","N/A","N/A"
"244.3.160.204","60222","244.3.160.254","4001","2","128","1","64","1","64","222.229626000","0.0001","N/A","N/A"
"244.3.160.204","60556","244.3.160.89","4001","2","128","1","64","1","64","224.229429000","0.0001","N/A","N/A"
"244.3.160.204","60561","244.3.160.254","2785","2","128","1","64","1","64","224.230746000","0.0001","N/A","N/A"
"244.3.160.204","61224","244.3.160.254","4001","2","128","1","64","1","64","228.230177000","0.0001","N/A","N/A"
"244.3.160.204","61564","244.3.160.254","2048","2","128","1","64","1","64","230.232208000","0.0001","N/A","N/A"
"244.3.160.204","56214","244.3.160.254","4002","2","128","1","64","1","64","198.225881000","0.0001","N/A","N/A"
"244.3.160.204","34489","244.3.160.254","4002","2","128","1","64","1","64","68.205216000","0.0001","N/A","N/A"
"244.3.160.204","29471","244.3.160.89","4002","2","128","1","64","1","64","38.198128000","0.0001","N/A","N/A"
"244.3.160.204","30482","244.3.160.254","4002","2","128","1","64","1","64","44.200337000","0.0001","N/A","N/A"
"244.3.160.204","31819","244.3.160.239","8080","2","128","1","64","1","64","52.203115000","0.0001","N/A","N/A"
"244.3.160.204","26130","244.3.160.89","2785","2","128","1","64","1","64","18.194515000","0.0001","N/A","N/A"
"244.3.160.204","26132","244.3.160.254","4002","2","128","1","64","1","64","18.195019000","0.0001","N/A","N/A"
"244.3.160.204","25468","244.3.160.254","2785","2","128","1","64","1","64","14.194960000","0.0001","N/A","N/A"
"244.3.160.204","23456","244.3.160.89","4000","2","128","1","64","1","64","2.192506000","0.0001","N/A","N/A"
"244.3.160.204","23462","244.3.160.254","2785","2","128","1","64","1","64","2.194102000","0.0001","N/A","N/A"
"244.3.160.204","23122","244.3.160.89","2785","2","128","1","64","1","64","0.191828000","0.0001","N/A","N/A"
"244.3.160.204","26804","244.3.160.254","2048","2","128","1","64","1","64","22.197064000","0.0001","N/A","N/A"
"244.3.160.204","27467","244.3.160.89","2785","2","128","1","64","1","64","26.196300000","0.0001","N/A","N/A"
"244.3.160.204","27804","244.3.160.254","4001","2","128","1","64","1","64","28.197536000","0.0001","N/A","N/A"
"244.3.160.204","28807","244.3.160.89","2785","2","128","1","64","1","64","34.197561000","0.0001","N/A","N/A"
"244.3.160.204","28814","244.3.160.254","2785","2","128","1","64","1","64","34.199378000","0.0001","N/A","N/A"
"244.3.160.204","30146","244.3.160.254","2785","2","128","1","64","1","64","42.200994000","0.0001","N/A","N/A"
"244.3.160.204","30807","244.3.160.89","4001","2","128","1","64","1","64","46.199348000","0.0001","N/A","N/A"
"244.3.160.204","32148","244.3.160.89","4002","2","128","1","64","1","64","54.200531000","0.0001","N/A","N/A"
"244.3.160.204","32158","244.3.160.239","8080","2","128","1","64","1","64","54.203127000","0.0001","N/A","N/A"
"244.3.160.204","33153","244.3.160.254","4001","2","128","1","64","1","64","60.204224000","0.0001","N/A","N/A"
"244.3.160.204","33480","244.3.160.89","4002","2","128","1","64","1","64","62.202549000","0.0001","N/A","N/A"
"244.3.160.204","34828","244.3.160.254","2048","2","128","1","64","1","64","70.205665000","0.0001","N/A","N/A"
"244.3.160.204","35825","244.3.160.254","4001","2","128","1","64","1","64","76.205750000","0.0001","N/A","N/A"
"244.3.160.204","35826","244.3.160.254","4002","2","128","1","64","1","64","76.206051000","0.0001","N/A","N/A"
"244.3.160.204","36499","244.3.160.254","4001","2","128","1","64","1","64","80.206975000","0.0001","N/A","N/A"
"244.3.160.204","36501","244.3.160.239","8080","2","128","1","64","1","64","80.207547000","0.0001","N/A","N/A"
"244.3.160.204","37163","244.3.160.89","2784","2","128","1","64","1","64","84.206058000","0.0001","N/A","N/A"
"244.3.160.204","37490","244.3.160.89","4000","2","128","1","64","1","64","86.206371000","0.0001","N/A","N/A"
"244.3.160.204","37836","244.3.160.239","8080","2","128","1","64","1","64","88.209161000","0.0001","N/A","N/A"
"244.3.160.204","38163","244.3.160.89","2785","2","128","1","64","1","64","90.207060000","0.0001","N/A","N/A"
"244.3.160.204","38831","244.3.160.89","4001","2","128","1","64","1","64","94.207308000","0.0001","N/A","N/A"
"244.3.160.204","39173","244.3.160.239","8080","2","128","1","64","1","64","96.210477000","0.0001","N/A","N/A"
"244.3.160.204","39501","244.3.160.254","2048","2","128","1","64","1","64","98.208809000","0.0001","N/A","N/A"
"244.3.160.204","40172","244.3.160.254","2048","2","128","1","64","1","64","102.217402000","0.0001","N/A","N/A"
"244.3.160.204","40508","244.3.160.254","2784","2","128","1","64","1","64","104.216646000","0.0001","N/A","N/A"
"244.3.160.204","40509","244.3.160.254","2785","2","128","1","64","1","64","104.216908000","0.0001","N/A","N/A"
"244.3.160.204","41507","244.3.160.254","2784","2","128","1","64","1","64","110.216558000","0.0001","N/A","N/A"
"244.3.160.204","41510","244.3.160.254","4001","2","128","1","64","1","64","110.217352000","0.0001","N/A","N/A"
"244.3.160.204","41511","244.3.160.254","4002","2","128","1","64","1","64","110.217608000","0.0001","N/A","N/A"
"244.3.160.204","42175","244.3.160.89","2785","2","128","1","64","1","64","114.216569000","0.0001","N/A","N/A"
"244.3.160.204","42177","244.3.160.254","4002","2","128","1","64","1","64","114.217125000","0.0001","N/A","N/A"
"244.3.160.204","42182","244.3.160.254","2785","2","128","1","64","1","64","114.218438000","0.0001","N/A","N/A"
"244.3.160.204","42839","244.3.160.89","4002","2","128","1","64","1","64","118.216340000","0.0001","N/A","N/A"
"244.3.160.204","43177","244.3.160.89","4002","2","128","1","64","1","64","120.217310000","0.0001","N/A","N/A"
"244.3.160.204","44175","244.3.160.89","4001","2","128","1","64","1","64","126.217506000","0.0001","N/A","N/A"
"244.3.160.204","44511","244.3.160.89","4001","2","128","1","64","1","64","128.218055000","0.0001","N/A","N/A"
"244.3.160.204","44848","244.3.160.89","4000","2","128","1","64","1","64","130.218341000","0.0001","N/A","N/A"
"244.3.160.204","44849","244.3.160.254","4002","2","128","1","64","1","64","130.218618000","0.0001","N/A","N/A"
"244.3.160.204","44850","244.3.160.254","2048","2","128","1","64","1","64","130.218874000","0.0001","N/A","N/A"
"244.3.160.204","44854","244.3.160.254","2785","2","128","1","64","1","64","130.219920000","0.0001","N/A","N/A"
"244.3.160.204","45183","244.3.160.254","2048","2","128","1","64","1","64","132.218855000","0.0001","N/A","N/A"
"244.3.160.204","45517","244.3.160.89","2048","2","128","1","64","1","64","134.218189000","0.0001","N/A","N/A"
"244.3.160.204","45522","244.3.160.254","4001","2","128","1","64","1","64","134.219492000","0.0001","N/A","N/A"
"244.3.160.204","45853","244.3.160.254","2785","2","128","1","64","1","64","136.220104000","0.0001","N/A","N/A"
"244.3.160.204","46522","244.3.160.254","4002","2","128","1","64","1","64","140.219942000","0.0001","N/A","N/A"
"244.3.160.204","46856","244.3.160.254","2048","2","128","1","64","1","64","142.221321000","0.0001","N/A","N/A"
"244.3.160.204","47521","244.3.160.254","4002","2","128","1","64","1","64","146.220102000","0.0001","N/A","N/A"
"244.3.160.204","48524","244.3.160.254","2784","2","128","1","64","1","64","152.220841000","0.0001","N/A","N/A"
"244.3.160.204","48859","244.3.160.89","2785","2","128","1","64","1","64","154.219639000","0.0001","N/A","N/A"
"244.3.160.204","49188","244.3.160.89","2048","2","128","1","64","1","64","156.219950000","0.0001","N/A","N/A"
"244.3.160.204","49531","244.3.160.254","2048","2","128","1","64","1","64","158.221470000","0.0001","N/A","N/A"
"244.3.160.204","52530","244.3.160.89","2785","2","128","1","64","1","64","176.222158000","0.0001","N/A","N/A"
"244.3.160.204","53205","244.3.160.254","4001","2","128","1","64","1","64","180.223578000","0.0001","N/A","N/A"
"244.3.160.204","53877","244.3.160.254","2785","2","128","1","64","1","64","184.224521000","0.0001","N/A","N/A"
"244.3.160.204","54540","244.3.160.254","4001","2","128","1","64","1","64","188.224284000","0.0001","N/A","N/A"
"244.3.160.204","54871","244.3.160.89","4001","2","128","1","64","1","64","190.222928000","0.0001","N/A","N/A"
"244.3.160.204","55550","244.3.160.254","2785","2","128","1","64","1","64","194.225951000","0.0001","N/A","N/A"
"244.3.160.204","56208","244.3.160.89","2048","2","128","1","64","1","64","198.224278000","0.0001","N/A","N/A"
"244.3.160.204","56551","244.3.160.254","4001","2","128","1","64","1","64","200.226636000","0.0001","N/A","N/A"
"244.3.160.204","57544","244.3.160.89","4002","2","128","1","64","1","64","206.226336000","0.0001","N/A","N/A"
"244.3.160.204","58894","244.3.160.239","8080","2","128","1","64","1","64","214.229737000","0.0001","N/A","N/A"
"244.3.160.204","59220","244.3.160.254","2784","2","128","1","64","1","64","216.228764000","0.0001","N/A","N/A"
"244.3.160.204","59884","244.3.160.89","2048","2","128","1","64","1","64","220.227987000","0.0001","N/A","N/A"
"244.3.160.204","59890","244.3.160.254","4002","2","128","1","64","1","64","220.229607000","0.0001","N/A","N/A"
"244.3.160.204","60224","244.3.160.254","2048","2","128","1","64","1","64","222.230169000","0.0001","N/A","N/A"
"244.3.160.204","60554","244.3.160.89","2785","2","128","1","64","1","64","224.228927000","0.0001","N/A","N/A"
"244.3.160.204","60893","244.3.160.254","2784","2","128","1","64","1","64","226.231491000","0.0001","N/A","N/A"
"244.3.160.204","60896","244.3.160.239","8080","2","128","1","64","1","64","226.232317000","0.0001","N/A","N/A"
"244.3.160.204","61555","244.3.160.89","4001","2","128","1","64","1","64","230.229832000","0.0001","N/A","N/A"
"244.3.160.204","61888","244.3.160.89","4001","2","128","1","64","1","64","232.230277000","0.0001","N/A","N/A"
"244.3.160.204","24795","244.3.160.89","2785","2","128","1","64","1","64","10.193696000","0.0001","N/A","N/A"
"244.3.160.204","26471","244.3.160.254","2048","2","128","1","64","1","64","20.196951000","0.0001","N/A","N/A"
"244.3.160.204","26797","244.3.160.89","2048","2","128","1","64","1","64","22.195197000","0.0001","N/A","N/A"
"244.3.160.204","28809","244.3.160.254","4002","2","128","1","64","1","64","34.198073000","0.0001","N/A","N/A"
"244.3.160.204","28816","244.3.160.239","8080","2","128","1","64","1","64","34.199947000","0.0001","N/A","N/A"
"244.3.160.204","29147","244.3.160.239","8080","2","128","1","64","1","64","36.201004000","0.0001","N/A","N/A"
"244.3.160.204","29809","244.3.160.89","4002","2","128","1","64","1","64","40.199555000","0.0001","N/A","N/A"
"244.3.160.204","29812","244.3.160.254","2784","2","128","1","64","1","64","40.200376000","0.0001","N/A","N/A"
"244.3.160.204","29815","244.3.160.254","4001","2","128","1","64","1","64","40.201180000","0.0001","N/A","N/A"
"244.3.160.204","30812","244.3.160.254","2785","2","128","1","64","1","64","46.200668000","0.0001","N/A","N/A"
"244.3.160.204","31478","244.3.160.89","2784","2","128","1","64","1","64","50.200060000","0.0001","N/A","N/A"
"244.3.160.204","31486","244.3.160.254","2785","2","128","1","64","1","64","50.202199000","0.0001","N/A","N/A"
"244.3.160.204","32155","244.3.160.254","4002","2","128","1","64","1","64","54.202391000","0.0001","N/A","N/A"
"244.3.160.204","32485","244.3.160.254","2785","2","128","1","64","1","64","56.203401000","0.0001","N/A","N/A"
"244.3.160.204","32813","244.3.160.89","2784","2","128","1","64","1","64","58.201460000","0.0001","N/A","N/A"
"244.3.160.204","33486","244.3.160.254","4001","2","128","1","64","1","64","62.204161000","0.0001","N/A","N/A"
"244.3.160.204","33488","244.3.160.254","2048","2","128","1","64","1","64","62.204676000","0.0001","N/A","N/A"
"244.3.160.204","33820","244.3.160.89","4001","2","128","1","64","1","64","64.203017000","0.0001","N/A","N/A"
"244.3.160.204","34820","244.3.160.89","4002","2","128","1","64","1","64","70.203512000","0.0001","N/A","N/A"
"244.3.160.204","34824","244.3.160.254","2785","2","128","1","64","1","64","70.204566000","0.0001","N/A","N/A"
"244.3.160.204","36155","244.3.160.89","4002","2","128","1","64","1","64","78.204480000","0.0001","N/A","N/A"
"244.3.160.204","36163","244.3.160.254","2048","2","128","1","64","1","64","78.206638000","0.0001","N/A","N/A"
"244.3.160.204","37167","244.3.160.254","2048","2","128","1","64","1","64","84.207123000","0.0001","N/A","N/A"
"244.3.160.204","37491","244.3.160.89","4001","2","128","1","64","1","64","86.206617000","0.0001","N/A","N/A"
"244.3.160.204","38164","244.3.160.89","4000","2","128","1","64","1","64","90.207321000","0.0001","N/A","N/A"
"244.3.160.204","38165","244.3.160.254","4002","2","128","1","64","1","64","90.207589000","0.0001","N/A","N/A"
"244.3.160.204","39835","244.3.160.89","2784","2","128","1","64","1","64","100.221612000","0.0001","N/A","N/A"
"244.3.160.204","40168","244.3.160.254","2785","2","128","1","64","1","64","102.216350000","0.0001","N/A","N/A"
"244.3.160.204","40501","244.3.160.89","2784","2","128","1","64","1","64","104.214792000","0.0001","N/A","N/A"
"244.3.160.204","41178","244.3.160.239","8080","2","128","1","64","1","64","108.218394000","0.0001","N/A","N/A"
"244.3.160.204","41840","244.3.160.254","2784","2","128","1","64","1","64","112.217344000","0.0001","N/A","N/A"
"244.3.160.204","43514","244.3.160.254","2785","2","128","1","64","1","64","122.218856000","0.0001","N/A","N/A"
"244.3.160.204","43851","244.3.160.254","2048","2","128","1","64","1","64","124.218580000","0.0001","N/A","N/A"
"244.3.160.204","43855","244.3.160.239","8080","2","128","1","64","1","64","124.219649000","0.0001","N/A","N/A"
"244.3.160.204","45176","244.3.160.89","2048","2","128","1","64","1","64","132.217055000","0.0001","N/A","N/A"
"244.3.160.204","45182","244.3.160.254","4002","2","128","1","64","1","64","132.218603000","0.0001","N/A","N/A"
"244.3.160.204","45848","244.3.160.89","4001","2","128","1","64","1","64","136.218753000","0.0001","N/A","N/A"
"244.3.160.204","46851","244.3.160.254","2784","2","128","1","64","1","64","142.219954000","0.0001","N/A","N/A"
"244.3.160.204","47526","244.3.160.254","2785","2","128","1","64","1","64","146.221423000","0.0001","N/A","N/A"
"244.3.160.204","48196","244.3.160.254","2048","2","128","1","64","1","64","150.221000000","0.0001","N/A","N/A"
"244.3.160.204","49193","244.3.160.254","4001","2","128","1","64","1","64","156.221237000","0.0001","N/A","N/A"
"244.3.160.204","49194","244.3.160.254","4002","2","128","1","64","1","64","156.221572000","0.0001","N/A","N/A"
"244.3.160.204","49523","244.3.160.89","4002","2","128","1","64","1","64","158.219327000","0.0001","N/A","N/A"
"244.3.160.204","49524","244.3.160.89","2048","2","128","1","64","1","64","158.219665000","0.0001","N/A","N/A"
"244.3.160.204","49860","244.3.160.89","4001","2","128","1","64","1","64","160.220275000","0.0001","N/A","N/A"
"244.3.160.204","49861","244.3.160.89","4002","2","128","1","64","1","64","160.220525000","0.0001","N/A","N/A"
"244.3.160.204","49867","244.3.160.254","4001","2","128","1","64","1","64","160.222161000","0.0001","N/A","N/A"
"244.3.160.204","50191","244.3.160.89","2785","2","128","1","64","1","64","162.220260000","0.0001","N/A","N/A"
"244.3.160.204","50198","244.3.160.254","2785","2","128","1","64","1","64","162.222135000","0.0001","N/A","N/A"
"244.3.160.204","51195","244.3.160.89","4001","2","128","1","64","1","64","168.220856000","0.0001","N/A","N/A"
"244.3.160.204","51196","244.3.160.89","4002","2","128","1","64","1","64","168.221107000","0.0001","N/A","N/A"
"244.3.160.204","51199","244.3.160.254","2784","2","128","1","64","1","64","168.221918000","0.0001","N/A","N/A"
"244.3.160.204","51538","244.3.160.254","2785","2","128","1","64","1","64","170.223395000","0.0001","N/A","N/A"
"244.3.160.204","51860","244.3.160.89","2048","2","128","1","64","1","64","172.221593000","0.0001","N/A","N/A"
"244.3.160.204","52539","244.3.160.254","4001","2","128","1","64","1","64","176.224504000","0.0001","N/A","N/A"
"244.3.160.204","53870","244.3.160.89","2785","2","128","1","64","1","64","184.222632000","0.0001","N/A","N/A"
"244.3.160.204","53873","244.3.160.89","4002","2","128","1","64","1","64","184.223407000","0.0001","N/A","N/A"
"244.3.160.204","54203","244.3.160.89","2785","2","128","1","64","1","64","186.223849000","0.0001","N/A","N/A"
"244.3.160.204","54541","244.3.160.254","4002","2","128","1","64","1","64","188.224545000","0.0001","N/A","N/A"
"244.3.160.204","55545","244.3.160.254","4002","2","128","1","64","1","64","194.224561000","0.0001","N/A","N/A"
"244.3.160.204","56876","244.3.160.89","4000","2","128","1","64","1","64","202.225085000","0.0001","N/A","N/A"
"244.3.160.204","57551","244.3.160.254","4002","2","128","1","64","1","64","206.228197000","0.0001","N/A","N/A"
"244.3.160.204","57552","244.3.160.254","2048","2","128","1","64","1","64","206.228416000","0.0001","N/A","N/A"
"244.3.160.204","57888","244.3.160.239","8080","2","128","1","64","1","64","208.228038000","0.0001","N/A","N/A"
"244.3.160.204","58217","244.3.160.254","4002","2","128","1","64","1","64","210.227068000","0.0001","N/A","N/A"
"244.3.160.204","58888","244.3.160.254","2785","2","128","1","64","1","64","214.228134000","0.0001","N/A","N/A"
"244.3.160.204","58890","244.3.160.254","4001","2","128","1","64","1","64","214.228709000","0.0001","N/A","N/A"
"244.3.160.204","59213","244.3.160.89","2784","2","128","1","64","1","64","216.226921000","0.0001","N/A","N/A"
"244.3.160.204","59556","244.3.160.254","2784","2","128","1","64","1","64","218.229153000","0.0001","N/A","N/A"
"244.3.160.204","60214","244.3.160.89","4000","2","128","1","64","1","64","222.227592000","0.0001","N/A","N/A"
"244.3.160.204","61226","244.3.160.254","2048","2","128","1","64","1","64","228.230726000","0.0001","N/A","N/A"
"244.3.160.204","61892","244.3.160.254","2784","2","128","1","64","1","64","232.231347000","0.0001","N/A","N/A"
"244.3.160.204","62230","244.3.160.254","2048","2","128","1","64","1","64","234.230823000","0.0001","N/A","N/A"
"244.3.160.204","24131","244.3.160.254","4002","2","128","1","64","1","64","6.195765000","0.0001","N/A","N/A"
"244.3.160.204","24134","244.3.160.239","8080","2","128","1","64","1","64","6.196586000","0.0001","N/A","N/A"
"244.3.160.204","24123","244.3.160.89","4001","2","128","1","64","1","64","6.193627000","0.0001","N/A","N/A"
"244.3.160.204","25130","244.3.160.254","4002","2","128","1","64","1","64","12.195463000","0.0001","N/A","N/A"
"244.3.160.204","26137","244.3.160.254","2785","2","128","1","64","1","64","18.196390000","0.0001","N/A","N/A"
"244.3.160.204","26800","244.3.160.254","2785","2","128","1","64","1","64","22.195982000","0.0001","N/A","N/A"
"244.3.160.204","37165","244.3.160.254","4001","2","128","1","64","1","64","84.206612000","0.0001","N/A","N/A"
"244.3.160.204","37834","244.3.160.254","4001","2","128","1","64","1","64","88.208599000","0.0001","N/A","N/A"
"244.3.160.204","30815","244.3.160.254","4002","2","128","1","64","1","64","46.201434000","0.0001","N/A","N/A"
"244.3.160.204","34819","244.3.160.89","4001","2","128","1","64","1","64","70.203246000","0.0001","N/A","N/A"
"244.3.160.204","38832","244.3.160.89","4002","2","128","1","64","1","64","94.207588000","0.0001","N/A","N/A"
"244.3.160.204","42840","244.3.160.89","2048","2","128","1","64","1","64","118.216585000","0.0001","N/A","N/A"
"244.3.160.204","43850","244.3.160.254","4002","2","128","1","64","1","64","124.218328000","0.0001","N/A","N/A"
"244.3.160.204","48195","244.3.160.254","4002","2","128","1","64","1","64","150.220723000","0.0001","N/A","N/A"
"244.3.160.204","48861","244.3.160.254","4002","2","128","1","64","1","64","154.220160000","0.0001","N/A","N/A"
"244.3.160.204","49526","244.3.160.254","2784","2","128","1","64","1","64","158.220131000","0.0001","N/A","N/A"
"244.3.160.204","51534","244.3.160.254","2048","2","128","1","64","1","64","170.222342000","0.0001","N/A","N/A"
"244.3.160.204","52868","244.3.160.254","4002","2","128","1","64","1","64","178.223216000","0.0001","N/A","N/A"
"244.3.160.204","54204","244.3.160.89","4000","2","128","1","64","1","64","186.224163000","0.0001","N/A","N/A"
"244.3.160.204","54209","244.3.160.254","2784","2","128","1","64","1","64","186.225473000","0.0001","N/A","N/A"
"244.3.160.204","54535","244.3.160.89","2048","2","128","1","64","1","64","188.222932000","0.0001","N/A","N/A"
"244.3.160.204","55202","244.3.160.89","2785","2","128","1","64","1","64","192.223179000","0.0001","N/A","N/A"
"244.3.160.204","55543","244.3.160.89","2785","2","128","1","64","1","64","194.224023000","0.0001","N/A","N/A"
"244.3.160.204","56542","244.3.160.89","2785","2","128","1","64","1","64","200.224257000","0.0001","N/A","N/A"
"244.3.160.204","57877","244.3.160.89","2785","2","128","1","64","1","64","208.225101000","0.0001","N/A","N/A"
"244.3.160.204","58551","244.3.160.254","2048","2","128","1","64","1","64","212.228300000","0.0001","N/A","N/A"
"244.3.160.204","59883","244.3.160.89","4002","2","128","1","64","1","64","220.227737000","0.0001","N/A","N/A"
"244.3.160.204","60223","244.3.160.254","4002","2","128","1","64","1","64","222.229915000","0.0001","N/A","N/A"
"244.3.160.204","60890","244.3.160.254","2048","2","128","1","64","1","64","226.230691000","0.0001","N/A","N/A"
"244.3.160.204","24125","244.3.160.89","2048","2","128","1","64","1","64","6.194127000","0.0001","N/A","N/A"
"244.3.160.204","24132","244.3.160.254","2048","2","128","1","64","1","64","6.196018000","0.0001","N/A","N/A"
"244.3.160.204","25472","244.3.160.254","2048","2","128","1","64","1","64","14.196054000","0.0001","N/A","N/A"
"244.3.160.204","28469","244.3.160.89","4002","2","128","1","64","1","64","32.197346000","0.0001","N/A","N/A"
"244.3.160.204","32817","244.3.160.254","2048","2","128","1","64","1","64","58.202514000","0.0001","N/A","N/A"
"244.3.160.204","36165","244.3.160.239","8080","2","128","1","64","1","64","78.207209000","0.0001","N/A","N/A"
"244.3.160.204","37171","244.3.160.239","8080","2","128","1","64","1","64","84.208205000","0.0001","N/A","N/A"
"244.3.160.204","38170","244.3.160.254","2785","2","128","1","64","1","64","90.208915000","0.0001","N/A","N/A"
"244.3.160.204","39169","244.3.160.254","2785","2","128","1","64","1","64","96.209393000","0.0001","N/A","N/A"
"244.3.160.204","41836","244.3.160.89","4001","2","128","1","64","1","64","112.216288000","0.0001","N/A","N/A"
"244.3.160.204","42849","244.3.160.239","8080","2","128","1","64","1","64","118.218967000","0.0001","N/A","N/A"
"244.3.160.204","44179","244.3.160.254","2784","2","128","1","64","1","64","126.218574000","0.0001","N/A","N/A"
"244.3.160.204","52872","244.3.160.254","2784","2","128","1","64","1","64","178.224238000","0.0001","N/A","N/A"
"244.3.160.204","57223","244.3.160.239","8080","2","128","1","64","1","64","204.227954000","0.0001","N/A","N/A"
"244.3.160.204","60215","244.3.160.89","4001","2","128","1","64","1","64","222.227841000","0.0001","N/A","N/A"
"244.3.160.204","31144","244.3.160.89","4002","2","128","1","64","1","64","48.206146000","0.0001","N/A","N/A"
"244.3.160.204","35157","244.3.160.254","2785","2","128","1","64","1","64","72.205530000","0.0001","N/A","N/A"
"244.3.160.204","35497","244.3.160.254","2784","2","128","1","64","1","64","74.205998000","0.0001","N/A","N/A"
"244.3.160.204","37492","244.3.160.89","4002","2","128","1","64","1","64","86.206898000","0.0001","N/A","N/A"
"244.3.160.204","39505","244.3.160.254","2785","2","128","1","64","1","64","98.209870000","0.0001","N/A","N/A"
"244.3.160.204","40838","244.3.160.254","2048","2","128","1","64","1","64","106.217199000","0.0001","N/A","N/A"
"244.3.160.204","42847","244.3.160.254","2048","2","128","1","64","1","64","118.218447000","0.0001","N/A","N/A"
"244.3.160.204","43510","244.3.160.254","2048","2","128","1","64","1","64","122.217799000","0.0001","N/A","N/A"
"244.3.160.204","43849","244.3.160.254","4001","2","128","1","64","1","64","124.218075000","0.0001","N/A","N/A"
"244.3.160.204","44512","244.3.160.89","4002","2","128","1","64","1","64","128.218338000","0.0001","N/A","N/A"
"244.3.160.204","48520","244.3.160.89","4001","2","128","1","64","1","64","152.219778000","0.0001","N/A","N/A"
"244.3.160.204","48525","244.3.160.254","2785","2","128","1","64","1","64","152.221145000","0.0001","N/A","N/A"
"244.3.160.204","49527","244.3.160.254","2785","2","128","1","64","1","64","158.220385000","0.0001","N/A","N/A"
"244.3.160.204","49530","244.3.160.254","4002","2","128","1","64","1","64","158.221185000","0.0001","N/A","N/A"
"244.3.160.204","51867","244.3.160.254","2048","2","128","1","64","1","64","172.223443000","0.0001","N/A","N/A"
"244.3.160.204","53879","244.3.160.254","4001","2","128","1","64","1","64","184.225074000","0.0001","N/A","N/A"
"244.3.160.204","54878","244.3.160.254","4001","2","128","1","64","1","64","190.224741000","0.0001","N/A","N/A"
"244.3.160.204","56207","244.3.160.89","4002","2","128","1","64","1","64","198.223998000","0.0001","N/A","N/A"
"244.3.160.204","58550","244.3.160.254","4002","2","128","1","64","1","64","212.228038000","0.0001","N/A","N/A"
"244.3.160.204","58887","244.3.160.254","2784","2","128","1","64","1","64","214.227855000","0.0001","N/A","N/A"
"244.3.160.204","60563","244.3.160.254","4001","2","128","1","64","1","64","224.231311000","0.0001","N/A","N/A"
"244.3.160.204","23798","244.3.160.254","4002","2","128","1","64","1","64","4.193565000","0.0001","N/A","N/A"
"244.3.160.204","23131","244.3.160.254","4001","2","128","1","64","1","64","0.194192000","0.0001","N/A","N/A"
"244.3.160.204","27810","244.3.160.239","8080","2","128","1","64","1","64","28.199147000","0.0001","N/A","N/A"
"244.3.160.204","32821","244.3.160.254","2785","2","128","1","64","1","64","58.203581000","0.0001","N/A","N/A"
"244.3.160.204","34151","244.3.160.89","2785","2","128","1","64","1","64","66.209061000","0.0001","N/A","N/A"
"244.3.160.204","39839","244.3.160.254","2048","2","128","1","64","1","64","100.222947000","0.0001","N/A","N/A"
"244.3.160.204","40834","244.3.160.89","2784","2","128","1","64","1","64","106.216154000","0.0001","N/A","N/A"
"244.3.160.204","56875","244.3.160.89","2785","2","128","1","64","1","64","202.224814000","0.0001","N/A","N/A"
"244.3.160.204","61225","244.3.160.254","4002","2","128","1","64","1","64","228.230441000","0.0001","N/A","N/A"
"244.3.160.204","61563","244.3.160.254","4002","2","128","1","64","1","64","230.231962000","0.0001","N/A","N/A"
"244.3.160.204","35150","244.3.160.89","2785","2","128","1","64","1","64","72.203651000","0.0001","N/A","N/A"
"244.3.160.204","36490","244.3.160.89","2785","2","128","1","64","1","64","80.204607000","0.0001","N/A","N/A"
"244.3.160.204","41843","244.3.160.254","4001","2","128","1","64","1","64","112.218160000","0.0001","N/A","N/A"
"244.3.160.204","47195","244.3.160.254","4001","2","128","1","64","1","64","144.220338000","0.0001","N/A","N/A"
"244.3.160.204","48527","244.3.160.254","4001","2","128","1","64","1","64","152.221743000","0.0001","N/A","N/A"
"244.3.160.204","53540","244.3.160.254","2048","2","128","1","64","1","64","182.224665000","0.0001","N/A","N/A"
"244.3.160.204","54210","244.3.160.254","2785","2","128","1","64","1","64","186.225723000","0.0001","N/A","N/A"
"244.3.160.204","55546","244.3.160.254","2048","2","128","1","64","1","64","194.224832000","0.0001","N/A","N/A"
"244.3.160.204","55872","244.3.160.89","2048","2","128","1","64","1","64","196.224066000","0.0001","N/A","N/A"
"244.3.160.204","59221","244.3.160.254","2785","2","128","1","64","1","64","216.229021000","0.0001","N/A","N/A"
"244.3.160.204","59891","244.3.160.254","2048","2","128","1","64","1","64","220.229882000","0.0001","N/A","N/A"
"244.3.160.204","29143","244.3.160.254","2048","2","128","1","64","1","64","36.199942000","0.0001","N/A","N/A"
"244.3.160.204","31150","244.3.160.254","4001","2","128","1","64","1","64","48.208103000","0.0001","N/A","N/A"
"244.3.160.204","23457","244.3.160.254","4002","2","128","1","64","1","64","2.192765000","0.0001","N/A","N/A"
"244.3.160.204","24801","244.3.160.254","2784","2","128","1","64","1","64","10.195295000","0.0001","N/A","N/A"
"244.3.160.204","33825","244.3.160.254","2785","2","128","1","64","1","64","64.204352000","0.0001","N/A","N/A"
"244.3.160.204","49191","244.3.160.89","2784","2","128","1","64","1","64","156.220704000","0.0001","N/A","N/A"
"244.3.160.204","50864","244.3.160.254","2785","2","128","1","64","1","64","166.221830000","0.0001","N/A","N/A"
"244.3.160.204","59225","244.3.160.239","8080","2","128","1","64","1","64","216.230126000","0.0001","N/A","N/A"
"244.3.160.204","40835","244.3.160.89","2785","2","128","1","64","1","64","106.216422000","0.0001","N/A","N/A"
"244.3.160.204","42503","244.3.160.89","4002","2","128","1","64","1","64","116.216349000","0.0001","N/A","N/A"
"244.3.160.204","43513","244.3.160.254","2784","2","128","1","64","1","64","122.218578000","0.0001","N/A","N/A"
"244.3.160.204","49187","244.3.160.89","4002","2","128","1","64","1","64","156.219673000","0.0001","N/A","N/A"
"244.3.160.204","50193","244.3.160.254","4002","2","128","1","64","1","64","162.220803000","0.0001","N/A","N/A"
"244.3.160.204","56549","244.3.160.254","2785","2","128","1","64","1","64","200.226123000","0.0001","N/A","N/A"
"244.3.160.204","57211","244.3.160.89","4002","2","128","1","64","1","64","204.224733000","0.0001","N/A","N/A"
"244.3.160.204","59559","244.3.160.239","8080","2","128","1","64","1","64","218.229910000","0.0001","N/A","N/A"
"244.3.160.204","61557","244.3.160.89","2048","2","128","1","64","1","64","230.230326000","0.0001","N/A","N/A"
"244.3.160.204","30476","244.3.160.89","2048","2","128","1","64","1","64","44.198843000","0.0001","N/A","N/A"
"244.3.160.204","42507","244.3.160.89","2784","2","128","1","64","1","64","116.217358000","0.0001","N/A","N/A"
"244.3.160.204","42846","244.3.160.254","4002","2","128","1","64","1","64","118.218146000","0.0001","N/A","N/A"
"244.3.160.204","58544","244.3.160.89","2048","2","128","1","64","1","64","212.226434000","0.0001","N/A","N/A"
"244.3.160.204","25467","244.3.160.254","2784","2","128","1","64","1","64","14.194693000","0.0001","N/A","N/A"
"244.3.160.204","30141","244.3.160.254","4002","2","128","1","64","1","64","42.199746000","0.0001","N/A","N/A"
"244.3.41.176","52187","244.3.39.203","444","2","128","2","128","0","0","58.338371000","0.0001","16516129.03","N/A"
"244.3.160.204","37498","244.3.160.254","4001","2","128","1","64","1","64","86.208513000","0.0001","N/A","N/A"
"244.3.160.204","37827","244.3.160.89","4001","2","128","1","64","1","64","88.206754000","0.0001","N/A","N/A"
"244.3.160.204","39164","244.3.160.89","4001","2","128","1","64","1","64","96.208076000","0.0001","N/A","N/A"
"244.3.160.204","41837","244.3.160.89","4002","2","128","1","64","1","64","112.216536000","0.0001","N/A","N/A"
"244.3.160.204","42174","244.3.160.89","2784","2","128","1","64","1","64","114.216326000","0.0001","N/A","N/A"
"244.3.160.204","43180","244.3.160.254","2784","2","128","1","64","1","64","120.218113000","0.0001","N/A","N/A"
"244.3.160.204","50866","244.3.160.254","4001","2","128","1","64","1","64","166.222371000","0.0001","N/A","N/A"
"244.3.160.204","53206","244.3.160.254","4002","2","128","1","64","1","64","180.223849000","0.0001","N/A","N/A"
"244.3.160.204","58547","244.3.160.89","2784","2","128","1","64","1","64","212.227230000","0.0001","N/A","N/A"
"244.3.160.204","28473","244.3.160.254","2785","2","128","1","64","1","64","32.198375000","0.0001","N/A","N/A"
"244.3.41.100","52137","244.3.39.203","444","2","128","2","128","0","0","63.848774000","0.0001","16786885.25","N/A"
"244.3.160.204","37159","244.3.160.89","4002","2","128","1","64","1","64","84.205012000","0.0001","N/A","N/A"
"244.3.160.204","38495","244.3.160.89","2784","2","128","1","64","1","64","92.207292000","0.0001","N/A","N/A"
"244.3.160.204","42509","244.3.160.254","4001","2","128","1","64","1","64","116.217878000","0.0001","N/A","N/A"
"244.3.160.204","44856","244.3.160.239","8080","2","128","1","64","1","64","130.220484000","0.0001","N/A","N/A"
"244.3.160.204","49533","244.3.160.239","8080","2","128","1","64","1","64","158.222045000","0.0001","N/A","N/A"
"244.3.160.204","56545","244.3.160.89","4002","2","128","1","64","1","64","200.225001000","0.0001","N/A","N/A"
"244.3.160.204","36826","244.3.160.254","2048","2","128","1","64","1","64","82.206346000","0.0001","N/A","N/A"
"244.3.160.204","40836","244.3.160.89","4000","2","128","1","64","1","64","106.216668000","0.0001","N/A","N/A"
"244.3.160.204","41508","244.3.160.254","2785","2","128","1","64","1","64","110.216843000","0.0001","N/A","N/A"
"244.3.160.204","43176","244.3.160.89","4001","2","128","1","64","1","64","120.217068000","0.0001","N/A","N/A"
"244.3.160.204","43183","244.3.160.254","4001","2","128","1","64","1","64","120.218907000","0.0001","N/A","N/A"
"244.3.160.204","28143","244.3.160.254","4002","2","128","1","64","1","64","30.198491000","0.0001","N/A","N/A"
"244.3.160.204","41834","244.3.160.89","2785","2","128","1","64","1","64","112.215827000","0.0001","N/A","N/A"
"244.3.160.204","61566","244.3.160.239","8080","2","128","1","64","1","64","230.232793000","0.0001","N/A","N/A"
"41.177.3.57","52232","244.3.39.203","444","2","128","2","128","0","0","60.655407000","0.0001","17355932.20","N/A"
"244.3.160.204","56211","244.3.160.254","2785","2","128","1","64","1","64","198.225090000","0.0001","N/A","N/A"
"244.3.160.204","26463","244.3.160.89","4002","2","128","1","64","1","64","20.194842000","0.0001","N/A","N/A"
"244.3.160.204","47857","244.3.160.254","4002","2","128","1","64","1","64","148.220383000","0.0001","N/A","N/A"
"244.3.160.204","48865","244.3.160.254","2784","2","128","1","64","1","64","154.221253000","0.0001","N/A","N/A"
"244.3.160.204","49865","244.3.160.254","2785","2","128","1","64","1","64","160.221610000","0.0001","N/A","N/A"
"244.3.160.204","33155","244.3.160.254","2048","2","128","1","64","1","64","60.204781000","0.0001","N/A","N/A"
"244.3.160.204","32480","244.3.160.89","4001","2","128","1","64","1","64","56.202074000","0.0001","N/A","N/A"
"244.3.160.204","43181","244.3.160.254","2785","2","128","1","64","1","64","120.218368000","0.0001","N/A","N/A"
"244.3.160.204","59552","244.3.160.254","4002","2","128","1","64","1","64","218.228058000","0.0001","N/A","N/A"
"244.3.160.204","39843","244.3.160.239","8080","2","128","1","64","1","64","100.224315000","0.0001","N/A","N/A"
"244.3.160.204","53536","244.3.160.254","2785","2","128","1","64","1","64","182.223588000","0.0001","N/A","N/A"
"244.3.160.204","54873","244.3.160.89","2048","2","128","1","64","1","64","190.223447000","0.0001","N/A","N/A"
"244.3.160.204","34158","244.3.160.254","2785","2","128","1","64","1","64","66.211385000","0.0001","N/A","N/A"
"244.3.160.204","25470","244.3.160.254","4001","2","128","1","64","1","64","14.195531000","0.0001","N/A","N/A"
"244.3.160.204","48862","244.3.160.254","2048","2","128","1","64","1","64","154.220456000","0.0001","N/A","N/A"
"244.3.160.204","23133","244.3.160.239","8080","2","128","1","64","1","64","0.194768000","0.0001","N/A","N/A"
"244.3.160.204","27470","244.3.160.254","2048","2","128","1","64","1","64","26.197102000","0.0001","N/A","N/A"
"244.3.160.204","36156","244.3.160.89","2048","2","128","1","64","1","64","78.204800000","0.0001","N/A","N/A"
"244.3.160.204","51194","244.3.160.89","4000","2","128","1","64","1","64","168.220624000","0.0001","N/A","N/A"
"244.3.160.204","27473","244.3.160.254","2784","2","128","1","64","1","64","26.197901000","0.0001","N/A","N/A"
"244.3.160.204","40513","244.3.160.239","8080","2","128","1","64","1","64","104.217999000","0.0001","N/A","N/A"
"244.3.160.204","40842","244.3.160.254","2785","2","128","1","64","1","64","106.218278000","0.0001","N/A","N/A"
"244.3.160.204","55877","244.3.160.254","4001","2","128","1","64","1","64","196.225422000","0.0000","N/A","N/A"
"244.3.160.204","53207","244.3.160.254","2048","2","128","1","64","1","64","180.224109000","0.0000","N/A","N/A"
"244.3.160.204","26467","244.3.160.89","2784","2","128","1","64","1","64","20.195912000","0.0000","N/A","N/A"
"244.3.160.204","28475","244.3.160.254","4001","2","128","1","64","1","64","32.198900000","0.0000","N/A","N/A"
"244.3.160.204","32484","244.3.160.254","2784","2","128","1","64","1","64","56.203141000","0.0000","N/A","N/A"
"244.3.160.204","35831","244.3.160.239","8080","2","128","1","64","1","64","76.207422000","0.0000","N/A","N/A"
"244.3.160.204","35493","244.3.160.254","4002","2","128","1","64","1","64","74.204958000","0.0000","N/A","N/A"
"244.3.160.204","24802","244.3.160.254","2785","2","128","1","64","1","64","10.195605000","0.0000","N/A","N/A"
"244.3.160.204","54880","244.3.160.254","2048","2","128","1","64","1","64","190.225328000","0.0000","N/A","N/A"
"244.3.160.204","45855","244.3.160.254","4001","2","128","1","64","1","64","136.220664000","0.0000","N/A","N/A"
"244.3.160.204","56877","244.3.160.254","4002","2","128","1","64","1","64","202.225415000","0.0000","N/A","N/A"
"77.197.210.181","37354","41.177.26.176","80","1","64","1","64","0","0","0.019023000","0.0000","N/A","N/A"
"151.77.135.33","49826","41.177.98.176","80","1","64","1","64","0","0","0.213561000","0.0000","N/A","N/A"
"46.100.160.135","1824","244.3.61.18","445","1","66","1","66","0","0","2.586195000","0.0000","N/A","N/A"
"241.141.156.123","12013","244.3.210.197","80","1","64","1","64","0","0","4.121345000","0.0000","N/A","N/A"
"253.98.108.71","2608","253.37.253.43","23","1","64","0","0","1","64","4.157550000","0.0000","N/A","N/A"
"67.122.211.41","30985","244.3.47.102","4899","1","66","1","66","0","0","9.360826000","0.0000","N/A","N/A"
"67.122.211.41","30993","244.3.47.181","4899","1","66","1","66","0","0","9.422351000","0.0000","N/A","N/A"
"67.122.211.41","31119","244.3.47.210","4899","1","66","1","66","0","0","10.888246000","0.0000","N/A","N/A"
"67.122.211.41","31121","244.3.47.17","4899","1","66","1","66","0","0","10.925352000","0.0000","N/A","N/A"
"67.122.211.41","31122","244.3.47.113","4899","1","66","1","66","0","0","10.935741000","0.0000","N/A","N/A"
"67.122.211.41","31123","244.3.47.93","4899","1","66","1","66","0","0","10.948843000","0.0000","N/A","N/A"
"67.122.211.41","31124","244.3.47.199","4899","1","66","1","66","0","0","10.965909000","0.0000","N/A","N/A"
"67.122.211.41","31127","244.3.47.57","4899","1","66","1","66","0","0","10.991952000","0.0000","N/A","N/A"
"67.122.211.41","31128","244.3.47.45","4899","1","66","1","66","0","0","10.997079000","0.0000","N/A","N/A"
"254.157.30.67","55920","244.3.210.197","80","1","64","1","64","0","0","12.199798000","0.0000","N/A","N/A"
"254.157.30.67","55921","244.3.210.197","80","1","64","1","64","0","0","12.201176000","0.0000","N/A","N/A"
"90.199.135.132","53559","244.3.210.197","80","1","64","0","0","1","64","15.281931000","0.0000","N/A","N/A"
"90.199.135.132","53557","244.3.210.197","80","1","64","0","0","1","64","15.281982000","0.0000","N/A","N/A"
"90.199.135.132","53555","244.3.210.197","80","1","64","0","0","1","64","15.281986000","0.0000","N/A","N/A"
"90.199.135.132","53558","244.3.210.197","80","1","64","0","0","1","64","15.282006000","0.0000","N/A","N/A"
"90.199.135.132","53560","244.3.210.197","80","1","64","0","0","1","64","15.282062000","0.0000","N/A","N/A"
"90.199.135.132","53556","244.3.210.197","80","1","64","0","0","1","64","15.282067000","0.0000","N/A","N/A"
"41.177.244.197","50675","244.3.210.197","80","1","64","0","0","1","64","15.282075000","0.0000","N/A","N/A"
"41.177.244.197","50645","244.3.210.197","80","1","64","0","0","1","64","15.282079000","0.0000","N/A","N/A"
"225.79.120.111","1620","244.3.210.197","80","1","64","1","64","0","0","22.278004000","0.0000","N/A","N/A"
"225.79.120.111","1622","244.3.210.197","80","1","64","1","64","0","0","22.279424000","0.0000","N/A","N/A"
"225.79.120.111","1623","244.3.210.197","80","1","64","1","64","0","0","22.280946000","0.0000","N/A","N/A"
"225.79.120.111","1626","244.3.210.197","80","1","64","1","64","0","0","22.282435000","0.0000","N/A","N/A"
"225.79.120.111","1627","244.3.210.197","80","1","64","1","64","0","0","22.283972000","0.0000","N/A","N/A"
"225.79.120.111","1629","244.3.210.197","80","1","64","1","64","0","0","22.285462000","0.0000","N/A","N/A"
"225.79.120.111","1625","244.3.210.197","80","1","64","1","64","0","0","22.286977000","0.0000","N/A","N/A"
"225.79.120.111","1630","244.3.210.197","80","1","64","1","64","0","0","22.288437000","0.0000","N/A","N/A"
"225.79.120.111","1624","244.3.210.197","80","1","64","1","64","0","0","22.289904000","0.0000","N/A","N/A"
"225.79.120.111","1628","244.3.210.197","80","1","64","1","64","0","0","22.291422000","0.0000","N/A","N/A"
"225.79.120.111","1621","244.3.210.197","80","1","64","1","64","0","0","22.292903000","0.0000","N/A","N/A"
"225.79.120.111","1619","244.3.210.197","80","1","64","1","64","0","0","22.294476000","0.0000","N/A","N/A"
"225.79.120.111","1631","244.3.210.197","80","1","64","1","64","0","0","22.295849000","0.0000","N/A","N/A"
"225.79.120.111","1632","244.3.210.197","80","1","64","1","64","0","0","22.297334000","0.0000","N/A","N/A"
"225.79.120.111","1633","244.3.210.197","80","1","64","1","64","0","0","22.298819000","0.0000","N/A","N/A"
"254.40.82.123","28383","244.3.210.197","80","1","64","1","64","0","0","23.286291000","0.0000","N/A","N/A"
"254.40.82.123","54876","244.3.210.197","80","1","64","1","64","0","0","23.286299000","0.0000","N/A","N/A"
"244.3.41.252","47571","41.177.46.176","5666","1","70","1","70","0","0","23.321572000","0.0000","N/A","N/A"
"219.22.0.211","26280","244.3.210.197","80","1","64","0","0","1","64","23.449919000","0.0000","N/A","N/A"
"219.22.0.211","26291","244.3.210.197","80","1","64","0","0","1","64","23.449959000","0.0000","N/A","N/A"
"219.22.0.211","26222","244.3.210.197","80","1","64","0","0","1","64","23.449979000","0.0000","N/A","N/A"
"154.108.181.150","51127","244.3.210.197","80","1","64","0","0","1","64","25.281984000","0.0000","N/A","N/A"
"41.177.244.197","50674","244.3.210.197","80","1","64","0","0","1","64","30.282000000","0.0000","N/A","N/A"
"15.111.142.246","2985","244.3.210.197","80","1","64","0","0","1","64","30.282066000","0.0000","N/A","N/A"
"15.111.142.246","2987","244.3.210.197","80","1","64","0","0","1","64","30.282070000","0.0000","N/A","N/A"
"15.111.142.246","2984","244.3.210.197","80","1","64","0","0","1","64","30.282074000","0.0000","N/A","N/A"
"15.111.142.246","2986","244.3.210.197","80","1","64","0","0","1","64","35.282013000","0.0000","N/A","N/A"
"15.111.142.246","2988","244.3.210.197","80","1","64","0","0","1","64","35.282033000","0.0000","N/A","N/A"
"253.84.160.167","3320","253.37.253.43","23","1","64","0","0","1","64","37.388113000","0.0000","N/A","N/A"
"67.122.211.41","33464","244.3.41.185","4899","1","66","1","66","0","0","37.873379000","0.0000","N/A","N/A"
"67.122.211.41","33577","244.3.41.224","4899","1","66","1","66","0","0","39.127302000","0.0000","N/A","N/A"
"67.122.211.41","33588","244.3.41.41","4899","1","66","1","66","0","0","39.215412000","0.0000","N/A","N/A"
"67.122.211.41","33652","244.3.41.246","4899","1","66","1","66","0","0","39.967152000","0.0000","N/A","N/A"
"67.122.211.41","33655","244.3.41.244","4899","1","66","1","66","0","0","39.982654000","0.0000","N/A","N/A"
"117.98.154.128","13919","244.3.210.197","80","1","64","0","0","1","64","40.282019000","0.0000","N/A","N/A"
"203.164.144.197","62517","244.3.210.197","80","1","64","0","0","1","64","40.282041000","0.0000","N/A","N/A"
"203.164.144.197","60622","244.3.210.197","80","1","64","0","0","1","64","40.282085000","0.0000","N/A","N/A"
"117.98.154.128","13925","244.3.210.197","80","1","64","0","0","1","64","40.282095000","0.0000","N/A","N/A"
"117.98.154.128","13917","244.3.210.197","80","1","64","0","0","1","64","45.282028000","0.0000","N/A","N/A"
"117.98.154.128","13909","244.3.210.197","80","1","64","0","0","1","64","45.282049000","0.0000","N/A","N/A"
"244.3.153.177","1903","244.3.160.80","443","1","64","1","64","0","0","52.045908000","0.0000","N/A","N/A"
"68.67.164.34","4372","244.3.210.197","80","1","64","1","64","0","0","54.689517000","0.0000","N/A","N/A"
"67.122.211.41","34980","244.3.61.215","4899","1","66","1","66","0","0","54.849318000","0.0000","N/A","N/A"
"67.122.211.41","34984","244.3.61.118","4899","1","66","1","66","0","0","54.878205000","0.0000","N/A","N/A"
"67.122.211.41","34988","244.3.61.40","4899","1","66","1","66","0","0","54.919483000","0.0000","N/A","N/A"
"67.122.211.41","34992","244.3.61.124","4899","1","66","1","66","0","0","54.935610000","0.0000","N/A","N/A"
"67.122.211.41","34995","244.3.61.244","4899","1","66","1","66","0","0","54.973516000","0.0000","N/A","N/A"
"67.122.211.41","34997","244.3.61.68","4899","1","66","1","66","0","0","54.985251000","0.0000","N/A","N/A"
"67.122.211.41","34998","244.3.61.151","4899","1","66","1","66","0","0","55.001788000","0.0000","N/A","N/A"
"67.122.211.41","35004","244.3.61.22","4899","1","66","1","66","0","0","55.087341000","0.0000","N/A","N/A"
"67.122.211.41","35008","244.3.61.177","4899","1","66","1","66","0","0","55.109888000","0.0000","N/A","N/A"
"67.122.211.41","35009","244.3.61.92","4899","1","66","1","66","0","0","55.125553000","0.0000","N/A","N/A"
"67.122.211.41","35012","244.3.61.225","4899","1","66","1","66","0","0","55.175687000","0.0000","N/A","N/A"
"67.122.211.41","35013","244.3.61.39","4899","1","66","1","66","0","0","55.189264000","0.0000","N/A","N/A"
"67.122.211.41","35014","244.3.61.209","4899","1","66","1","66","0","0","55.206754000","0.0000","N/A","N/A"
"67.122.211.41","35015","244.3.61.41","4899","1","66","1","66","0","0","55.227764000","0.0000","N/A","N/A"
"177.202.167.210","47271","41.177.98.84","25","1","66","1","66","0","0","56.925154000","0.0000","N/A","N/A"
"244.3.61.151","21025","181.127.47.67","80","1","66","0","0","1","66","58.957111000","0.0000","N/A","N/A"
"244.3.41.176","52214","244.3.39.203","444","1","70","1","70","0","0","65.361433000","0.0000","N/A","N/A"
"41.177.3.57","52250","244.3.39.203","444","1","70","1","70","0","0","67.663232000","0.0000","N/A","N/A"
"41.177.244.177","55848","244.3.210.197","80","1","64","0","0","1","64","68.449948000","0.0000","N/A","N/A"
"253.37.253.121","2831","253.160.108.127","80","1","64","1","64","0","0","68.665091000","0.0000","N/A","N/A"
"176.48.132.197","3832","41.177.3.177","445","1","66","1","66","0","0","74.236132000","0.0000","N/A","N/A"
"203.103.84.181","45517","244.3.210.197","80","1","64","0","0","1","64","75.282138000","0.0000","N/A","N/A"
"67.122.211.41","37306","244.3.39.224","4899","1","66","1","66","0","0","81.217972000","0.0000","N/A","N/A"
"67.122.211.41","37324","244.3.39.95","4899","1","66","1","66","0","0","81.405190000","0.0000","N/A","N/A"
"67.122.211.41","37326","244.3.39.102","4899","1","66","1","66","0","0","81.437160000","0.0000","N/A","N/A"
"128.75.71.215","2778","244.3.210.197","80","1","64","0","0","1","64","83.449909000","0.0000","N/A","N/A"
"128.75.71.215","2791","244.3.210.197","80","1","64","0","0","1","64","83.449953000","0.0000","N/A","N/A"
"128.75.71.215","2779","244.3.210.197","80","1","64","0","0","1","64","83.449958000","0.0000","N/A","N/A"
"128.75.71.215","2776","244.3.210.197","80","1","64","0","0","1","64","83.449987000","0.0000","N/A","N/A"
"128.75.71.215","2777","244.3.210.197","80","1","64","0","0","1","64","83.450008000","0.0000","N/A","N/A"
"128.75.71.215","2780","244.3.210.197","80","1","64","0","0","1","64","83.450030000","0.0000","N/A","N/A"
"225.79.185.181","50441","244.3.210.197","80","1","64","0","0","1","64","90.282217000","0.0000","N/A","N/A"
"244.3.41.252","48339","41.177.26.205","5666","1","70","1","70","0","0","90.379211000","0.0000","N/A","N/A"
"225.79.185.181","50442","244.3.210.197","80","1","64","0","0","1","64","95.282220000","0.0000","N/A","N/A"
"151.72.95.110","1289","244.3.210.197","80","1","64","0","0","1","64","120.282358000","0.0000","N/A","N/A"
"151.72.95.110","1291","244.3.210.197","80","1","64","0","0","1","64","120.282363000","0.0000","N/A","N/A"
"151.72.95.110","1293","244.3.210.197","80","1","64","0","0","1","64","120.282367000","0.0000","N/A","N/A"
"151.72.95.110","1285","244.3.210.197","80","1","64","0","0","1","64","120.282371000","0.0000","N/A","N/A"
"151.72.95.110","1287","244.3.210.197","80","1","64","0","0","1","64","120.282375000","0.0000","N/A","N/A"
"151.72.95.110","1295","244.3.210.197","80","1","64","0","0","1","64","120.282405000","0.0000","N/A","N/A"
"209.71.102.241","3814","41.177.98.142","80","1","64","1","64","0","0","122.994643000","0.0000","N/A","N/A"
"209.71.102.241","3815","41.177.98.142","80","1","64","1","64","0","0","122.994964000","0.0000","N/A","N/A"
"40.193.220.98","33294","244.3.210.197","80","1","64","0","0","1","64","125.282328000","0.0000","N/A","N/A"
"41.177.116.184","4341","253.37.253.43","623","1","64","0","0","1","64","126.190203000","0.0000","N/A","N/A"
"33.64.77.46","1386","41.177.230.55","445","1","66","1","66","0","0","127.354262000","0.0000","N/A","N/A"
"253.160.251.85","43326","253.37.253.43","446","1","64","0","0","1","64","132.296682000","0.0000","N/A","N/A"
"41.177.176.254","65524","41.177.26.23","25","1","78","1","78","0","0","132.788307000","0.0000","N/A","N/A"
"225.176.139.18","49259","244.3.210.197","80","1","64","1","64","0","0","141.216988000","0.0000","N/A","N/A"
"253.160.251.85","43327","253.37.253.43","446","1","64","0","0","1","64","142.311590000","0.0000","N/A","N/A"
"223.75.41.154","1114","244.3.41.120","445","1","66","1","66","0","0","143.919414000","0.0000","N/A","N/A"
"41.177.155.193","4084","215.108.241.38","80","1","64","0","0","1","64","156.349536000","0.0000","N/A","N/A"
"244.3.176.210","24385","181.89.145.48","1723","1","64","0","0","1","64","164.610460000","0.0000","N/A","N/A"
"253.160.211.176","1203","253.37.253.43","23","1","64","0","0","1","64","171.138594000","0.0000","N/A","N/A"
"253.160.211.176","1792","253.37.253.43","23","1","64","0","0","1","64","171.238900000","0.0000","N/A","N/A"
"244.3.210.39","4899","67.91.20.26","2644","1","66","0","0","1","66","181.699727000","0.0000","N/A","N/A"
"244.3.210.64","4899","67.91.20.26","2693","1","66","0","0","1","66","181.736054000","0.0000","N/A","N/A"
"244.3.210.108","4899","67.91.20.26","2711","1","66","0","0","1","66","181.743276000","0.0000","N/A","N/A"
"244.3.210.31","4899","67.91.20.26","2733","1","66","0","0","1","66","181.778353000","0.0000","N/A","N/A"
"67.91.20.26","4941","244.3.210.153","4899","1","66","1","66","0","0","183.579696000","0.0000","N/A","N/A"
"67.91.20.26","4975","244.3.210.224","4899","1","66","1","66","0","0","183.611930000","0.0000","N/A","N/A"
"67.91.20.26","4998","244.3.210.224","4899","1","66","1","66","0","0","183.625773000","0.0000","N/A","N/A"
"67.91.20.26","4999","244.3.210.94","4899","1","66","1","66","0","0","183.633953000","0.0000","N/A","N/A"
"67.91.20.26","5000","244.3.210.203","4899","1","66","1","66","0","0","183.654032000","0.0000","N/A","N/A"
"244.3.210.144","4899","67.91.20.26","1043","1","66","0","0","1","66","183.669346000","0.0000","N/A","N/A"
"244.3.210.184","4899","67.91.20.26","1056","1","66","0","0","1","66","183.684380000","0.0000","N/A","N/A"
"244.3.210.41","4899","67.91.20.26","1063","1","66","0","0","1","66","183.699580000","0.0000","N/A","N/A"
"244.3.210.43","4899","67.91.20.26","1111","1","66","0","0","1","66","183.719628000","0.0000","N/A","N/A"
"244.3.210.145","4899","67.91.20.26","1117","1","66","0","0","1","66","183.735116000","0.0000","N/A","N/A"
"244.3.210.130","4899","67.91.20.26","1132","1","66","0","0","1","66","183.751213000","0.0000","N/A","N/A"
"244.3.210.61","4899","67.91.20.26","1213","1","66","0","0","1","66","183.758587000","0.0000","N/A","N/A"
"244.3.210.117","4899","67.91.20.26","1260","1","66","0","0","1","66","183.797763000","0.0000","N/A","N/A"
"244.3.40.80","4899","67.91.20.26","4601","1","66","0","0","1","66","188.793742000","0.0000","N/A","N/A"
"244.3.40.176","4899","67.91.20.26","4594","1","66","0","0","1","66","188.794504000","0.0000","N/A","N/A"
"244.3.40.198","4899","67.91.20.26","4617","1","66","0","0","1","66","188.807133000","0.0000","N/A","N/A"
"41.177.98.220","7010","244.3.93.242","1109","1","64","0","0","1","64","192.034676000","0.0000","N/A","N/A"
"41.177.197.141","16448","41.177.197.48","389","1","70","1","70","0","0","196.687603000","0.0000","N/A","N/A"
"244.3.41.71","42606","79.242.145.77","80","1","66","0","0","1","66","201.424147000","0.0000","N/A","N/A"
"244.3.197.47","53945","253.37.253.43","623","1","127","0","0","1","127","214.640666000","0.0000","N/A","N/A"
"244.3.210.230","3422","253.23.23.108","1433","1","66","1","66","0","0","233.145211000","0.0000","N/A","N/A"
"244.3.160.239","62785","41.43.180.128","80","1","66","1","66","0","0","234.466969000","0.0000","N/A","N/A"
