"Address A","Address B","Packets","Bytes","Packets A → B","Bytes A → B","Packets B → A","Bytes B → A","Rel Start","Duration","Bits/s A → B","Bits/s B → A"
"Cisco_38:f1:0e","Cisco_30:1d:00","83629","22616621","0","0","83629","22616621","0.001809000","234.4782","N/A","771641.03"
"All-HSRP-routers_00","Cisco_38:f1:0e","90562","50274580","0","0","90562","50274580","0.000000000","234.4779","N/A","1715286.28"
"Cisco_38:f1:0f","Cisco_30:1d:00","85948","43767611","0","0","85948","43767611","0.002467000","234.4753","N/A","1493295.67"
"All-HSRP-routers_00","Cisco_38:f1:0f","82383","17114389","1","66","82382","17114323","0.001961000","234.4752","N/A","583919.34"
"Cisco_db:64:00","IPv4mcast_02","9112","599716","9112","599716","0","0","0.000236000","234.4681","20462.18","N/A"
"Oracle_24:3f:fd","Cisco_30:1d:00","45828","4943733","0","0","45828","4943733","0.018681000","234.4588","N/A","168685.79"
"All-HSRP-routers_00","Oracle_01:27:f0","67577","48487923","0","0","67577","48487923","0.013045000","234.4539","N/A","1654497.30"
"Oracle_01:27:f0","Cisco_30:1d:00","63569","47744402","0","0","63569","47744402","0.012954000","234.4527","N/A","1629135.53"
"All-HSRP-routers_00","Oracle_24:3f:fd","27024","24814607","0","0","27024","24814607","0.039146000","234.4386","N/A","846775.46"
"All-HSRP-routers_00","Oracle_24:40:1b","53236","61734806","0","0","53236","61734806","0.019122000","234.4344","N/A","2106680.62"
"All-HSRP-routers_00","IPv4mcast_02","8278","546348","8278","546348","0","0","0.017291000","234.4285","18644.42","N/A"
"Oracle_1e:e8:53","Cisco_30:1d:00","19146","3411254","0","0","19146","3411254","0.012384000","234.4272","N/A","116411.52"
"All-HSRP-routers_00","Oracle_1e:e8:53","30424","38625071","4","256","30420","38624815","0.012589000","234.4267","8.74","1318102.66"
"Ibm_53:a0:10","Cisco_30:1d:00","16699","7798148","0","0","16699","7798148","0.013580000","234.3570","N/A","266197.18"
"All-HSRP-routers_00","Ibm_53:a0:10","20768","16746856","0","0","20768","16746856","0.013152000","234.3567","N/A","571670.68"
"Cisco_67:93:20","Broadcast","856","54784","856","54784","0","0","0.096498000","234.3468","1870.19","N/A"
"Oracle_24:40:1b","Cisco_30:1d:00","4622","1202304","0","0","4622","1202304","0.062053000","234.3421","N/A","41044.41"
"Dell_ab:7f:81","Broadcast","480","47662","480","47662","0","0","0.043145000","234.3188","1627.25","N/A"
"Oracle_ad:41:2b","IPv4mcast_01","1264","80896","1264","80896","0","0","0.103753000","234.3156","2761.95","N/A"
"Cisco_63:ec:b7","PVST+","17632","1198976","17632","1198976","0","0","0.135391000","234.2992","40938.28","N/A"
"All-HSRP-routers_00","Oracle_3f:d3:8e","941","83532","3","192","938","83340","0.018437000","234.2897","6.56","2845.71"
"Oracle_3f:d3:8e","Cisco_30:1d:00","1036","73976","0","0","1036","73976","0.018749000","234.2896","N/A","2525.97"
"Intel_d5:0b:4f","Broadcast","952","93296","952","93296","0","0","0.109419000","234.2764","3185.84","N/A"
"Oracle_01:27:f0","NortelNe_2f:4c:00","7471","745945","3575","492863","3896","253082","0.191314000","234.2594","16831.36","8642.79"
"Oracle_82:f7:ba","Oracle_a1:f7:5c","1312","83968","1312","83968","0","0","0.197174000","234.1928","2868.34","N/A"
"Oracle_a1:f7:5c","Dell_50:00:ea","675","43200","9","576","666","42624","0.197111000","234.1927","19.68","1456.03"
"Oracle_a1:f7:5c","BrocadeC_a1:c5:39","674","43136","8","512","666","42624","0.197119000","234.1927","17.49","1456.03"
"Oracle_a1:f7:5c","BrocadeC_a3:25:b9","669","42816","6","384","663","42432","0.197115000","234.1927","13.12","1449.47"
"Oracle_a1:f7:5c","Netapp_18:ce:70","656","41984","0","0","656","41984","0.197233000","234.1926","N/A","1434.17"
"Oracle_a1:f7:5c","Netapp_18:ab:39","656","41984","0","0","656","41984","0.197225000","234.1926","N/A","1434.17"
"Oracle_a1:f7:5c","IPv4mcast_01","656","41984","656","41984","0","0","0.196968000","234.1926","1434.17","N/A"
"Oracle_a1:f7:5c","Netapp_47:ac:28","656","41984","0","0","656","41984","0.197035000","234.1926","N/A","1434.17"
"Oracle_a1:f7:5c","BrocadeC_35:23:27","671","42944","6","384","665","42560","0.197229000","234.1926","13.12","1453.85"
"Oracle_a1:f7:5c","Netapp_47:ad:64","656","41984","0","0","656","41984","0.197039000","234.1926","N/A","1434.17"
"Oracle_a1:f7:5c","BrocadeC_35:28:59","669","42816","6","384","663","42432","0.197242000","234.1926","13.12","1449.47"
"All-HSRP-routers_00","Oracle_12:e5:2a","6839","5683270","3","192","6836","5683078","0.197107000","234.1926","6.56","194133.48"
"All-HSRP-routers_00","Dell_4b:72:bc","1366","131862","5","320","1361","131542","0.197142000","234.1926","10.93","4493.46"
"Oracle_24:3f:6c","Oracle_a1:f7:5c","1314","84096","1312","83968","2","128","0.197217000","234.1926","2868.34","4.37"
"Cisco_30:1d:00","MS-NLB-VirtServer-Multicast_80:68:4f:08","12418","2396272","12418","2396272","0","0","0.015296000","234.1835","81859.65","N/A"
"Cisco_70:56:80","Dell_1b:19:0c","12418","794752","0","0","12418","794752","0.016292000","234.1826","N/A","27149.82"
"Cisco_70:56:80","Dell_b2:69:7a","12418","794752","0","0","12418","794752","0.016318000","234.1826","N/A","27149.82"
"Cisco_70:56:80","Broadcast","24938","1596032","24938","1596032","0","0","0.016251000","234.1826","54522.65","N/A"
"Cisco_70:56:80","Dell_ee:24:f9","12418","794752","0","0","12418","794752","0.016323000","234.1826","N/A","27149.82"
"Cisco_30:1d:00","Broadcast","6995","449936","6995","449936","0","0","0.145858000","234.1800","15370.60","N/A"
"IntelCor_36:91:3d","IPv4mcast_01","1264","80896","1264","80896","0","0","0.213732000","234.1147","2764.32","N/A"
"Ibm_b7:15:21","Cisco_30:1d:00","2693","502815","0","0","2693","502815","0.126530000","234.0981","N/A","17183.05"
"NortelNe_2f:4c:00","Broadcast","3482","222848","3482","222848","0","0","0.183439000","234.0884","7615.86","N/A"
"All-HSRP-routers_00","Oracle_24:40:23","8751","4569952","3","192","8748","4569760","0.065270000","234.0821","6.56","156176.30"
"All-HSRP-routers_00","Ibm_b7:15:21","2576","1279003","3","192","2573","1278811","0.149595000","234.0745","6.56","43706.13"
"All-HSRP-routers_00","Oracle_1e:e8:54","989","96212","2","128","987","96084","0.216290000","234.0532","4.38","3284.18"
"Oracle_1e:e8:54","Cisco_30:1d:00","1005","215353","0","0","1005","215353","0.216560000","234.0532","N/A","7360.82"
"Oracle_24:40:23","Cisco_30:1d:00","7941","1087874","0","0","7941","1087874","0.096568000","234.0514","N/A","37184.10"
"Cisco_58:be:62","Cisco_30:1d:00","10315","2266766","0","0","10315","2266766","0.433207000","234.0355","N/A","77484.52"
"Cisco_38:f1:11","Cisco_37:08:73","2726","1748676","2351","1696578","375","52098","0.228823000","234.0064","58001.09","1781.08"
"Dell_b2:69:7a","MS-NLB-VirtServer-Multicast_80:68:4f:08","518","716092","518","716092","0","0","0.031928000","234.0009","24481.69","N/A"
"Dell_ee:24:f9","MS-NLB-VirtServer-Multicast_80:68:4f:08","516","715904","516","715904","0","0","0.225322000","234.0001","24475.34","N/A"
"Vmware_5c:fb:45","Broadcast","118","10502","118","10502","0","0","0.477825000","233.9988","359.04","N/A"
"Dell_1b:19:0c","MS-NLB-VirtServer-Multicast_80:68:4f:08","518","715708","518","715708","0","0","0.165872000","233.9980","24468.86","N/A"
"Cisco_64:7c:77","Cisco_58:be:63","468","38376","234","19188","234","19188","0.486383000","233.9734","656.07","656.07"
"Cisco_64:7c:76","Cisco_58:be:62","468","38376","234","19188","234","19188","0.486332000","233.9734","656.07","656.07"
"Oracle_38:cc:c6","Cisco_30:1d:00","655","41969","0","0","655","41969","0.218709000","233.9397","N/A","1435.21"
"All-HSRP-routers_00","Oracle_38:cc:c6","656","41984","2","128","654","41856","0.218453000","233.9396","4.38","1431.34"
"All-HSRP-routers_00","Apple_9c:07:62","1356","470723","1","64","1355","470659","0.460614000","233.9357","N/A","16095.33"
"BrocadeC_a1:c5:39","Oracle_17:00:0a","282","18048","143","9152","139","8896","0.076160000","233.9234","312.99","304.24"
"Oracle_0f:07:a3","Cisco_30:1d:00","668","43124","0","0","668","43124","0.197308000","233.9230","N/A","1474.81"
"All-HSRP-routers_00","Oracle_0f:07:a3","659","42214","3","192","656","42022","0.197011000","233.9228","6.57","1437.12"
"Cisco_7b:b0:70","PVST+","819","55692","819","55692","0","0","0.080415000","233.8709","1905.05","N/A"
"All-HSRP-routers_00","Cisco_58:be:62","14087","15079718","0","0","14087","15079718","0.433717000","233.8489","N/A","515879.05"
"Ibm_b7:3b:b4","Cisco_58:be:63","12568","13938699","12568","13938699","0","0","0.433607000","233.8487","476844.95","N/A"
"All-HSRP-routers_00","Oracle_0f:07:a2","1003","90036","3","192","1000","89844","0.226976000","233.8026","6.57","3074.18"
"Oracle_0f:07:a2","Cisco_30:1d:00","1150","88637","0","0","1150","88637","0.227243000","233.8026","N/A","3032.88"
"Apple_9c:07:62","Cisco_30:1d:00","1315","92632","0","0","1315","92632","0.461094000","233.7629","N/A","3170.12"
"Oracle_17:00:0a","Oracle_17:13:e2","261","16704","261","16704","0","0","0.367083000","233.7528","571.68","N/A"
"Oracle_17:13:e2","IPv4mcast_01","1310","83840","1310","83840","0","0","0.366988000","233.7528","2869.36","N/A"
"Dell_36:c1:58","Oracle_17:13:e2","676","43264","667","42688","9","576","0.367068000","233.7528","1460.96","19.71"
"IETF-VRRP-VRID_01","IPv4mcast_12","224","14336","224","14336","0","0","0.379312000","233.6176","490.92","N/A"
"AlteonNe_4b:47:10","Broadcast","1632","104448","1632","104448","0","0","0.892753000","233.4819","3578.80","N/A"
"Cisco_30:1d:00","SuperMic_00:d2:46","221","14144","221","14144","0","0","0.425041000","233.1910","485.23","N/A"
"Oracle_12:e5:2a","Cisco_30:1d:00","4037","827427","0","0","4037","827427","0.213561000","233.1860","N/A","28386.86"
"All-HSRP-routers_00","SuperMic_00:d2:46","238","26012","8","512","230","25500","0.305426000","233.1364","17.57","875.02"
"Cisco_db:64:00","IPv4mcast_0d","278","21128","278","21128","0","0","0.044456000","233.0444","725.29","N/A"
"IntelCor_36:ed:dd","Broadcast","234","15912","234","15912","0","0","0.891143000","233.0218","546.28","N/A"
"IntelCor_36:eb:b4","Broadcast","234","15912","234","15912","0","0","0.891147000","233.0218","546.28","N/A"
"IntelCor_36:eb:b5","Broadcast","235","15976","235","15976","0","0","0.766122000","233.0218","548.48","N/A"
"IntelCor_36:ed:dc","Broadcast","234","15912","234","15912","0","0","0.766127000","233.0218","546.28","N/A"
"IntelCor_36:f0:43","Broadcast","234","15912","234","15912","0","0","0.757654000","233.0213","546.28","N/A"
"IntelCor_36:ef:a4","Broadcast","234","15912","234","15912","0","0","0.757659000","233.0213","546.28","N/A"
"IntelCor_36:f0:42","Broadcast","234","15912","234","15912","0","0","0.945156000","233.0213","546.28","N/A"
"IntelCor_36:ef:a5","Broadcast","234","15912","234","15912","0","0","0.945177000","233.0213","546.28","N/A"
"IntelCor_86:b6:b2","Broadcast","234","15912","234","15912","0","0","0.751035000","233.0168","546.30","N/A"
"IntelCor_86:ba:9a","Broadcast","237","16104","237","16104","0","0","0.751031000","233.0168","552.89","N/A"
"IETF-VRRP-VRID_36","IPv4mcast_12","702","44928","702","44928","0","0","0.601083000","233.0079","1542.54","N/A"
"All-HSRP-routers_00","HewlettP_29:b9:74","247","19369","0","0","247","19369","0.663992000","233.0065","N/A","665.01"
"HewlettP_29:b9:74","Cisco_30:1d:00","247","16822","0","0","247","16822","0.862536000","232.9723","N/A","577.65"
"Cisco_30:1d:00","IPv4mcast_0d","372","28272","372","28272","0","0","0.585333000","232.9381","970.97","N/A"
"All-HSRP-routers_00","Dell_ee:24:f9","7687","9632234","1","64","7686","9632170","1.277014000","232.6552","N/A","331208.46"
"Dell_50:00:e9","Cisco_30:1d:00","1419","247813","0","0","1419","247813","0.138515000","232.2686","N/A","8535.39"
"Oracle_17:00:0a","Netapp_47:ad:64","264","16896","131","8384","133","8512","1.506186000","232.1432","288.93","293.34"
"Dell_36:c1:58","Oracle_3f:d3:8f","284","18176","145","9280","139","8896","0.738461000","232.1097","319.85","306.61"
"Dell_36:c1:58","Oracle_38:cc:c7","283","18112","144","9216","139","8896","0.658496000","232.0997","317.66","306.63"
"BrocadeC_a3:25:b9","Oracle_17:00:0a","278","17792","141","9024","137","8768","1.146178000","232.0733","311.07","302.25"
"Oracle_17:03:da","Broadcast","52","3328","52","3328","0","0","1.784856000","232.0444","114.74","N/A"
"Oracle_17:00:0a","Netapp_18:ab:39","262","16768","130","8320","132","8448","0.736259000","232.0433","286.84","291.26"
"Vmware_5c:fb:47","Broadcast","116","10324","116","10324","0","0","1.477842000","231.9987","356.00","N/A"
"Cisco_d7:76:c0","IPv4mcast_02","95","6252","95","6252","0","0","2.176785000","231.8462","215.73","N/A"
"Cisco_30:1d:00","IPv4mcast_05","332","96880","332","96880","0","0","1.377290000","231.7886","3343.74","N/A"
"All-HSRP-routers_00","Apple_f2:f9:ca","156","14664","0","0","156","14664","0.269200000","231.2613","N/A","507.27"
"Apple_f2:f9:ca","Cisco_30:1d:00","78","9204","0","0","78","9204","0.269579000","231.2604","N/A","318.39"
"Oracle_a1:f7:5c","Oracle_17:03:da","118","7552","2","128","116","7424","1.747126000","231.2326","4.43","256.85"
"HewlettP_29:b9:74","Broadcast","243","37380","243","37380","0","0","2.929887000","231.0068","1294.51","N/A"
"HewlettP_5e:c3:de","Broadcast","252","38748","252","38748","0","0","1.094293000","231.0023","1341.91","N/A"
"Cisco_db:64:00","IPv4mcast_05","168","48712","168","48712","0","0","0.800298000","230.7600","1688.75","N/A"
"Ibm_53:9c:12","Ibm_53:a2:c1","744","378757","322","170997","422","207760","3.556787000","230.4140","5937.03","7213.45"
"Vmware_a0:68:26","IPv4mcast_23","132","19008","132","19008","0","0","1.119908000","230.3143","660.25","N/A"
"Cisco_38:f1:0e","Cisco_37:08:70","94","11844","47","5922","47","5922","2.602276000","230.2929","205.72","205.72"
"Cisco_38:f1:0f","Cisco_37:08:71","94","11844","47","5922","47","5922","2.602464000","230.2929","205.72","205.72"
"Dell_93:5d:00","Cisco_30:1d:00","154","14975","0","0","154","14975","1.950578000","230.2759","N/A","520.25"
"All-HSRP-routers_00","Dell_b2:69:7a","9791","12161137","0","0","9791","12161137","0.038765000","230.2440","N/A","422547.85"
"All-HSRP-routers_00","Dell_93:5d:00","173","199512","0","0","173","199512","1.950133000","230.2339","N/A","6932.50"
"Dell_fd:11:79","IPv4mcast_05","47","4418","47","4418","0","0","1.965827000","230.0167","153.66","N/A"
"MS-NLB-PhysServer-01_00","Broadcast","24","1536","24","1536","0","0","2.060119000","230.0143","53.42","N/A"
"Cisco_cc:5a:60","IPv4mcast_05","51","21486","51","21486","0","0","4.199344000","230.0099","747.31","N/A"
"Cisco_67:93:20","IPv4mcast_05","51","21486","51","21486","0","0","1.419811000","230.0098","747.31","N/A"
"Vmware_a0:69:4e","Broadcast","96","9716","96","9716","0","0","0.375519000","230.0065","337.94","N/A"
"Cisco_1e:0d:7e","IPv4mcast_05","52","5184","52","5184","0","0","1.137968000","230.0034","180.31","N/A"
"Dell_54:1c:8d","Broadcast","96","34346","96","34346","0","0","4.059951000","229.9998","1194.64","N/A"
"Cisco_18:ec:00","IPv4mcast_05","246","97884","246","97884","0","0","0.937367000","229.3294","3414.62","N/A"
"Oracle_0f:06:d4","Cisco_30:1d:00","3123","261583","0","0","3123","261583","0.279513000","229.0433","N/A","9136.54"
"All-HSRP-routers_00","Oracle_0f:06:d4","5404","7170213","0","0","5404","7170213","0.279097000","229.0432","N/A","250440.59"
"Oracle_93:0b:3d","Broadcast","20","1280","20","1280","0","0","4.202506000","228.6833","44.78","N/A"
"Cisco_d7:68:c0","Broadcast","57","3648","57","3648","0","0","0.069680000","228.6166","127.65","N/A"
"Vmware_a0:11:be","IPv4mcast_23","93","13392","93","13392","0","0","4.882188000","227.7327","470.45","N/A"
"Spanning-tree-(for-bridges)_07","Spanning-tree-(for-bridges)_09","18","1584","0","0","18","1584","5.816783000","227.7214","N/A","55.65"
"Ibm_53:a0:10","Ibm_31:eb:e2","73","7940","37","4062","36","3878","6.534247000","226.6674","143.36","136.87"
"Ibm_53:a2:c1","Ibm_31:eb:e2","73","7940","37","4062","36","3878","6.534252000","226.6674","143.36","136.87"
"Ibm_53:a2:c1","Cisco_30:1d:00","144","23066","0","0","144","23066","1.034177000","226.5584","N/A","814.48"
"All-HSRP-routers_00","Ibm_53:a2:c1","135","35299","1","64","134","35235","1.034029000","226.5584","N/A","1244.18"
"Dell_0d:ff:ae","Broadcast","138","8832","138","8832","0","0","7.858011000","226.3736","312.12","N/A"
"Apple_f3:20:c1","Broadcast","180","11520","180","11520","0","0","5.628953000","226.2645","407.31","N/A"
"All-HSRP-routers_00","Dell_1b:19:0c","157","97234","0","0","157","97234","3.352388000","226.1863","N/A","3439.08"
"Dell_1b:19:0c","Cisco_30:1d:00","122","18420","0","0","122","18420","3.352193000","226.0944","N/A","651.76"
"Oracle_00:fb:44","Oracle_01:27:f0","41","17114","0","0","41","17114","1.432237000","225.9236","N/A","606.01"
"Oracle_01:27:f1","Cisco_30:1d:00","40","5047","0","0","40","5047","1.431608000","225.9231","N/A","178.72"
"Dell_10:04:e5","Broadcast","116","12182","116","12182","0","0","5.832517000","225.7463","431.71","N/A"
"Dell_fd:12:14","IPv4mcast_05","50","4580","50","4580","0","0","4.880975000","225.0081","162.84","N/A"
"Cisco_38:f1:0f","Broadcast","453","52686","453","52686","0","0","6.857279000","224.9456","1873.73","N/A"
"Oracle_16:e8:44","Broadcast","21","1344","21","1344","0","0","5.031092000","224.6657","47.86","N/A"
"Oracle_16:f6:f9","Broadcast","24","1536","24","1536","0","0","9.660106000","224.3160","54.78","N/A"
"Oracle_0f:07:a3","Broadcast","27","1728","27","1728","0","0","8.398226000","224.2916","61.63","N/A"
"Cisco_db:64:00","Broadcast","40","2560","40","2560","0","0","5.832951000","224.2474","91.33","N/A"
"Oracle_b8:08:da","Broadcast","8","512","8","512","0","0","0.863530000","223.8364","18.30","N/A"
"Vmware_a0:28:94","Broadcast","44","3548","44","3548","0","0","10.313084000","223.2920","127.12","N/A"
"Vmware_a0:1d:44","IPv4mcast_23","96","13824","96","13824","0","0","2.732277000","222.9458","496.05","N/A"
"All-HSRP-routers_00","Oracle_91:6f:a1","137","21677","3","192","134","21485","3.469287000","222.1018","6.92","773.88"
"Oracle_3f:d3:8f","Broadcast","48","3072","48","3072","0","0","9.319658000","221.7403","110.83","N/A"
"IntelCor_86:b3:03","Broadcast","64","4096","64","4096","0","0","0.996692000","221.2604","148.10","N/A"
"Cisco_18:ec:00","Cisco_30:1d:00","2611","454947","1327","257247","1284","197700","0.243343000","221.1889","9304.16","7150.45"
"Cisco_63:ec:b7","CDP/VTP/DTP/PAgP/UDLD","28","4710","28","4710","0","0","10.655271000","221.1692","170.37","N/A"
"Dell_19:81:7b","Broadcast","201","45525","201","45525","0","0","7.099363000","221.1132","1647.12","N/A"
"All-HSRP-routers_00","Dell_19:81:7b","51","13501","1","64","50","13437","7.201561000","221.0109","N/A","486.38"
"Oracle_16:d2:62","Broadcast","12","768","12","768","0","0","9.930838000","220.9458","27.81","N/A"
"Oracle_e4:47:74","Broadcast","40","2560","40","2560","0","0","7.630775000","220.8868","92.72","N/A"
"Apple_f3:20:c0","IPv4mcast_fb","28","2240","28","2240","0","0","6.992839000","220.5598","81.25","N/A"
"IntelCor_70:00:14","Broadcast","45","2880","45","2880","0","0","14.438900000","218.2237","105.58","N/A"
"Cisco_db:64:00","IPv4mcast_01","156","9984","156","9984","0","0","3.176383000","218.1168","366.19","N/A"
"Vmware_a0:27:90","Broadcast","10","640","10","640","0","0","1.549556000","217.3839","23.55","N/A"
"All-HSRP-routers_00","Dell_1d:43:d4","6035","2447012","0","0","6035","2447012","2.725327000","217.0976","N/A","90171.88"
"Dell_1d:43:d4","Cisco_30:1d:00","6978","1114503","0","0","6978","1114503","2.725240000","217.0840","N/A","41071.78"
"Oracle_01:0c:0a","Broadcast","22","1408","22","1408","0","0","5.026138000","215.6200","52.24","N/A"
"Oracle_28:7f:6f","Broadcast","26","2250","26","2250","0","0","0.364525000","215.5502","83.51","N/A"
"Cisco_7b:b0:70","CDP/VTP/DTP/PAgP/UDLD","27","4665","27","4665","0","0","9.109818000","215.2964","173.34","N/A"
"All-HSRP-routers_00","Apple_94:1b:50","108","10301","0","0","108","10301","5.620335000","215.1431","N/A","383.04"
"Apple_94:1b:50","Cisco_30:1d:00","109","9443","0","0","109","9443","5.620840000","215.1424","N/A","351.13"
"Oracle_91:6f:a1","Cisco_30:1d:00","63","7179","0","0","63","7179","3.468096000","214.3266","N/A","267.96"
"Oracle_29:a4:27","Cisco_58:be:63","215","36503","97","25605","118","10898","16.711848000","214.1514","956.52","407.11"
"Vmware_a0:62:0a","Broadcast","8","512","8","512","0","0","6.213881000","212.7106","19.26","N/A"
"Oracle_17:13:e2","Broadcast","28","1792","28","1792","0","0","8.468098000","212.5818","67.44","N/A"
"Cisco_c9:94:58","Broadcast","189","12096","189","12096","0","0","10.620942000","210.9304","458.77","N/A"
"All-HSRP-routers_00","Dell_50:00:e9","23","1890","6","384","17","1506","11.988243000","210.7255","14.58","57.17"
"NortelNe_fb:4f:00","Broadcast","303","19392","303","19392","0","0","3.224304000","210.4231","737.26","N/A"
"Apple_e7:29:f2","IPv4mcast_01","16","1376","16","1376","0","0","2.044376000","210.0116","52.42","N/A"
"Apple_e8:14:06","IPv4mcast_01","32","2752","32","2752","0","0","15.478610000","210.0084","104.83","N/A"
"Apple_f3:20:c0","IPv4mcast_01","16","1392","16","1392","0","0","9.211983000","210.0063","53.03","N/A"
"Apple_9e:4d:99","IPv4mcast_01","32","2848","32","2848","0","0","2.152170000","209.9887","108.50","N/A"
"Cisco_d7:68:c0","IPv4mcast_0d","8","608","8","608","0","0","23.363423000","208.6928","23.31","N/A"
"Oracle_0f:06:d4","Broadcast","29","1856","29","1856","0","0","1.719085000","207.8486","71.44","N/A"
"Oracle_91:6f:a1","Broadcast","30","1920","30","1920","0","0","3.958851000","207.8019","73.92","N/A"
"Dell_bc:55:31","Cisco_30:1d:00","9","594","0","0","9","594","4.525565000","207.5397","N/A","22.90"
"Oracle_1a:65:78","Broadcast","8","512","8","512","0","0","23.940854000","207.4294","19.75","N/A"
"Cisco_d7:76:c0","IPv4mcast_0d","8","608","8","608","0","0","4.273156000","206.3100","23.58","N/A"
"IntelCor_86:b3:07","Broadcast","32","2048","32","2048","0","0","6.211913000","205.6836","79.66","N/A"
"Oracle_a1:f7:5c","Broadcast","11","704","11","704","0","0","20.183518000","205.3858","27.42","N/A"
"Dell_fd:ad:33","Broadcast","11","1085","11","1085","0","0","24.976101000","205.2179","42.30","N/A"
"Dell_af:40:53","Broadcast","4","256","4","256","0","0","10.505968000","205.0798","9.99","N/A"
"Vmware_9b:4c:a4","Broadcast","6","384","6","384","0","0","11.733876000","203.2766","15.11","N/A"
"Oracle_3f:40:4a","Broadcast","6","384","6","384","0","0","6.192567000","203.2049","15.12","N/A"
"Oracle_01:0c:a8","Broadcast","12","768","12","768","0","0","2.769862000","201.9945","30.42","N/A"
"Dell_19:77:fd","Broadcast","12","1317","12","1317","0","0","16.427888000","201.9508","52.17","N/A"
"Oracle_fd:05:53","Broadcast","14","896","14","896","0","0","6.434969000","201.4879","35.58","N/A"
"Oracle_b7:f4:52","Broadcast","10","640","10","640","0","0","4.041987000","201.2270","25.44","N/A"
"Oracle_44:af:6d","Broadcast","8","512","8","512","0","0","13.717321000","200.5783","20.42","N/A"
"Vmware_a0:52:0e","Broadcast","12","768","12","768","0","0","23.754505000","200.0319","30.72","N/A"
"SuperMic_00:d1:c6","Broadcast","69","4416","69","4416","0","0","26.592664000","198.9852","177.54","N/A"
"Oracle_3f:d3:8e","Broadcast","15","960","15","960","0","0","0.808405000","198.4885","38.69","N/A"
"Dell_ee:24:f9","Cisco_30:1d:00","62","5652","0","0","62","5652","4.420276000","198.0671","N/A","228.29"
"Oracle_17:00:0a","Broadcast","18","1152","18","1152","0","0","25.146474000","197.4440","46.68","N/A"
"Cisco_30:1d:00","IPv4mcast_01","52","3328","52","3328","0","0","27.956623000","197.2539","134.97","N/A"
"Apple_35:a2:81","IPv4mcast_fb","6","514","6","514","0","0","34.000177000","197.1491","20.86","N/A"
"Oracle_85:08:0b","Broadcast","13","832","13","832","0","0","5.274587000","196.8197","33.82","N/A"
"Oracle_5b:2b:47","Broadcast","16","1024","16","1024","0","0","4.202292000","196.3789","41.72","N/A"
"Ibm_97:09:65","Broadcast","7","814","7","814","0","0","0.168729000","195.9913","33.23","N/A"
"Dell_b2:69:7a","Cisco_30:1d:00","103","73840","0","0","103","73840","24.192816000","195.5004","N/A","3021.58"
"Dell_19:81:7f","Broadcast","12","3804","12","3804","0","0","20.885605000","195.3329","155.80","N/A"
"Fujitsu_e5:37:ee","Broadcast","32","2048","32","2048","0","0","13.878064000","194.0183","84.45","N/A"
"Oracle_c6:30:3e","Broadcast","32","2048","32","2048","0","0","17.991501000","194.0046","84.45","N/A"
"Oracle_38:cc:c7","Broadcast","36","2304","36","2304","0","0","27.209564000","191.6262","96.19","N/A"
"Vmware_a0:6f:3f","Broadcast","8","512","8","512","0","0","23.096372000","191.5418","21.38","N/A"
"Apple_35:70:bf","IPv4mcast_fb","6","476","6","476","0","0","34.099128000","191.0489","19.93","N/A"
"Ibm_b7:15:21","Broadcast","18","1152","18","1152","0","0","32.457076000","191.0322","48.24","N/A"
"Vmware_a0:2a:ea","Broadcast","10","640","10","640","0","0","27.847422000","190.6946","26.85","N/A"
"Oracle_67:fd:30","Broadcast","14","896","14","896","0","0","2.080585000","188.9263","37.94","N/A"
"Oracle_82:c1:53","Broadcast","86","5504","86","5504","0","0","13.186028000","188.7134","233.33","N/A"
"Oracle_ad:41:2a","Broadcast","12","768","12","768","0","0","28.484052000","188.1539","32.65","N/A"
"IntelCor_36:91:3d","Broadcast","10","640","10","640","0","0","29.304083000","187.8939","27.25","N/A"
"Oracle_1e:e8:53","Broadcast","12","768","12","768","0","0","9.586339000","187.4828","32.77","N/A"
"Lantroni_57:0a:a1","Broadcast","7","630","7","630","0","0","26.683925000","187.4385","26.89","N/A"
"Lantroni_67:21:d9","Broadcast","21","1890","21","1890","0","0","18.450476000","187.2383","80.75","N/A"
"Dell_fe:6a:47","Broadcast","6","750","6","750","0","0","24.748517000","186.9271","32.10","N/A"
"Oracle_2c:c1:00","Broadcast","14","896","14","896","0","0","1.192622000","186.3348","38.47","N/A"
"Oracle_01:0c:48","Broadcast","6","384","6","384","0","0","8.153562000","185.9699","16.52","N/A"
"Oracle_d8:e3:fb","Broadcast","16","1024","16","1024","0","0","4.508219000","184.9952","44.28","N/A"
"Oracle_a4:cf:10","Broadcast","4","256","4","256","0","0","25.894428000","184.3388","11.11","N/A"
"Oracle_d3:d7:e8","Broadcast","6","384","6","384","0","0","41.500057000","184.0453","16.69","N/A"
"Oracle_eb:73:85","Broadcast","6","384","6","384","0","0","21.604377000","184.0173","16.69","N/A"
"Dell_6b:2e:89","Broadcast","20","5520","20","5520","0","0","7.976157000","183.6653","240.44","N/A"
"Fujitsu_e5:3c:36","Broadcast","10","640","10","640","0","0","39.021495000","182.0813","28.12","N/A"
"All-HSRP-routers_00","Dell_e5:c3:49","70","11471","0","0","70","11471","34.737236000","180.5327","N/A","508.32"
"Dell_8d:a5:9a","Ibm_b7:38:0a","8","512","4","256","4","256","22.077482000","180.3789","11.35","11.35"
"Ibm_7e:09:3a","Broadcast","28","1792","28","1792","0","0","1.902346000","180.2143","79.55","N/A"
"Pronet_b8:20:40","Broadcast","4","256","4","256","0","0","9.967486000","180.1763","11.37","N/A"
"Pronet_66:e7:77","Broadcast","4","256","4","256","0","0","9.562870000","180.1738","11.37","N/A"
"Ibm_b7:3b:b4","40:00:10:00:03:49","7","448","7","448","0","0","24.865029000","180.0910","19.90","N/A"
"00:00:00_00:00:00","Ibm_b7:3b:b4","7","448","0","0","7","448","24.644896000","180.0808","N/A","19.90"
"Apple_9d:95:ad","IPv4mcast_fb","4","544","4","544","0","0","9.588487000","180.0460","24.17","N/A"
"Oracle_48:b0:8f","Broadcast","16","1024","16","1024","0","0","23.030853000","180.0317","45.50","N/A"
"Clariion_18:74:03","IPv4mcast_02","6","384","6","384","0","0","3.974630000","180.0089","17.07","N/A"
"Apple_f2:f9:ca","IPv4mcast_01","21","1848","21","1848","0","0","29.801055000","180.0082","82.13","N/A"
"Oracle_15:31:fa","Broadcast","9","576","9","576","0","0","23.399480000","180.0077","25.60","N/A"
"Dell_13:26:07","Broadcast","8","512","8","512","0","0","52.853998000","180.0010","22.76","N/A"
"Cisco_d7:76:c0","IPv4mcast_01","4","256","4","256","0","0","14.685805000","179.9959","11.38","N/A"
"Apple_b5:c1:84","IPv4mcast_fb","8","1088","8","1088","0","0","33.069722000","179.9949","48.36","N/A"
"Apple_b5:dd:7c","IPv4mcast_fb","16","2176","16","2176","0","0","53.592468000","179.9923","96.72","N/A"
"Apple_9b:c5:e8","IPv4mcast_fb","4","544","4","544","0","0","22.472327000","179.9915","24.18","N/A"
"Apple_e4:a0:ba","IPv4mcast_fb","4","544","4","544","0","0","6.721474000","179.8926","24.19","N/A"
"Apple_38:4a:87","IPv4mcast_fb","5","349","5","349","0","0","8.286924000","179.1791","15.58","N/A"
"Vmware_9b:50:64","IPv4mcast_fb","4","256","4","256","0","0","49.957312000","179.0101","11.44","N/A"
"Cisco_e8:e7:80","Broadcast","48","3072","48","3072","0","0","9.360926000","178.9230","137.36","N/A"
"Apple_f2:f9:ca","IPv4mcast_fb","12","768","12","768","0","0","9.464795000","178.7567","34.37","N/A"
"Netapp_0d:d2:3e","IPv4mcast_09","8","512","8","512","0","0","5.021468000","178.3168","22.97","N/A"
"Cisco_30:1d:00","Cisco_db:64:00","4","408","4","408","0","0","45.891487000","178.0848","18.33","N/A"
"Cisco_2a:3a:80","Cisco_30:1d:00","5","510","0","0","5","510","40.870410000","177.9350","N/A","22.93"
"All-HSRP-routers_00","Cisco_2a:3a:80","4","408","0","0","4","408","40.870615000","177.9349","N/A","18.34"
"Oracle_24:40:23","Broadcast","27","1728","27","1728","0","0","25.430937000","177.7999","77.75","N/A"
"Vmware_9b:50:64","IPv4mcast_fc","4","256","4","256","0","0","45.457150000","176.5099","11.60","N/A"
"Apple_9e:4d:99","IPv4mcast_fb","8","512","8","512","0","0","12.508448000","176.4034","23.22","N/A"
"Oracle_eb:cf:79","Broadcast","12","768","12","768","0","0","12.409007000","176.1843","34.87","N/A"
"Oracle_16:d5:51","Broadcast","10","640","10","640","0","0","7.563799000","175.4666","29.18","N/A"
"AlteonNe_4a:b9:60","Broadcast","118","7552","118","7552","0","0","1.713050000","174.6955","345.84","N/A"
"Oracle_eb:73:84","Broadcast","9","576","9","576","0","0","30.474723000","174.1171","26.46","N/A"
"Oracle_12:e5:2a","Broadcast","21","1344","21","1344","0","0","2.463946000","174.1156","61.75","N/A"
"Dell_e0:97:32","Broadcast","12","1500","12","1500","0","0","31.364100000","173.3951","69.21","N/A"
"Oracle_16:c7:3f","Broadcast","8","512","8","512","0","0","29.216056000","173.0835","23.66","N/A"
"TyanComp_80:1b:66","Broadcast","8","887","8","887","0","0","32.319783000","172.2937","41.19","N/A"
"Oracle_0f:07:a2","Broadcast","15","960","15","960","0","0","8.527495000","171.0317","44.90","N/A"
"IETF-VRRP-VRID_36","Broadcast","39","2340","39","2340","0","0","61.120358000","170.9242","109.52","N/A"
"Oracle_0f:06:85","Broadcast","6","384","6","384","0","0","18.957163000","169.7825","18.09","N/A"
"SuperMic_00:d2:46","Broadcast","252","24192","252","24192","0","0","59.112838000","169.6467","1140.82","N/A"
"Oracle_7d:8f:a9","Broadcast","14","896","14","896","0","0","16.896280000","168.4427","42.55","N/A"
"SuperMic_00:d2:46","IPv4mcast_fc","132","9768","132","9768","0","0","58.811123000","168.2470","464.46","N/A"
"IntelCor_36:89:75","Broadcast","80","5120","80","5120","0","0","28.502417000","167.4984","244.54","N/A"
"Oracle_2b:d6:79","Broadcast","90","5760","90","5760","0","0","13.814512000","166.6125","276.57","N/A"
"Oracle_0c:94:92","Broadcast","8","512","8","512","0","0","0.863410000","166.5585","24.59","N/A"
"Oracle_f4:38:a1","Broadcast","6","384","6","384","0","0","30.213676000","165.1819","18.60","N/A"
"Dell_e0:97:34","Broadcast","10","1372","10","1372","0","0","41.499951000","165.0022","66.52","N/A"
"Fujitsu_e5:37:ea","Broadcast","40","2560","40","2560","0","0","6.879966000","164.8996","124.20","N/A"
"Oracle_ac:14:da","Broadcast","9","576","9","576","0","0","36.130807000","162.3848","28.38","N/A"
"Dell_8f:56:c2","Broadcast","16","1024","16","1024","0","0","59.661050000","161.5561","50.71","N/A"
"IntelCor_6e:9b:51","Broadcast","3","375","3","375","0","0","23.047556000","161.4395","18.58","N/A"
"IntelCor_36:91:13","Broadcast","74","4736","74","4736","0","0","31.813885000","160.9526","235.40","N/A"
"Ibm_b7:13:40","Dell_22:f8:97","16","4382","9","3930","7","452","35.385286000","160.3773","196.04","22.55"
"Ibm_b7:13:40","Dell_23:00:e6","16","4382","9","3930","7","452","35.385251000","160.3380","196.09","22.55"
"Dell_8d:af:c3","Ibm_b7:38:0a","32","9670","14","913","18","8757","42.097378000","160.2811","45.57","437.08"
"Oracle_93:0b:1d","Broadcast","20","1280","20","1280","0","0","27.680606000","160.1473","63.94","N/A"
"Dell_6f:51:ee","Broadcast","6","384","6","384","0","0","67.664016000","159.6068","19.25","N/A"
"Dell_4b:72:bc","Cisco_30:1d:00","40","4261","0","0","40","4261","60.324739000","157.4876","N/A","216.45"
"Vmware_a0:05:f5","Broadcast","4","622","4","622","0","0","67.445963000","157.0737","31.68","N/A"
"Oracle_16:a0:69","Broadcast","7","448","7","448","0","0","28.490634000","156.4537","22.91","N/A"
"Oracle_01:0c:a9","Broadcast","4","256","4","256","0","0","42.157867000","155.6622","13.16","N/A"
"Oracle_24:3f:6b","Broadcast","14","896","14","896","0","0","19.350944000","155.2597","46.17","N/A"
"Oracle_16:d9:41","Dell_50:00:e9","20","3292","20","3292","0","0","78.614468000","152.1033","173.15","N/A"
"Oracle_67:fd:31","Broadcast","14","896","14","896","0","0","76.259036000","151.1169","47.43","N/A"
"Oracle_16:ed:56","Broadcast","9","576","9","576","0","0","4.909153000","150.3640","30.65","N/A"
"Dell_2b:6b:f7","Broadcast","9","1125","9","1125","0","0","73.076056000","146.9944","61.23","N/A"
"Dell_aa:51:4d","Broadcast","46","4747","46","4747","0","0","39.519648000","146.6580","258.94","N/A"
"Vmware_a0:29:74","Broadcast","6","384","6","384","0","0","81.071400000","146.0744","21.03","N/A"
"Vmware_a0:20:c5","Broadcast","10","640","10","640","0","0","82.996549000","146.0075","35.07","N/A"
"Oracle_4e:c6:dd","Broadcast","8","628","8","628","0","0","31.719221000","144.3537","34.80","N/A"
"Oracle_12:5a:15","Broadcast","8","512","8","512","0","0","34.949953000","142.9245","28.66","N/A"
"Vmware_a0:7d:26","Broadcast","6","384","6","384","0","0","75.347668000","142.8795","21.50","N/A"
"Vmware_9b:29:b3","Broadcast","4","256","4","256","0","0","65.508354000","142.2455","14.40","N/A"
"Oracle_44:ac:26","Broadcast","8","512","8","512","0","0","29.008538000","141.2329","29.00","N/A"
"Dell_aa:51:4b","Broadcast","8","1814","8","1814","0","0","39.519810000","140.9078","102.99","N/A"
"Oracle_16:ed:57","Broadcast","10","640","10","640","0","0","48.859574000","140.6440","36.40","N/A"
"Dell_e6:83:d0","Broadcast","2","311","2","311","0","0","81.129653000","139.6097","17.82","N/A"
"Dell_f8:cd:a8","Broadcast","12","2058","12","2058","0","0","90.356922000","135.8452","121.20","N/A"
"Dell_f8:cd:aa","Broadcast","4","535","4","535","0","0","90.357069000","135.8449","31.51","N/A"
"Oracle_16:d5:50","Broadcast","9","576","9","576","0","0","0.063596000","135.8147","33.93","N/A"
"Oracle_86:8c:b0","Broadcast","8","512","8","512","0","0","71.180588000","135.4745","30.23","N/A"
"Vmware_9b:37:b6","Broadcast","32","2454","32","2454","0","0","22.399701000","134.7672","145.67","N/A"
"Oracle_16:ed:9c","Broadcast","9","576","9","576","0","0","93.483059000","134.6326","34.23","N/A"
"Dell_ee:24:fb","Broadcast","21","1344","21","1344","0","0","65.603254000","134.5385","79.92","N/A"
"Intel_d6:e5:29","Broadcast","16","3576","16","3576","0","0","10.904377000","133.2339","214.72","N/A"
"Vmware_a0:36:6e","Broadcast","6","758","6","758","0","0","47.657586000","133.0719","45.57","N/A"
"Dell_36:c1:57","Dell_50:00:e9","28","4022","25","3830","3","192","57.330213000","132.5604","231.14","11.59"
"Cisco_30:1d:00","EmersonN_02:df:b8","3","198","3","198","0","0","54.906119000","131.8616","12.01","N/A"
"Oracle_2d:27:8e","Broadcast","6","384","6","384","0","0","60.817530000","131.0718","23.44","N/A"
"Oracle_ac:32:d2","Broadcast","14","896","14","896","0","0","4.944845000","130.0464","55.12","N/A"
"Oracle_75:74:7f","Broadcast","11","704","11","704","0","0","32.807110000","129.4270","43.51","N/A"
"Oracle_e5:c3:43","Broadcast","16","1024","16","1024","0","0","67.751129000","128.0173","63.99","N/A"
"Dell_0d:ff:b0","Broadcast","3","954","3","954","0","0","55.100597000","127.9463","59.65","N/A"
"Apple_e7:21:fc","Broadcast","4","256","4","256","0","0","34.137123000","127.6051","16.05","N/A"
"Apple_e8:14:08","Broadcast","4","256","4","256","0","0","50.566068000","127.6017","16.05","N/A"
"Apple_e7:29:f4","Broadcast","4","256","4","256","0","0","72.109775000","127.5814","16.05","N/A"
"Apple_e7:0a:c0","Broadcast","4","256","4","256","0","0","36.346886000","127.5734","16.05","N/A"
"Apple_94:1b:53","Broadcast","6","384","6","384","0","0","98.945027000","127.2979","24.13","N/A"
"Apple_94:1b:52","Broadcast","6","384","6","384","0","0","98.943993000","127.2975","24.13","N/A"
"Vmware_9b:24:f8","Broadcast","12","768","12","768","0","0","86.383708000","126.8404","48.44","N/A"
"Vmware_a0:27:68","Broadcast","8","512","8","512","0","0","12.973682000","126.6304","32.35","N/A"
"Ibm_60:20:7b","IPv6mcast_01:00:02","2","220","2","220","0","0","8.302300000","126.3167","13.93","N/A"
"Oracle_1e:e8:54","Broadcast","18","1152","18","1152","0","0","88.347314000","125.6519","73.35","N/A"
"Oracle_0b:44:b5","Broadcast","20","1396","20","1396","0","0","4.375846000","124.4946","89.71","N/A"
"Ibm_60:21:69","IPv6mcast_01:00:02","2","220","2","220","0","0","90.378212000","124.2041","14.17","N/A"
"Oracle_38:cc:c6","Broadcast","9","576","9","576","0","0","107.052796000","123.8757","37.20","N/A"
"Oracle_03:71:9c","Broadcast","10","640","10","640","0","0","41.970955000","122.7150","41.72","N/A"
"Ibm_b7:13:50","Broadcast","4","256","4","256","0","0","61.484407000","122.0208","16.78","N/A"
"Ibm_53:a0:10","Oracle_28:7f:6f","28","4884","12","2114","16","2770","93.754846000","121.4198","139.29","182.51"
"Ibm_60:b9:93","IPv6mcast_01:00:02","2","220","2","220","0","0","1.130406000","121.0603","14.54","N/A"
"Ibm_53:a2:c1","Oracle_28:7f:6f","28","4868","12","2114","16","2754","77.356516000","120.9988","139.77","182.08"
"Dell_19:77:fd","Cisco_30:1d:00","2","128","0","0","2","128","63.522558000","120.7541","N/A","8.48"
"Dell_2b:6b:f7","Cisco_30:1d:00","16","2744","0","0","16","2744","99.706479000","120.6045","N/A","182.02"
"All-HSRP-routers_00","Dell_2b:6b:f7","12","2118","2","128","10","1990","99.707412000","120.6032","8.49","132.00"
"Vmware_9b:60:6f","Broadcast","4","256","4","256","0","0","99.554083000","120.3567","17.02","N/A"
"Vmware_a0:3d:60","Broadcast","4","256","4","256","0","0","105.858796000","120.3336","17.02","N/A"
"Vmware_a0:03:05","Broadcast","6","384","6","384","0","0","58.568422000","120.3279","25.53","N/A"
"Dell_2b:6c:e5","Broadcast","6","750","6","750","0","0","99.758941000","120.3261","49.86","N/A"
"Vmware_9b:79:00","Broadcast","4","256","4","256","0","0","105.895383000","120.3238","17.02","N/A"
"Vmware_9b:3f:b6","Broadcast","4","256","4","256","0","0","109.763233000","120.3127","17.02","N/A"
"Vmware_a0:6b:89","Broadcast","8","512","8","512","0","0","101.806697000","120.3086","34.05","N/A"
"Vmware_9b:5d:d0","Broadcast","4","256","4","256","0","0","29.852233000","120.3019","17.02","N/A"
"Vmware_9b:58:15","Broadcast","8","512","8","512","0","0","58.461088000","120.2968","34.05","N/A"
"Vmware_a0:32:9d","Broadcast","4","256","4","256","0","0","31.799784000","120.2846","17.03","N/A"
"Oracle_0f:06:84","Broadcast","4","256","4","256","0","0","68.528569000","120.2819","17.03","N/A"
"Dell_2b:6a:dc","Broadcast","6","750","6","750","0","0","25.788189000","120.2590","49.89","N/A"
"Vmware_a0:18:18","Broadcast","8","512","8","512","0","0","87.487897000","120.2561","34.06","N/A"
"Cisco_2a:3a:80","Broadcast","20","1280","20","1280","0","0","13.899231000","120.2522","85.15","N/A"
"Computer_fe:11:15","Broadcast","8","512","8","512","0","0","93.732523000","120.2513","34.06","N/A"
"Vmware_a0:58:b9","Broadcast","8","512","8","512","0","0","94.383443000","120.2449","34.06","N/A"
"Vmware_9b:2d:1f","Broadcast","4","256","4","256","0","0","100.013742000","120.2301","17.03","N/A"
"Vmware_9b:18:8c","Broadcast","4","256","4","256","0","0","100.039511000","120.2209","17.04","N/A"
"Oracle_a1:f7:5c","Oracle_3f:d3:8f","2","128","2","128","0","0","110.918747000","120.0513","8.53","N/A"
"Oracle_e5:c1:ae","Broadcast","28","4920","28","4920","0","0","25.897561000","120.0208","327.94","N/A"
"Oracle_24:3f:6c","Broadcast","8","512","8","512","0","0","42.107780000","120.0113","34.13","N/A"
"Vmware_9b:57:6b","Broadcast","4","256","4","256","0","0","102.997133000","120.0102","17.07","N/A"
"Vmware_a0:02:b4","Broadcast","4","256","4","256","0","0","102.996630000","120.0076","17.07","N/A"
"Oracle_2d:1f:bd","Broadcast","4","256","4","256","0","0","0.201109000","120.0007","17.07","N/A"
"Oracle_1e:ea:39","Broadcast","4","256","4","256","0","0","100.998793000","119.9918","17.07","N/A"
"All-HSRP-routers_00","Dell_19:77:fd","3","192","1","64","2","128","63.522164000","119.9872","N/A","8.53"
"Oracle_1e:ea:3a","Broadcast","6","384","6","384","0","0","41.166961000","119.9533","25.61","N/A"
"Ibm_60:cf:e1","IPv6mcast_01:00:02","2","220","2","220","0","0","21.182759000","119.6321","14.71","N/A"
"Ibm_60:21:81","IPv6mcast_01:00:02","2","220","2","220","0","0","84.263423000","116.3809","15.12","N/A"
"Oracle_b7:c7:22","Broadcast","5","320","5","320","0","0","41.840149000","114.9182","22.28","N/A"
"Ibm_53:a2:c1","Broadcast","6","384","6","384","0","0","34.233183000","114.4090","26.85","N/A"
"Oracle_16:ed:2f","Broadcast","20","1280","20","1280","0","0","56.509925000","113.3351","90.35","N/A"
"Oracle_82:f7:ba","Broadcast","4","256","4","256","0","0","51.030852000","113.3004","18.08","N/A"
"Dell_19:81:7b","Cisco_30:1d:00","6","1083","0","0","6","1083","14.745137000","112.4719","N/A","77.03"
"Oracle_2b:d6:78","Broadcast","6","384","6","384","0","0","47.941413000","112.2267","27.37","N/A"
"Ibm_60:8a:f7","IPv6mcast_01:00:02","2","220","2","220","0","0","55.660447000","108.8799","16.16","N/A"
"Vmware_9b:58:ff","Broadcast","8","512","8","512","0","0","17.305451000","108.8370","37.63","N/A"
"Dell_fd:57:e7","Broadcast","2","160","2","160","0","0","124.722595000","107.8814","11.86","N/A"
"Vmware_a0:64:39","Broadcast","4","256","4","256","0","0","76.008944000","107.3035","19.09","N/A"
"Oracle_ae:dd:47","Broadcast","6","384","6","384","0","0","72.346529000","107.1410","28.67","N/A"
"Dell_e6:93:81","Broadcast","6","384","6","384","0","0","65.355047000","107.0786","28.69","N/A"
"Vmware_9b:01:a2","Broadcast","12","768","12","768","0","0","122.172205000","106.2259","57.84","N/A"
"Oracle_1a:5f:de","Broadcast","6","384","6","384","0","0","56.526276000","105.4500","29.13","N/A"
"Dell_66:9e:19","Broadcast","9","1674","9","1674","0","0","73.807442000","101.8411","131.50","N/A"
"Vmware_a0:24:0f","Broadcast","4","622","4","622","0","0","98.347490000","100.0125","49.75","N/A"
"Oracle_82:c1:52","Broadcast","20","1280","20","1280","0","0","128.567455000","99.7556","102.65","N/A"
"Vmware_a0:6c:1a","Broadcast","10","640","10","640","0","0","51.408170000","99.7003","51.35","N/A"
"Dell_33:96:37","Broadcast","16","1408","16","1408","0","0","92.735030000","99.3998","113.32","N/A"
"Vmware_a0:06:95","Broadcast","6","1116","6","1116","0","0","43.575320000","99.0932","90.10","N/A"
"Oracle_e7:da:21","Broadcast","6","384","6","384","0","0","62.976795000","97.4745","31.52","N/A"
"Oracle_d8:e3:fa","Broadcast","7","448","7","448","0","0","4.958218000","97.4335","36.78","N/A"
"Dell_34:e5:99","Broadcast","42","2688","42","2688","0","0","3.414834000","96.6803","222.42","N/A"
"Oracle_16:ed:9d","Broadcast","14","896","14","896","0","0","128.607884000","96.0916","74.60","N/A"
"Apple_37:fc:3f","IPv4mcast_fb","4","310","4","310","0","0","66.281608000","95.0588","26.09","N/A"
"Oracle_99:2a:b3","Broadcast","4","256","4","256","0","0","87.199114000","94.1203","21.76","N/A"
"Oracle_5b:c8:4f","Broadcast","20","1280","20","1280","0","0","25.894166000","93.3305","109.72","N/A"
"Dell_4e:6f:df","Broadcast","28","2444","28","2444","0","0","127.232743000","93.2320","209.71","N/A"
"Vmware_82:51:f4","Broadcast","4","622","4","622","0","0","5.678452000","92.5057","53.79","N/A"
"Oracle_16:d2:63","Broadcast","8","512","8","512","0","0","29.291294000","91.0523","44.99","N/A"
"Vmware_a0:65:94","Broadcast","8","512","8","512","0","0","75.478948000","90.0155","45.50","N/A"
"Vmware_a0:17:df","Broadcast","10","1198","10","1198","0","0","49.730647000","86.3648","110.97","N/A"
"LanAcces_7f:55:26","Broadcast","4","256","4","256","0","0","99.896377000","85.7703","23.88","N/A"
"Oracle_16:cb:d1","Broadcast","192","28256","192","28256","0","0","42.039934000","84.6148","2671.49","N/A"
"Ibm_16:2f:0a","Broadcast","3","192","3","192","0","0","41.358956000","84.2810","18.22","N/A"
"Vmware_a0:6a:21","Broadcast","6","384","6","384","0","0","134.810484000","83.9891","36.58","N/A"
"Oracle_ae:dd:34","Broadcast","4","256","4","256","0","0","30.377423000","82.4770","24.83","N/A"
"Dell_50:9f:42","Broadcast","6","660","6","660","0","0","98.448924000","82.2037","64.23","N/A"
"Broadcom_01:e0:da","Broadcast","16","2528","16","2528","0","0","9.073268000","81.0730","249.45","N/A"
"Oracle_d4:6c:bb","Broadcast","6","384","6","384","0","0","38.136331000","80.5410","38.14","N/A"
"Oracle_fc:de:4e","Broadcast","4","256","4","256","0","0","128.917627000","80.0698","25.58","N/A"
"Dell_8d:af:c3","Cisco_58:be:63","52","20335","28","7841","24","12494","130.374726000","79.8197","785.87","1252.22"
"Dell_e6:83:cf","Broadcast","6","933","6","933","0","0","141.004497000","79.7354","93.61","N/A"
"IntelCor_6e:a0:70","Broadcast","6","933","6","933","0","0","125.720580000","77.4076","96.42","N/A"
"Dell_14:8d:fc","Broadcast","8","880","8","880","0","0","150.734492000","76.6128","91.89","N/A"
"Vmware_a0:50:ff","Broadcast","6","1116","6","1116","0","0","7.600897000","75.8405","117.72","N/A"
"Oracle_ac:14:dc","Broadcast","4","256","4","256","0","0","69.591721000","75.4221","27.15","N/A"
"02:e0:ed:0a:fb:5f","Broadcast","2","128","2","128","0","0","12.626621000","75.2795","13.60","N/A"
"Dell_fe:68:c6","Broadcast","6","750","6","750","0","0","104.933240000","71.1810","84.29","N/A"
"Oracle_01:0c:0b","Broadcast","8","512","8","512","0","0","22.785323000","71.1086","57.60","N/A"
"Vmware_a0:24:89","Broadcast","4","256","4","256","0","0","94.095206000","69.7853","29.35","N/A"
"Ibm_b7:15:21","Dell_22:f8:ee","4","256","2","128","2","128","32.457178000","69.0678","14.83","14.83"
"IntelCor_86:cc:75","Broadcast","2","311","2","311","0","0","125.391655000","67.7821","36.71","N/A"
"Dell_5b:5e:71","Broadcast","12","3012","12","3012","0","0","15.020308000","67.5630","356.64","N/A"
"Dell_e6:b1:2f","Broadcast","4","714","4","714","0","0","77.102457000","67.4422","84.69","N/A"
"Dell_3e:41:78","Cisco_58:be:63","46","19799","26","7709","20","12090","68.665015000","66.8959","921.91","1445.83"
"Apple_e7:21:fa","Broadcast","14","1280","14","1280","0","0","166.956611000","64.9146","157.75","N/A"
"IntelCor_8a:64:5e","Broadcast","21","4728","21","4728","0","0","65.846375000","63.9166","591.77","N/A"
"Dell_15:fd:1c","Broadcast","10","1648","10","1648","0","0","52.590124000","63.7030","206.96","N/A"
"Vmware_a0:2f:4b","Broadcast","10","640","10","640","0","0","3.588868000","62.6643","81.71","N/A"
"IntelCor_6e:a0:71","Broadcast","2","311","2","311","0","0","125.720691000","61.4686","40.48","N/A"
"Apple_37:fc:5f","IPv4mcast_fb","6","442","6","442","0","0","41.245277000","61.3942","57.60","N/A"
"Apple_8b:49:a4","IPv4mcast_fb","4","256","4","256","0","0","3.288156000","60.2643","33.98","N/A"
"Oracle_b7:f4:53","Broadcast","7","448","7","448","0","0","119.546241000","60.2572","59.48","N/A"
"Oracle_ae:dd:48","Broadcast","4","256","4","256","0","0","24.276253000","60.2115","34.01","N/A"
"Ibm_d2:23:ee","Broadcast","4","256","4","256","0","0","11.969405000","59.9907","34.14","N/A"
"Apple_38:4d:a3","IPv4mcast_fb","5","347","5","347","0","0","65.692348000","59.7942","46.43","N/A"
"Intel_a7:07:34","Broadcast","10","640","10","640","0","0","102.504287000","59.7622","85.67","N/A"
"IPv4mcast_02","DellEmc_43:73:19","4","256","0","0","4","256","124.303582000","59.5209","N/A","34.41"
"Oracle_15:3a:57","Broadcast","4","256","4","256","0","0","37.286022000","58.9908","34.72","N/A"
"Oracle_ed:46:e8","Broadcast","4","256","4","256","0","0","4.690210000","58.6597","34.91","N/A"
"Oracle_16:06:3e","Broadcast","6","384","6","384","0","0","120.568964000","58.6025","52.42","N/A"
"Dell_e7:b1:94","Broadcast","6","660","6","660","0","0","3.144664000","57.7649","91.41","N/A"
"Oracle_0e:c3:27","Broadcast","6","384","6","384","0","0","57.354398000","57.4679","53.46","N/A"
"Dell_e3:54:d4","Broadcast","4","256","4","256","0","0","5.968284000","57.1080","35.86","N/A"
"Oracle_f8:1b:a1","Broadcast","6","384","6","384","0","0","37.979698000","55.9404","54.92","N/A"
"Dell_ff:ec:8d","Broadcast","7","631","7","631","0","0","68.062300000","55.7753","90.51","N/A"
"Vmware_a0:74:e9","Broadcast","6","384","6","384","0","0","9.651481000","55.7577","55.10","N/A"
"Vmware_b7:74:79","Broadcast","12","1720","12","1720","0","0","109.547874000","54.0042","254.80","N/A"
"Dell_e6:b6:55","Broadcast","8","512","8","512","0","0","9.100573000","52.9710","77.33","N/A"
"Dell_1b:19:0b","Broadcast","4","686","4","686","0","0","35.024996000","52.9529","103.64","N/A"
"Dell_e6:c6:44","Broadcast","46","5032","46","5032","0","0","137.996828000","52.8145","762.22","N/A"
"Oracle_1d:80:85","Broadcast","4","256","4","256","0","0","3.498263000","49.9546","41.00","N/A"
"Oracle_45:04:db","Broadcast","8","512","8","512","0","0","122.188305000","49.0745","83.46","N/A"
"SuperMic_00:d3:de","Broadcast","24","8304","24","8304","0","0","28.408042000","49.0718","1353.77","N/A"
"Dell_6d:b9:e3","Broadcast","4","256","4","256","0","0","85.960432000","45.8834","44.63","N/A"
"Oracle_29:a4:27","Broadcast","2","128","2","128","0","0","66.445156000","45.2497","22.63","N/A"
"Dell_e3:55:1e","Broadcast","9","576","9","576","0","0","64.874847000","45.0503","102.29","N/A"
"IntelCor_6e:9b:50","Broadcast","6","933","6","933","0","0","2.526491000","44.6469","167.18","N/A"
"Dell_e3:54:1b","Broadcast","9","576","9","576","0","0","62.931403000","44.1434","104.39","N/A"
"Cisco_30:1d:00","Vmware_4a:5d:a1","5","330","5","330","0","0","128.216757000","43.5302","60.65","N/A"
"Oracle_1d:80:84","Broadcast","9","576","9","576","0","0","112.898176000","43.3542","106.29","N/A"
"Dell_92:20:33","Broadcast","12","1056","12","1056","0","0","68.950300000","42.7502","197.61","N/A"
"Dell_f7:e9:b5","Broadcast","2","311","2","311","0","0","93.117823000","42.6274","58.37","N/A"
"Vmware_a0:6b:c0","Broadcast","6","384","6","384","0","0","98.386181000","41.7395","73.60","N/A"
"Oracle_f4:38:c9","Broadcast","6","384","6","384","0","0","16.118298000","40.9807","74.96","N/A"
"Vmware_a0:1e:ff","Broadcast","6","933","6","933","0","0","82.696423000","39.1599","190.60","N/A"
"Ibm_97:09:64","Broadcast","9","1674","9","1674","0","0","66.891960000","38.1562","350.98","N/A"
"Oracle_16:ed:2e","Broadcast","6","384","6","384","0","0","129.101791000","37.6013","81.70","N/A"
"Oracle_01:0a:10","Broadcast","8","512","8","512","0","0","117.482224000","36.0655","113.57","N/A"
"Fujitsu_e5:37:eb","Broadcast","4","256","4","256","0","0","1.808400000","34.3504","59.62","N/A"
"Dell_ed:df:fb","Broadcast","12","1152","12","1152","0","0","159.500423000","31.9766","288.21","N/A"
"Apple_8b:42:7c","Broadcast","14","1280","14","1280","0","0","41.268317000","31.9331","320.67","N/A"
"Dell_eb:64:14","Broadcast","12","768","12","768","0","0","180.372245000","31.5959","194.46","N/A"
"Cisco_30:1d:00","Vmware_4f:63:f4","3","198","3","198","0","0","23.975437000","31.0098","51.08","N/A"
"Dell_eb:65:de","Broadcast","4","256","4","256","0","0","42.616115000","29.5650","69.27","N/A"
"Cisco_30:1d:00","Vmware_4e:53:47","5","330","5","330","0","0","36.898504000","28.3574","93.10","N/A"
"Vmware_a0:6e:dd","Broadcast","6","1116","6","1116","0","0","115.088135000","27.5815","323.70","N/A"
"Dell_e3:54:1c","Broadcast","10","640","10","640","0","0","62.899384000","27.0806","189.07","N/A"
"Dell_33:96:39","Broadcast","4","543","4","543","0","0","172.920481000","25.9657","167.30","N/A"
"Vmware_9b:42:0d","Broadcast","8","512","8","512","0","0","65.682697000","25.5485","160.32","N/A"
"Oracle_f4:0c:91","Broadcast","6","384","6","384","0","0","71.596233000","25.5406","120.28","N/A"
"Oracle_f4:38:a2","Broadcast","4","256","4","256","0","0","116.501113000","25.4837","80.37","N/A"
"Cisco_30:1d:00","Vmware_70:3a:de","5","330","5","330","0","0","31.110444000","23.7678","111.07","N/A"
"Oracle_67:fd:32","Broadcast","6","384","6","384","0","0","45.529669000","23.4698","130.89","N/A"
"Dell_8d:a5:9a","Cisco_58:be:63","30","15536","17","5692","13","9844","15.863706000","23.1172","1969.79","3406.64"
"Dell_59:57:63","Broadcast","6","660","6","660","0","0","126.853288000","22.6643","232.97","N/A"
"Dell_f2:b8:de","Broadcast","8","512","8","512","0","0","208.641252000","20.1510","203.26","N/A"
"Oracle_d3:d7:e7","Broadcast","6","384","6","384","0","0","64.854287000","18.8408","163.05","N/A"
"Cisco_30:1d:00","IPv6mcast_01","2","244","2","244","0","0","107.013562000","18.0681","108.04","N/A"
"Ibm_60:8a:f7","Broadcast","4","1384","4","1384","0","0","198.460248000","17.9994","615.13","N/A"
"Vmware_9b:6a:b7","Broadcast","4","256","4","256","0","0","3.352430000","17.7161","115.60","N/A"
"Vmware_a0:48:eb","Broadcast","4","256","4","256","0","0","150.419015000","17.3807","117.83","N/A"
"Dell_21:dc:9d","Broadcast","16","1866","16","1866","0","0","38.500125000","17.2990","862.94","N/A"
"Dell_e5:93:a4","Broadcast","6","1130","6","1130","0","0","155.912718000","17.0412","530.48","N/A"
"Oracle_16:7a:2e","Broadcast","6","384","6","384","0","0","163.204604000","15.2941","200.86","N/A"
"Dell_fc:fb:49","Broadcast","4","256","4","256","0","0","119.454596000","14.3315","142.90","N/A"
"Ibm_60:fa:5f","Broadcast","3","1038","3","1038","0","0","84.245368000","13.9994","593.17","N/A"
"Oracle_ac:32:d0","Broadcast","6","384","6","384","0","0","4.958114000","12.6616","242.62","N/A"
"Ibm_7d:66:e3","Broadcast","3","1782","3","1782","0","0","162.969593000","12.2176","1166.84","N/A"
"Ibm_7c:3b:8a","Broadcast","3","1782","3","1782","0","0","132.500793000","12.0451","1183.55","N/A"
"Dell_f0:53:6c","Broadcast","6","384","6","384","0","0","214.196357000","10.9226","281.25","N/A"
"Dell_6f:51:ee","Cisco_30:1d:00","8","524","0","0","8","524","58.338371000","9.3249","N/A","449.55"
"Apple_8b:4a:3c","Broadcast","14","1280","14","1280","0","0","115.940078000","8.8276","1160.00","N/A"
"Dell_1b:19:0c","Broadcast","14","1646","14","1646","0","0","35.025080000","8.8121","1494.30","N/A"
"Dell_e4:7c:06","Broadcast","8","880","8","880","0","0","205.680562000","8.5166","826.62","N/A"
"Dell_b3:70:68","IPv4mcast_10:7b:d5","8","1152","8","1152","0","0","13.009534000","8.4994","1084.32","N/A"
"Oracle_b8:08:db","Broadcast","4","256","4","256","0","0","63.676138000","8.0899","253.16","N/A"
"Cisco_30:1d:00","Vmware_75:b0:6a","3","198","3","198","0","0","54.973516000","7.0901","223.41","N/A"
"IntelCor_0b:cf:62","Broadcast","20","2452","20","2452","0","0","36.423206000","5.0006","3922.74","N/A"
"Dell_50:66:d1","Broadcast","25","3065","25","3065","0","0","186.228241000","4.0021","6126.81","N/A"
"Apple_e7:23:c2","Broadcast","50","6130","50","6130","0","0","159.490452000","4.0016","12255.14","N/A"
"Cisco_30:1d:00","Vmware_7a:6f:0b","2","132","2","132","0","0","55.001788000","3.9553","266.98","N/A"
"Dell_ee:24:f9","Broadcast","6","384","6","384","0","0","34.357219000","3.4817","882.33","N/A"
"Apple_94:1b:50","Broadcast","36","3456","36","3456","0","0","134.593051000","3.0150","9170.11","N/A"
"Cisco_30:1d:00","Vmware_9b:2d:61","5","330","5","330","0","0","188.283837000","3.0119","876.52","N/A"
"Cisco_37:08:71","Cisco_30:1d:00","2","132","0","0","2","132","2.888554000","3.0068","N/A","351.20"
"Cisco_30:1d:00","Vmware_74:41:e8","3","198","3","198","0","0","52.607208000","2.9744","532.54","N/A"
"Cisco_30:1d:00","Vmware_73:25:20","2","132","2","132","0","0","125.371721000","2.9514","357.79","N/A"
"Cisco_30:1d:00","BrocadeC_90:19:7b","2","132","2","132","0","0","9.686658000","2.9506","357.89","N/A"
"Cisco_30:1d:00","EmersonN_07:74:fb","2","132","2","132","0","0","183.966416000","2.9128","362.54","N/A"
"Cisco_30:1d:00","EmersonN_02:e1:ac","2","132","2","132","0","0","183.872060000","2.8984","364.34","N/A"
"Cisco_30:1d:00","EmersonN_0e:7e:8e","2","132","2","132","0","0","183.977908000","2.8927","365.06","N/A"
"Cisco_30:1d:00","EmersonN_02:52:86","2","132","2","132","0","0","183.891639000","2.8836","366.21","N/A"
"Cisco_30:1d:00","EmersonN_09:c3:af","2","132","2","132","0","0","183.993932000","2.8780","366.93","N/A"
"Cisco_30:1d:00","EmersonN_02:e2:13","2","132","2","132","0","0","183.907605000","2.8729","367.57","N/A"
"Cisco_30:1d:00","EmersonN_09:c3:a9","2","132","2","132","0","0","184.017194000","2.8627","368.88","N/A"
"Cisco_30:1d:00","EmersonN_02:e3:63","2","132","2","132","0","0","183.922438000","2.8562","369.72","N/A"
"Cisco_30:1d:00","EmersonN_0a:54:a6","2","132","2","132","0","0","184.032029000","2.8540","370.01","N/A"
"Cisco_30:1d:00","EmersonN_07:6b:45","2","132","2","132","0","0","183.931140000","2.8354","372.44","N/A"
"Cisco_30:1d:00","EmersonN_07:74:55","2","132","2","132","0","0","183.947093000","2.8233","374.03","N/A"
"Vmware_82:28:07","Broadcast","4","622","4","622","0","0","164.195438000","2.3909","2081.19","N/A"
"Vmware_a0:44:d8","Broadcast","4","686","4","686","0","0","193.464941000","1.8598","2950.82","N/A"
"Apple_8b:49:f0","Broadcast","12","1152","12","1152","0","0","23.070768000","1.5249","6043.60","N/A"
"Apple_8b:49:a4","Broadcast","12","1152","12","1152","0","0","61.461872000","1.5241","6046.66","N/A"
"Apple_83:82:2c","Broadcast","12","1152","12","1152","0","0","54.055052000","1.5200","6063.31","N/A"
"Apple_8b:49:d4","Broadcast","12","1152","12","1152","0","0","36.072932000","1.5189","6067.45","N/A"
"Apple_8b:4b:28","Broadcast","12","1152","12","1152","0","0","2.475729000","1.5179","6071.37","N/A"
"Apple_cc:4a:ae","Broadcast","12","1152","12","1152","0","0","27.496941000","1.5175","6073.19","N/A"
"Apple_8b:4b:32","Broadcast","12","1152","12","1152","0","0","74.109341000","1.5159","6079.52","N/A"
"Dell_fd:ad:31","Broadcast","9","864","9","864","0","0","38.473077000","1.4987","4611.89","N/A"
"Dell_e6:c6:44","EmersonN_02:df:b8","94","26354","46","12586","48","13768","187.052543000","1.4119","71313.23","78010.53"
"Dell_e6:c6:44","EmersonN_02:52:81","71","18280","35","8833","36","9447","188.357171000","1.4097","50125.63","53609.96"
"Apple_f3:25:22","Broadcast","12","1152","12","1152","0","0","58.091978000","1.3856","6651.31","N/A"
"Apple_f3:0a:b8","Broadcast","12","1152","12","1152","0","0","84.340899000","1.3807","6674.69","N/A"
"Dell_1b:12:ce","Broadcast","8","880","8","880","0","0","69.960251000","0.7301","9642.62","N/A"
"Vmware_a0:4f:b7","Broadcast","6","384","6","384","0","0","83.742834000","0.2926","10498.51","N/A"
"Ibm_b7:15:21","Dell_23:00:e6","5","389","2","174","3","215","218.472682000","0.2195","6340.76","7834.85"
"Dell_4e:6f:e0","Broadcast","6","384","6","384","0","0","133.792300000","0.1251","24551.06","N/A"
"Dell_e0:95:93","Broadcast","8","512","8","512","0","0","11.252544000","0.1250","32774.03","N/A"
"Cisco_30:1d:00","SuperMic_00:d3:96","11","1356","11","1356","0","0","184.473944000","0.1127","96282.03","N/A"
"All-HSRP-routers_00","SuperMic_00:d3:96","10","752","1","64","9","688","184.473172000","0.1121","N/A","49094.64"
"Cisco_30:1d:00","SuperMic_00:d0:8a","11","1356","11","1356","0","0","201.286976000","0.1075","100906.00","N/A"
"All-HSRP-routers_00","SuperMic_00:d0:8a","10","752","1","64","9","688","201.286058000","0.1072","N/A","51349.51"
"Apple_9c:07:62","IPv4mcast_fb","8","744","8","744","0","0","177.057529000","0.1009","58966.89","N/A"
"Apple_9c:07:63","IPv4mcast_fb","6","586","6","586","0","0","177.057578000","0.1009","46479.81","N/A"
"Dell_fe:68:c7","Cisco_30:1d:00","2","132","0","0","2","132","81.405190000","0.0320","N/A","33030.97"
"Dell_ea:f4:9f","Broadcast","8","512","8","512","0","0","80.901122000","0.0219","186622.93","N/A"
"Vmware_9b:60:0a","Broadcast","8","512","8","512","0","0","90.541324000","0.0205","200127.03","N/A"
"Vmware_a0:02:06","Broadcast","2","128","2","128","0","0","163.264544000","0.0179","57130.10","N/A"
"Apple_f2:f9:cb","IPv4mcast_fb","3","192","3","192","0","0","184.957342000","0.0099","155875.79","N/A"
"IntelCor_36:91:3c","Broadcast","2","128","2","128","0","0","115.805803000","0.0042","245210.73","N/A"
"Ibm_e6:2f:0a","Broadcast","3","192","3","192","0","0","146.358681000","0.0023","656971.77","N/A"
"Oracle_24:b7:52","Oracle_17:03:da","3","426","2","362","1","64","172.474484000","0.0018","1621500.56","N/A"
"Vmware_a0:38:f4","Broadcast","4","256","4","256","0","0","145.683143000","0.0012","1644979.92","N/A"
"Vmware_a0:11:be","Broadcast","3","192","3","192","0","0","100.406863000","0.0012","1270471.46","N/A"
"Dell_b9:37:a2","Broadcast","3","741","3","741","0","0","143.220000000","0.0010","5963782.70","N/A"
"Dell_fc:be:57","Broadcast","2","128","2","128","0","0","133.494068000","0.0009","1096359.74","N/A"
"Dell_1e:3d:33","Broadcast","3","330","3","330","0","0","97.946641000","0.0009","2920353.98","N/A"
"Clariion_0f:8b:51","IPv4mcast_02","2","128","2","128","0","0","69.162970000","0.0008","1226347.31","N/A"
"Oracle_15:ff:a4","Broadcast","3","192","3","192","0","0","19.042637000","0.0008","1873170.73","N/A"
"Vmware_a0:0d:80","Broadcast","3","192","3","192","0","0","100.524913000","0.0007","2210071.94","N/A"
"Oracle_a4:d0:3b","Broadcast","3","192","3","192","0","0","50.248022000","0.0007","2216450.22","N/A"
"Vmware_9b:17:5d","Broadcast","2","128","2","128","0","0","183.131990000","0.0007","1556231.00","N/A"
"Vmware_9b:14:b1","Broadcast","2","128","2","128","0","0","220.591187000","0.0007","1575384.62","N/A"
"SuperMic_00:d0:8a","Broadcast","3","192","3","192","0","0","201.284875000","0.0006","2370370.37","N/A"
"IntelCor_6f:fe:b0","Broadcast","3","741","3","741","0","0","108.957775000","0.0006","9320754.72","N/A"
"Vmware_9b:40:31","Broadcast","2","128","2","128","0","0","83.700037000","0.0006","1615141.96","N/A"
"Oracle_1a:65:79","Broadcast","2","128","2","128","0","0","21.710838000","0.0006","1617693.52","N/A"
"Dell_ea:d0:aa","Broadcast","2","128","2","128","0","0","102.865417000","0.0006","1622820.92","N/A"
"Dell_fd:58:be","Broadcast","3","192","3","192","0","0","214.237176000","0.0006","2445859.87","N/A"
"Dell_b8:d1:a3","Broadcast","2","128","2","128","0","0","205.140391000","0.0006","1633173.84","N/A"
"IbmRisc6_c3:21:92","Broadcast","2","128","2","128","0","0","216.320198000","0.0006","1638400.00","N/A"
"Dell_ea:e2:a5","Broadcast","2","128","2","128","0","0","115.383164000","0.0006","1646302.25","N/A"
"Dell_57:10:1f","Broadcast","2","220","2","220","0","0","189.846802000","0.0006","2889983.58","N/A"
"Vmware_82:5e:f2","Broadcast","4","256","4","256","0","0","128.744982000","0.0006","3368421.05","N/A"
"IntelCor_86:cc:74","Broadcast","3","192","3","192","0","0","72.102366000","0.0006","2538842.98","N/A"
"Dell_91:f2:a2","Broadcast","2","128","2","128","0","0","171.165651000","0.0006","1718120.81","N/A"
"Dell_f7:e9:b3","Broadcast","3","741","3","741","0","0","93.118315000","0.0006","9996627.32","N/A"
"Dell_e7:71:22","Broadcast","3","330","3","330","0","0","147.976444000","0.0006","4459459.46","N/A"
"Ibm_53:9c:12","Broadcast","2","128","2","128","0","0","156.244811000","0.0006","1765517.24","N/A"
"Vmware_a0:05:71","Broadcast","2","128","2","128","0","0","23.761348000","0.0006","1790209.79","N/A"
"Ibm_97:06:da","Broadcast","3","192","3","192","0","0","104.252278000","0.0006","2690017.51","N/A"
"Vmware_9b:51:c1","Broadcast","2","128","2","128","0","0","104.849955000","0.0006","1822064.06","N/A"
"Vmware_a0:15:39","Broadcast","6","384","6","384","0","0","189.377604000","0.0006","5535135.13","N/A"
"TyanComp_49:8c:6c","Broadcast","2","220","2","220","0","0","165.570516000","0.0005","3205828.78","N/A"
"Dell_94:e0:ab","Broadcast","4","256","4","256","0","0","122.537245000","0.0005","3792592.59","N/A"
"Dell_f2:19:45","Broadcast","6","384","6","384","0","0","78.423726000","0.0005","5919075.14","N/A"
"Dell_fd:ad:d6","Broadcast","3","288","3","288","0","0","189.896329000","0.0005","4562376.24","N/A"
"Apple_bf:fd:d8","IPv4mcast_fb","2","128","2","128","0","0","101.829568000","0.0005","2064516.13","N/A"
"Apple_9e:5b:53","IPv4mcast_fb","2","128","2","128","0","0","221.473566000","0.0005","2077079.11","N/A"
"Apple_b5:bc:36","IPv4mcast_fb","2","128","2","128","0","0","101.829609000","0.0005","2106995.88","N/A"
"Oracle_d3:84:4f","Broadcast","3","192","3","192","0","0","38.081571000","0.0005","3206680.58","N/A"
"Vmware_a0:70:90","Broadcast","6","384","6","384","0","0","152.610015000","0.0005","6413361.17","N/A"
"IntelCor_6f:5c:60","Broadcast","3","288","3","288","0","0","4.548913000","0.0005","4871035.94","N/A"
"IntelCor_86:ad:52","Broadcast","3","192","3","192","0","0","88.259799000","0.0005","3303225.81","N/A"
"Ibm_d3:29:c2","Broadcast","2","128","2","128","0","0","3.723267000","0.0004","2343249.43","N/A"
"Oracle_f8:1a:39","Broadcast","3","192","3","192","0","0","105.191041000","0.0004","3755501.22","N/A"
"Vmware_9b:05:7a","Broadcast","3","192","3","192","0","0","172.012536000","0.0004","3783251.23","N/A"
"Oracle_16:08:3c","Broadcast","3","192","3","192","0","0","143.956548000","0.0004","3830423.94","N/A"
"Oracle_f8:1b:51","Broadcast","3","192","3","192","0","0","188.015474000","0.0004","3979274.61","N/A"
"Clariion_18:74:02","IPv4mcast_02","2","128","2","128","0","0","69.026994000","0.0004","2767567.57","N/A"
"Oracle_62:76:b9","Broadcast","2","128","2","128","0","0","198.121961000","0.0004","2775067.75","N/A"
"Apple_f3:25:22","IPv4mcast_fb","2","128","2","128","0","0","123.645720000","0.0004","2797814.21","N/A"
"Vmware_a0:22:82","Broadcast","3","192","3","192","0","0","100.815469000","0.0004","4219780.22","N/A"
"Oracle_38:cc:c8","Broadcast","4","256","4","256","0","0","18.269123000","0.0004","5785310.73","N/A"
"Apple_f1:c6:d0","IPv4mcast_fb","2","128","2","128","0","0","183.403454000","0.0004","2892655.37","N/A"
"Dell_71:07:1b","Broadcast","4","256","4","256","0","0","58.600356000","0.0003","5919075.14","N/A"
"Apple_f3:20:c1","IPv4mcast_fb","2","128","2","128","0","0","183.824326000","0.0003","2959537.57","N/A"
"Dell_eb:f2:3a","Broadcast","3","192","3","192","0","0","214.996228000","0.0003","4452173.91","N/A"
"Oracle_16:3b:c2","Broadcast","3","192","3","192","0","0","67.458791000","0.0003","4452173.91","N/A"
"Oracle_e2:e7:eb","Broadcast","3","192","3","192","0","0","10.482114000","0.0003","4544378.70","N/A"
"Ibm_e6:59:1c","Broadcast","3","192","3","192","0","0","148.050925000","0.0003","4640483.38","N/A"
"Oracle_0e:c3:26","Broadcast","3","192","3","192","0","0","228.284957000","0.0003","4682926.83","N/A"
"Vmware_a0:68:26","IPv4mcast_01:02:03","4","688","4","688","0","0","23.100286000","0.0003","16831804.28","N/A"
"Ibm_08:76:20","Broadcast","4","256","4","256","0","0","61.224415000","0.0003","6282208.59","N/A"
"Oracle_a4:cf:0f","Broadcast","3","192","3","192","0","0","77.422350000","0.0003","4740740.74","N/A"
"Oracle_1d:80:86","Broadcast","3","192","3","192","0","0","47.502256000","0.0003","4740740.74","N/A"
"Vmware_a0:20:91","Broadcast","3","192","3","192","0","0","106.694482000","0.0003","4785046.73","N/A"
"Dell_fe:68:c7","Broadcast","4","988","4","988","0","0","121.145720000","0.0003","24700000.00","N/A"
"Oracle_ae:dd:33","Broadcast","3","192","3","192","0","0","230.948192000","0.0003","4800000.00","N/A"
"Dell_89:ed:3e","Broadcast","3","192","3","192","0","0","135.055617000","0.0003","4815047.02","N/A"
"Oracle_86:8c:b2","Broadcast","2","128","2","128","0","0","189.089392000","0.0003","3230283.91","N/A"
"Dell_89:ec:99","Broadcast","3","192","3","192","0","0","79.346654000","0.0003","4860759.49","N/A"
"Vmware_a0:23:cd","Broadcast","4","256","4","256","0","0","58.852307000","0.0003","6522292.99","N/A"
"Oracle_d3:81:07","Broadcast","3","192","3","192","0","0","126.451216000","0.0003","4970873.79","N/A"
"Dell_11:51:cf","Broadcast","3","330","3","330","0","0","229.515996000","0.0003","8571428.57","N/A"
"Dell_94:c8:33","Broadcast","4","256","4","256","0","0","85.457646000","0.0003","6759075.91","N/A"
"Oracle_15:3a:56","Broadcast","3","192","3","192","0","0","101.557648000","0.0003","5086092.72","N/A"
"Dell_e7:71:43","Broadcast","3","330","3","330","0","0","97.956013000","0.0003","8829431.44","N/A"
"Vmware_a0:3d:b5","Broadcast","2","128","2","128","0","0","115.829357000","0.0003","3424749.16","N/A"
"Computer_73:d2:09","Broadcast","4","256","4","256","0","0","27.855673000","0.0003","6872483.22","N/A"
"Oracle_0e:c3:28","Broadcast","3","192","3","192","0","0","65.416684000","0.0003","5171717.17","N/A"
"Dell_ee:57:2e","Broadcast","3","192","3","192","0","0","92.275632000","0.0003","5189189.19","N/A"
"Vmware_a0:6e:03","Broadcast","3","192","3","192","0","0","200.072962000","0.0003","5260273.97","N/A"
"Vmware_82:1b:bd","Broadcast","3","192","3","192","0","0","181.526494000","0.0003","5296551.72","N/A"
"Dell_ec:2c:8e","Broadcast","3","192","3","192","0","0","69.711810000","0.0003","5314878.89","N/A"
"Vmware_a0:70:5b","Broadcast","4","256","4","256","0","0","55.215910000","0.0003","7288256.23","N/A"
"Oracle_44:ac:27","Broadcast","2","128","2","128","0","0","123.363823000","0.0003","3644128.11","N/A"
"Oracle_b3:db:c0","Broadcast","2","128","2","128","0","0","134.670150000","0.0003","3670250.90","N/A"
"Dell_3f:27:67","Broadcast","2","128","2","128","0","0","122.117203000","0.0003","3670250.90","N/A"
"Vmware_a0:1e:85","Broadcast","2","128","2","128","0","0","166.251720000","0.0003","3696750.90","N/A"
"Dell_15:f0:e7","Dell_94:e0:ab","2","161","1","64","1","97","122.538123000","0.0003","N/A","N/A"
"Ibm_c7:ee:52","Broadcast","2","128","2","128","0","0","91.407001000","0.0003","3737226.28","N/A"
"Dell_8e:87:ac","Broadcast","2","128","2","128","0","0","129.871727000","0.0003","3806691.45","N/A"
"Dell_e7:70:93","Broadcast","2","220","2","220","0","0","91.167088000","0.0003","6666666.67","N/A"
"Dell_2a:fb:a2","Broadcast","2","128","2","128","0","0","91.545237000","0.0003","3893536.12","N/A"
"Vmware_a0:05:8e","Broadcast","2","128","2","128","0","0","200.507271000","0.0003","3923371.65","N/A"
"BrocadeC_04:5b:4b","Broadcast","2","128","2","128","0","0","182.645969000","0.0003","3938461.54","N/A"
"Netapp_0d:76:7c","Broadcast","2","128","2","128","0","0","35.991495000","0.0003","3968992.25","N/A"
"Apple_e7:23:c4","Broadcast","2","128","2","128","0","0","111.738493000","0.0003","3968992.25","N/A"
"Oracle_01:0c:49","Broadcast","2","128","2","128","0","0","72.662115000","0.0003","4015686.27","N/A"
"Vmware_a0:46:8e","Broadcast","2","128","2","128","0","0","166.449783000","0.0003","4031496.06","N/A"
"Ibm_d2:60:96","Broadcast","2","128","2","128","0","0","115.258101000","0.0003","4096000.00","N/A"
"IntelCor_36:89:74","Broadcast","2","128","2","128","0","0","214.516146000","0.0002","4096000.00","N/A"
"Ibm_7b:78:10","Broadcast","2","128","2","128","0","0","190.349211000","0.0002","4112449.80","N/A"
"DellEmc_43:e7:d6","Broadcast","2","128","2","128","0","0","18.934250000","0.0002","4145748.99","N/A"
"Dell_d7:43:61","Broadcast","4","256","4","256","0","0","150.624412000","0.0002","8291497.98","N/A"
"Apple_9d:95:ad","Broadcast","2","128","2","128","0","0","184.942415000","0.0002","4145748.99","N/A"
"DellEmc_43:93:1c","Broadcast","2","128","2","128","0","0","94.131126000","0.0002","4179591.84","N/A"
"Clariion_18:74:03","IPv4mcast_7f:02:02","2","134","2","134","0","0","43.424939000","0.0002","4375510.20","N/A"
"Vmware_a0:0b:e1","Broadcast","2","128","2","128","0","0","41.569894000","0.0002","4196721.31","N/A"
"Ibm_48:c5:10","Broadcast","2","128","2","128","0","0","86.055265000","0.0002","4196721.31","N/A"
"Vmware_a0:54:1d","Broadcast","2","128","2","128","0","0","4.329864000","0.0002","4231404.96","N/A"
"Vmware_3a:97:ec","Broadcast","2","128","2","128","0","0","74.214180000","0.0002","4248962.66","N/A"
"Vmware_a0:6e:8c","Broadcast","2","128","2","128","0","0","40.851052000","0.0002","4248962.66","N/A"
"Vmware_a0:1c:10","Broadcast","2","128","2","128","0","0","33.914542000","0.0002","4266666.67","N/A"
"Dell_ac:0d:87","Broadcast","2","128","2","128","0","0","32.644008000","0.0002","4302521.01","N/A"
"Vmware_a0:0a:d7","Broadcast","2","128","2","128","0","0","90.714330000","0.0002","4302521.01","N/A"
"Netapp_0d:74:15","Broadcast","2","128","2","128","0","0","111.100047000","0.0002","4302521.01","N/A"
"Vmware_42:4d:bd","Broadcast","2","128","2","128","0","0","167.527451000","0.0002","4302521.01","N/A"
"DellEmc_43:37:95","Broadcast","2","128","2","128","0","0","196.416301000","0.0002","4320675.11","N/A"
"Netapp_0d:77:61","Broadcast","2","128","2","128","0","0","224.692535000","0.0002","4338983.05","N/A"
"Netapp_0d:d3:66","Broadcast","2","128","2","128","0","0","187.697192000","0.0002","4394849.79","N/A"
"Apple_9c:07:62","Broadcast","3","192","3","192","0","0","28.462165000","0.0002","6592274.68","N/A"
"Vmware_9b:78:93","Broadcast","2","128","2","128","0","0","188.629257000","0.0002","4413793.10","N/A"
"SuperMic_00:d3:08","Broadcast","3","192","3","192","0","0","17.541302000","0.0002","6678260.87","N/A"
"Vmware_a0:21:3d","Broadcast","2","128","2","128","0","0","34.189899000","0.0002","4471615.72","N/A"
"Vmware_82:1b:41","Broadcast","2","128","2","128","0","0","25.136208000","0.0002","4471615.72","N/A"
"Dell_c8:4a:af","Broadcast","2","128","2","128","0","0","25.779077000","0.0002","4491228.07","N/A"
"Dell_68:10:1a","Broadcast","2","128","2","128","0","0","58.694909000","0.0002","4491228.07","N/A"
"DellEmc_43:70:a6","Broadcast","2","128","2","128","0","0","156.439592000","0.0002","4491228.07","N/A"
"Dell_57:10:19","Broadcast","2","220","2","220","0","0","202.007796000","0.0002","7719298.25","N/A"
"Vmware_a0:3a:7f","Broadcast","2","128","2","128","0","0","220.249338000","0.0002","4511013.22","N/A"
"Dell_fd:2f:3a","Broadcast","2","128","2","128","0","0","172.953939000","0.0002","4551111.11","N/A"
"Dell_d0:8f:03","Broadcast","2","128","2","128","0","0","66.993213000","0.0002","4571428.57","N/A"
"Vmware_a0:48:d9","Broadcast","2","128","2","128","0","0","80.284049000","0.0002","4571428.57","N/A"
"Dell_22:f8:ee","Broadcast","2","494","2","494","0","0","97.075927000","0.0002","17642857.14","N/A"
"Vmware_a0:47:d6","Broadcast","4","256","4","256","0","0","178.712115000","0.0002","9142857.14","N/A"
"Dell_e2:df:9c","Broadcast","2","128","2","128","0","0","194.174657000","0.0002","4591928.25","N/A"
"Ibm_d3:3f:05","Broadcast","4","256","4","256","0","0","45.871097000","0.0002","9183856.50","N/A"
"Oracle_b7:c9:36","Broadcast","2","128","2","128","0","0","45.624292000","0.0002","4612612.61","N/A"
"Apple_9e:5b:53","Broadcast","2","128","2","128","0","0","46.949009000","0.0002","4612612.61","N/A"
"Vmware_a0:74:63","Broadcast","2","128","2","128","0","0","125.114916000","0.0002","4633484.16","N/A"
"Oracle_01:0a:11","Broadcast","2","128","2","128","0","0","128.029011000","0.0002","4654545.45","N/A"
"Dell_9b:62:b4","Broadcast","2","128","2","128","0","0","79.485784000","0.0002","4654545.45","N/A"
"Clariion_2c:82:c8","Broadcast","2","128","2","128","0","0","50.002324000","0.0002","4675799.09","N/A"
"SuperMic_00:d3:96","Broadcast","3","192","3","192","0","0","184.472361000","0.0002","7045871.56","N/A"
"Vmware_82:06:10","Broadcast","2","128","2","128","0","0","93.198689000","0.0002","4740740.74","N/A"
"Vmware_a0:68:42","Broadcast","2","128","2","128","0","0","64.228176000","0.0002","4762790.70","N/A"
"Oracle_a0:6f:0d","Broadcast","2","128","2","128","0","0","86.749883000","0.0002","4762790.70","N/A"
"Vmware_a0:49:1c","Broadcast","2","128","2","128","0","0","26.376187000","0.0002","4807511.74","N/A"
"Vmware_a0:16:8c","Broadcast","2","128","2","128","0","0","177.252747000","0.0002","4853080.57","N/A"
"Vmware_46:44:bc","Broadcast","2","128","2","128","0","0","3.969138000","0.0002","4853080.57","N/A"
"Oracle_9a:ed:f3","Broadcast","2","128","2","128","0","0","230.037517000","0.0002","4853080.57","N/A"
"Vmware_a0:24:f2","Broadcast","2","128","2","128","0","0","64.606081000","0.0002","4876190.48","N/A"
"Apple_b5:bc:36","Broadcast","2","128","2","128","0","0","96.009967000","0.0002","4899521.53","N/A"
"Vmware_a0:72:1d","Broadcast","2","128","2","128","0","0","89.435723000","0.0002","4923076.92","N/A"
"Vmware_9b:48:0e","Broadcast","2","128","2","128","0","0","163.573193000","0.0002","4923076.92","N/A"
"Vmware_a0:5d:3c","Broadcast","2","128","2","128","0","0","98.514684000","0.0002","4946859.90","N/A"
"Dell_91:fb:a1","Broadcast","2","128","2","128","0","0","8.457407000","0.0002","4946859.90","N/A"
"Micro-St_f2:c6:70","Broadcast","2","494","2","494","0","0","167.762075000","0.0002","19091787.44","N/A"
"Dell_d4:74:7f","Broadcast","2","128","2","128","0","0","99.917361000","0.0002","4970873.79","N/A"
"Vmware_a0:6d:3f","Broadcast","2","128","2","128","0","0","72.433178000","0.0002","4995121.95","N/A"
"Apple_b5:dd:7c","Broadcast","2","128","2","128","0","0","224.894023000","0.0002","5019607.84","N/A"
"Dell_dd:c8:d3","Broadcast","2","128","2","128","0","0","231.879780000","0.0002","5044334.98","N/A"
"Vmware_a0:01:a0","Broadcast","2","128","2","128","0","0","63.844985000","0.0002","5094527.36","N/A"
"Dell_ec:29:5a","Broadcast","2","128","2","128","0","0","5.516967000","0.0002","5145728.64","N/A"
"Apple_f3:20:c0","Broadcast","2","128","2","128","0","0","86.401232000","0.0002","5171717.17","N/A"
"Vmware_a0:11:6d","Broadcast","2","494","2","494","0","0","159.557533000","0.0002","19959595.96","N/A"
"Netapp_0d:77:5e","Broadcast","2","128","2","128","0","0","128.722178000","0.0002","5197969.54","N/A"
"Dell_92:1f:0f","Broadcast","3","192","3","192","0","0","183.313361000","0.0002","7836734.69","N/A"
"Netapp_0d:d3:8c","Broadcast","2","128","2","128","0","0","66.747757000","0.0002","5224489.80","N/A"
"Oracle_43:69:4b","Broadcast","2","128","2","128","0","0","73.468700000","0.0002","5278350.52","N/A"
"Dell_e5:ef:7a","Broadcast","2","128","2","128","0","0","172.953505000","0.0002","5361256.54","N/A"
"Vmware_a0:40:e9","Broadcast","2","128","2","128","0","0","90.715042000","0.0002","5417989.42","N/A"
"Ibm_a8:93:8f","Broadcast","4","2200","4","2200","0","0","168.404429000","0.0002","93617021.27","N/A"
"Vmware_9b:38:3d","Broadcast","2","128","2","128","0","0","220.602078000","0.0002","5475935.83","N/A"
"Dell_4e:eb:33","Broadcast","4","256","4","256","0","0","93.839490000","0.0002","11010752.69","N/A"
"Netapp_0d:d2:3c","Broadcast","2","128","2","128","0","0","66.747990000","0.0002","5565217.39","N/A"
"Apple_e7:0a:be","Broadcast","4","1014","4","1014","0","0","105.631205000","0.0002","44817679.56","N/A"
"Vmware_a0:22:82","IPv4mcast_01:02:07","3","444","3","444","0","0","23.601523000","0.0002","20297142.86","N/A"
"Vmware_a0:01:8c","Broadcast","2","128","2","128","0","0","164.220694000","0.0002","5988304.09","N/A"
"Dell_f6:ba:a1","Broadcast","2","494","2","494","0","0","101.151292000","0.0002","23247058.82","N/A"
"Dell_d5:21:17","Broadcast","3","330","3","330","0","0","214.121228000","0.0002","15714285.71","N/A"
"Dell_33:97:6a","Broadcast","2","494","2","494","0","0","71.030115000","0.0002","23664670.66","N/A"
"Oracle_aa:84:13","Broadcast","3","192","3","192","0","0","15.335996000","0.0002","9253012.05","N/A"
"Vmware_9b:36:ba","Broadcast","3","192","3","192","0","0","25.770562000","0.0002","9423312.88","N/A"
"Dell_4d:f9:c3","Broadcast","2","192","2","192","0","0","221.847581000","0.0002","9600000.00","N/A"
"Dell_f8:dd:78","Broadcast","2","494","2","494","0","0","35.382257000","0.0002","24700000.00","N/A"
"Dell_fe:6a:48","Broadcast","2","494","2","494","0","0","149.668190000","0.0002","24700000.00","N/A"
"Dell_54:1c:65","Broadcast","2","494","2","494","0","0","93.058491000","0.0002","25171974.52","N/A"
"Intel_ac:03:73","IPv4mcast_02","2","128","2","128","0","0","5.743934000","0.0002","6606451.61","N/A"
"Dell_4c:79:a0","Broadcast","2","494","2","494","0","0","39.787162000","0.0002","25496774.19","N/A"
"Dell_f8:cf:8b","Broadcast","3","192","3","192","0","0","17.690436000","0.0001","10378378.38","N/A"
"Vmware_9b:25:c7","IPv4mcast_65:84:9b","3","441","3","441","0","0","18.719331000","0.0001","23837837.84","N/A"
"Vmware_a0:59:8d","IPv4mcast_01:02:07","4","592","4","592","0","0","16.504686000","0.0001","33828571.43","N/A"
"Vmware_9b:42:d0","IPv4mcast_2d:7a:c3","4","576","4","576","0","0","16.424255000","0.0001","33151079.14","N/A"
"Vmware_a0:11:be","IPv4mcast_01:02:03","3","516","3","516","0","0","28.223363000","0.0001","32503937.01","N/A"
"Oracle_16:91:6e","Broadcast","3","192","3","192","0","0","58.695543000","0.0001","13592920.35","N/A"
"Dell_f8:cf:ff","Broadcast","3","192","3","192","0","0","226.228911000","0.0001","13714285.71","N/A"
"Dell_e2:d8:d0","Broadcast","3","192","3","192","0","0","98.239995000","0.0001","14912621.36","N/A"
"Oracle_2b:9d:5c","Broadcast","3","192","3","192","0","0","49.949862000","0.0001","14912621.36","N/A"
"Dell_f8:dd:4c","Broadcast","3","192","3","192","0","0","99.592642000","0.0001","18962962.96","N/A"
"Oracle_f4:38:ca","Broadcast","2","128","2","128","0","0","79.958946000","0.0001","14628571.43","N/A"
"Oracle_f8:1b:a2","Broadcast","2","128","2","128","0","0","48.970042000","0.0001","15515151.51","N/A"
"Oracle_ad:41:2b","Broadcast","2","128","2","128","0","0","203.947530000","0.0001","15753846.15","N/A"
"Oracle_b3:d9:75","Broadcast","2","128","2","128","0","0","49.964242000","0.0001","16000000.00","N/A"
"Oracle_44:af:6c","Broadcast","2","128","2","128","0","0","144.509570000","0.0001","16253968.25","N/A"
"Dell_66:9e:1a","Broadcast","2","494","2","494","0","0","73.807560000","0.0001","64786885.24","N/A"
"IntelCor_77:c7:63","Broadcast","2","128","2","128","0","0","85.677910000","0.0001","17066666.67","N/A"
"Oracle_3f:40:4b","Broadcast","2","128","2","128","0","0","114.635069000","0.0001","17066666.67","N/A"
"Oracle_b3:db:e1","Broadcast","2","128","2","128","0","0","130.617935000","0.0001","17355932.20","N/A"
"Oracle_b3:dc:99","Broadcast","2","128","2","128","0","0","127.159041000","0.0001","17655172.42","N/A"
"Oracle_eb:cf:7a","Broadcast","2","128","2","128","0","0","153.222406000","0.0001","17964912.28","N/A"
"Oracle_a4:d0:3c","Broadcast","2","128","2","128","0","0","210.908846000","0.0001","17964912.28","N/A"
"Oracle_d4:6c:bc","Broadcast","2","128","2","128","0","0","134.147114000","0.0001","18618181.82","N/A"
"Oracle_e2:e7:ec","Broadcast","2","128","2","128","0","0","14.442139000","0.0001","18618181.82","N/A"
"Oracle_b3:de:59","Broadcast","2","128","2","128","0","0","22.718873000","0.0001","18618181.82","N/A"
"Oracle_d3:81:08","Broadcast","2","128","2","128","0","0","47.090268000","0.0001","19320754.72","N/A"
"Oracle_15:31:fb","Broadcast","2","128","2","128","0","0","14.532386000","0.0001","19692307.69","N/A"
"Oracle_f8:1b:52","Broadcast","2","128","2","128","0","0","173.995336000","0.0001","19692307.70","N/A"
"Oracle_d3:84:50","Broadcast","2","128","2","128","0","0","147.572922000","0.0000","20480000.01","N/A"
"Dell_e3:c9:3e","Broadcast","2","128","2","128","0","0","22.894767000","0.0000","20897959.18","N/A"
"Oracle_f4:0c:92","Broadcast","2","128","2","128","0","0","187.777307000","0.0000","21333333.34","N/A"
"Oracle_b3:dc:45","Broadcast","2","128","2","128","0","0","171.801180000","0.0000","22260869.55","N/A"
"Oracle_1d:f5:c9","Broadcast","2","128","2","128","0","0","49.371765000","0.0000","22755555.56","N/A"
"Oracle_f8:1a:3a","Broadcast","2","128","2","128","0","0","118.051124000","0.0000","23813953.49","N/A"
"Oracle_ff:3d:14","Broadcast","2","128","2","128","0","0","208.987192000","0.0000","30117647.06","N/A"
"Oracle_24:3f:fd","Cisco_e8:e7:80","2","128","2","128","0","0","27.712752000","0.0000","39384615.39","N/A"
"Dell_b2:69:7a","Broadcast","2","510","2","510","0","0","169.673510000","0.0000","815999997.42","N/A"
"Vmware_a0:42:51","Broadcast","2","534","2","534","0","0","22.399959000","0.0000","854399999.73","N/A"
"Apple_37:1a:fb","IPv4mcast_fb","2","182","2","182","0","0","93.816695000","0.0000","291199999.91","N/A"
"Apple_36:ec:89","IPv4mcast_fb","2","186","2","186","0","0","93.891509000","0.0000","297599999.91","N/A"
"Oracle_82:f7:b9","Broadcast","2","128","2","128","0","0","161.470866000","0.0000","204800000.52","N/A"
"Ibm_b7:37:f7","Broadcast","2","128","2","128","0","0","181.656642000","0.0000","204800000.52","N/A"
"IntelCor_86:b2:c7","Broadcast","1","64","1","64","0","0","0.607336000","0.0000","N/A","N/A"
"Cisco_30:1d:00","Vmware_46:44:bc","1","66","1","66","0","0","2.586195000","0.0000","N/A","N/A"
"Cisco_30:1d:00","Netapp_0d:d2:94","1","66","1","66","0","0","9.360826000","0.0000","N/A","N/A"
"Cisco_30:1d:00","Netapp_0d:77:5e","1","66","1","66","0","0","9.422351000","0.0000","N/A","N/A"
"Cisco_30:1d:00","Netapp_0d:d3:8e","1","66","1","66","0","0","10.888246000","0.0000","N/A","N/A"
"Cisco_30:1d:00","Netapp_0d:d3:8c","1","66","1","66","0","0","10.925352000","0.0000","N/A","N/A"
"Cisco_30:1d:00","Netapp_0d:d3:64","1","66","1","66","0","0","10.935741000","0.0000","N/A","N/A"
"Cisco_30:1d:00","Netapp_0d:d3:8d","1","66","1","66","0","0","10.948843000","0.0000","N/A","N/A"
"Cisco_30:1d:00","Netapp_0d:d3:65","1","66","1","66","0","0","10.965909000","0.0000","N/A","N/A"
"Cisco_30:1d:00","Netapp_0d:77:61","1","66","1","66","0","0","10.991952000","0.0000","N/A","N/A"
"Cisco_30:1d:00","Netapp_0d:76:7c","1","66","1","66","0","0","10.997079000","0.0000","N/A","N/A"
"Dell_61:24:c8","Broadcast","1","247","1","247","0","0","16.554707000","0.0000","N/A","N/A"
"Broadcom_2c:01:97","IPv4mcast_53:52:4f","1","64","1","64","0","0","18.272960000","0.0000","N/A","N/A"
"Vmware_9b:64:fe","Broadcast","1","64","1","64","0","0","22.173231000","0.0000","N/A","N/A"
"Broadcom_2b:b2:6f","IPv4mcast_53:52:4f","1","64","1","64","0","0","22.724215000","0.0000","N/A","N/A"
"Cisco_30:1d:00","Vmware_a0:13:79","1","70","1","70","0","0","23.321572000","0.0000","N/A","N/A"
"All-HSRP-routers_00","Cisco_e8:e7:80","1","167","0","0","1","167","25.845898000","0.0000","N/A","N/A"
"All-HSRP-routers_00","Computer_73:d2:09","1","64","1","64","0","0","27.856024000","0.0000","N/A","N/A"
"Broadcom_2b:b2:6f","IPv4mcast_53:52:4d","1","92","1","92","0","0","29.809028000","0.0000","N/A","N/A"
"Broadcom_2c:01:97","IPv4mcast_53:52:4d","1","92","1","92","0","0","31.276743000","0.0000","N/A","N/A"
"Ibm_60:cf:e0","IPv6mcast_01:00:02","1","110","1","110","0","0","34.426799000","0.0000","N/A","N/A"
"Dell_f8:dd:7a","Broadcast","1","247","1","247","0","0","35.382210000","0.0000","N/A","N/A"
"All-HSRP-routers_00","Lantroni_67:21:d9","1","94","0","0","1","94","36.130282000","0.0000","N/A","N/A"
"Cisco_30:1d:00","Lantroni_67:21:d9","1","94","1","94","0","0","36.130496000","0.0000","N/A","N/A"
"Dell_e6:84:60","Broadcast","1","64","1","64","0","0","37.390977000","0.0000","N/A","N/A"
"Ibm_b7:13:40","Cisco_30:1d:00","1","66","0","0","1","66","37.873379000","0.0000","N/A","N/A"
"Cisco_70:56:80","Ibm_b7:13:40","1","68","0","0","1","68","37.885286000","0.0000","N/A","N/A"
"JuniperN_93:8e:4f","Broadcast","1","64","1","64","0","0","37.973096000","0.0000","N/A","N/A"
"Dell_2f:28:d9","Cisco_30:1d:00","1","66","0","0","1","66","39.127302000","0.0000","N/A","N/A"
"Cisco_64:7c:76","Cisco_30:1d:00","1","66","0","0","1","66","39.215412000","0.0000","N/A","N/A"
"Dell_8d:a5:9a","Broadcast","1","253","1","253","0","0","39.407379000","0.0000","N/A","N/A"
"Vmware_9b:57:4c","Broadcast","1","64","1","64","0","0","39.657917000","0.0000","N/A","N/A"
"Dell_d5:c8:bc","Cisco_30:1d:00","1","66","0","0","1","66","39.967152000","0.0000","N/A","N/A"
"Dell_d5:11:68","Cisco_30:1d:00","1","66","0","0","1","66","39.982654000","0.0000","N/A","N/A"
"Oracle_99:2a:b4","Broadcast","1","64","1","64","0","0","44.118820000","0.0000","N/A","N/A"
"Dell_fd:58:bf","Broadcast","1","64","1","64","0","0","51.991852000","0.0000","N/A","N/A"
"Oracle_01:27:f1","Cisco_e8:e7:80","1","64","1","64","0","0","54.451454000","0.0000","N/A","N/A"
"Cisco_30:1d:00","Vmware_4d:02:40","1","66","1","66","0","0","54.849318000","0.0000","N/A","N/A"
"Cisco_30:1d:00","Vmware_7b:c1:a0","1","66","1","66","0","0","54.919483000","0.0000","N/A","N/A"
"Cisco_30:1d:00","Vmware_41:ce:ff","1","66","1","66","0","0","54.935610000","0.0000","N/A","N/A"
"Cisco_30:1d:00","Vmware_42:2f:1c","1","66","1","66","0","0","55.087341000","0.0000","N/A","N/A"
"Cisco_30:1d:00","Vmware_9b:54:3b","1","66","1","66","0","0","55.125553000","0.0000","N/A","N/A"
"Cisco_30:1d:00","Vmware_77:3d:9a","1","66","1","66","0","0","55.206754000","0.0000","N/A","N/A"
"Dell_bb:8a:a2","Cisco_30:1d:00","1","66","0","0","1","66","55.227764000","0.0000","N/A","N/A"
"Ibm_60:21:80","IPv6mcast_01:00:02","1","110","1","110","0","0","55.467230000","0.0000","N/A","N/A"
"Dell_36:c1:57","Cisco_30:1d:00","1","66","0","0","1","66","56.925154000","0.0000","N/A","N/A"
"Broadcom_2b:b2:6f","IPv4mcast_53:52:4e","1","92","1","92","0","0","59.804977000","0.0000","N/A","N/A"
"Broadcom_2c:01:97","IPv4mcast_53:52:4e","1","92","1","92","0","0","61.274359000","0.0000","N/A","N/A"
"Intel_ed:62:8a","Dell_e3:55:1e","1","64","1","64","0","0","64.875857000","0.0000","N/A","N/A"
"Dell_3e:41:78","Broadcast","1","64","1","64","0","0","68.664861000","0.0000","N/A","N/A"
"Dell_33:97:6c","Broadcast","1","247","1","247","0","0","71.030042000","0.0000","N/A","N/A"
"Cisco_30:1d:00","IwatsuEl_00:2c:61","1","66","1","66","0","0","74.236132000","0.0000","N/A","N/A"
"All-HSRP-routers_00","Vmware_9b:68:db","1","86","0","0","1","86","75.038094000","0.0000","N/A","N/A"
"JuniperN_3f:fe:bf","Broadcast","1","64","1","64","0","0","77.714700000","0.0000","N/A","N/A"
"IntelCor_86:b6:b3","Broadcast","1","64","1","64","0","0","81.052576000","0.0000","N/A","N/A"
"Dell_f0:13:af","Cisco_30:1d:00","1","66","0","0","1","66","81.217972000","0.0000","N/A","N/A"
"Vmware_a0:32:87","Broadcast","1","247","1","247","0","0","82.696229000","0.0000","N/A","N/A"
"Ibm_60:8a:f6","Broadcast","1","346","1","346","0","0","91.459097000","0.0000","N/A","N/A"
"Ibm_60:cf:e0","Broadcast","1","346","1","346","0","0","97.633585000","0.0000","N/A","N/A"
"Dell_92:20:34","Broadcast","1","96","1","96","0","0","101.193249000","0.0000","N/A","N/A"
"American_6a:a1:e5","Broadcast","1","64","1","64","0","0","108.704170000","0.0000","N/A","N/A"
"IntelCor_6f:fe:b1","Broadcast","1","247","1","247","0","0","108.957895000","0.0000","N/A","N/A"
"Dell_fd:11:7b","Broadcast","1","64","1","64","0","0","112.273808000","0.0000","N/A","N/A"
"Ibm_60:fa:5f","IPv6mcast_01:00:02","1","110","1","110","0","0","123.130003000","0.0000","N/A","N/A"
"Cisco_30:1d:00","CnetTech_3a:c2:3e","1","66","1","66","0","0","127.354262000","0.0000","N/A","N/A"
"Dell_8d:af:c3","Broadcast","1","64","1","64","0","0","130.374887000","0.0000","N/A","N/A"
"Oracle_00:fb:45","Cisco_30:1d:00","1","78","0","0","1","78","132.788307000","0.0000","N/A","N/A"
"Dell_b9:37:a3","Broadcast","1","247","1","247","0","0","143.219883000","0.0000","N/A","N/A"
"Dell_22:f8:97","Cisco_30:1d:00","1","66","0","0","1","66","143.919414000","0.0000","N/A","N/A"
"IntelCor_86:ad:37","Broadcast","1","64","1","64","0","0","152.657521000","0.0000","N/A","N/A"
"Cisco_30:1d:00","AlteonNe_4a:b9:6e","1","64","1","64","0","0","156.349536000","0.0000","N/A","N/A"
"Intel_dc:d5:80","Cisco_30:1d:00","1","64","0","0","1","64","164.610460000","0.0000","N/A","N/A"
"Ibm_a8:93:8e","Broadcast","1","550","1","550","0","0","168.404355000","0.0000","N/A","N/A"
"Apple_94:1b:51","Cisco_30:1d:00","1","66","0","0","1","66","181.699727000","0.0000","N/A","N/A"
"Cisco_70:56:80","Apple_94:1b:51","1","64","0","0","1","64","181.700024000","0.0000","N/A","N/A"
"Apple_36:ec:89","Cisco_30:1d:00","1","66","0","0","1","66","181.736054000","0.0000","N/A","N/A"
"Apple_37:1a:fb","Cisco_30:1d:00","1","66","0","0","1","66","181.743276000","0.0000","N/A","N/A"
"Apple_9c:07:63","Cisco_30:1d:00","1","66","0","0","1","66","181.778353000","0.0000","N/A","N/A"
"All-HSRP-routers_00","Vmware_9b:17:5d","1","64","1","64","0","0","183.132367000","0.0000","N/A","N/A"
"Cisco_30:1d:00","EmersonN_02:52:81","1","66","1","66","0","0","183.579696000","0.0000","N/A","N/A"
"Cisco_70:56:80","EmersonN_02:52:81","1","64","0","0","1","64","183.579961000","0.0000","N/A","N/A"
"Cisco_30:1d:00","EmersonN_02:e3:61","1","66","1","66","0","0","183.611930000","0.0000","N/A","N/A"
"Cisco_30:1d:00","EmersonN_0e:7e:2e","1","66","1","66","0","0","183.625773000","0.0000","N/A","N/A"
"Cisco_30:1d:00","EmersonN_02:88:cd","1","66","1","66","0","0","183.633953000","0.0000","N/A","N/A"
"Cisco_30:1d:00","EmersonN_0e:7e:44","1","66","1","66","0","0","183.654032000","0.0000","N/A","N/A"
"Cisco_30:1d:00","EmersonN_02:f9:75","1","66","1","66","0","0","183.669346000","0.0000","N/A","N/A"
"Cisco_30:1d:00","EmersonN_0c:9c:3a","1","66","1","66","0","0","183.684380000","0.0000","N/A","N/A"
"Cisco_30:1d:00","EmersonN_0a:4a:e5","1","66","1","66","0","0","183.699580000","0.0000","N/A","N/A"
"Cisco_30:1d:00","EmersonN_0c:a2:e0","1","66","1","66","0","0","183.719628000","0.0000","N/A","N/A"
"Cisco_30:1d:00","EmersonN_0c:a2:c2","1","66","1","66","0","0","183.735116000","0.0000","N/A","N/A"
"Cisco_30:1d:00","EmersonN_07:51:b6","1","66","1","66","0","0","183.751213000","0.0000","N/A","N/A"
"Cisco_30:1d:00","EmersonN_02:52:43","1","66","1","66","0","0","183.758587000","0.0000","N/A","N/A"
"Cisco_30:1d:00","EmersonN_09:5e:ad","1","66","1","66","0","0","183.797763000","0.0000","N/A","N/A"
"Cisco_70:56:80","EmersonN_02:df:b8","1","64","0","0","1","64","183.858341000","0.0000","N/A","N/A"
"Broadcom_2b:b2:6f","Broadcast","1","550","1","550","0","0","194.704991000","0.0000","N/A","N/A"
"Oracle_5a:14:5f","Vmware_a0:24:89","1","70","0","0","1","70","196.687603000","0.0000","N/A","N/A"
"IntelCor_6f:5c:61","Broadcast","1","64","1","64","0","0","197.054444000","0.0000","N/A","N/A"
"Broadcom_2b:b2:6f","Cisco_30:1d:00","1","66","0","0","1","66","201.424147000","0.0000","N/A","N/A"
"Broadcom_28:1f:26","Broadcast","1","64","1","64","0","0","203.380177000","0.0000","N/A","N/A"
"Dell_fa:71:8b","Broadcast","1","64","1","64","0","0","215.846213000","0.0000","N/A","N/A"
"Apple_e7:29:f2","IPv4mcast_fb","1","117","1","117","0","0","223.182276000","0.0000","N/A","N/A"
"Vmware_a0:64:39","IPv4mcast_fb","1","90","1","90","0","0","223.453108000","0.0000","N/A","N/A"
"NortelNe_2f:4c:00","Vmware_9b:54:c0","1","64","0","0","1","64","233.990202000","0.0000","N/A","N/A"
"41.177.241.46","151.77.15.210","46685","37849562","28372","35013745","18313","2835817","0.000000000","232.8523","1202951.37","97428.88"
"41.177.18.41","210.218.218.164","95","6254","95","6254","0","0","0.000236000","234.1161","213.71","N/A"
"244.3.153.30","244.3.176.224","46452","34019200","18173","1392547","28279","32626653","0.001961000","216.6563","51419.58","1204733.95"
"41.177.26.91","68.157.168.194","9570","8645136","5664","8315499","3906","329637","0.012384000","233.8482","284475.11","11276.96"
"117.246.95.43","244.3.160.239","2054","723176","960","542017","1094","181159","0.012954000","221.0782","19613.58","6555.47"
"41.177.3.224","41.177.117.184","20988","9008756","11188","4786013","9800","4222743","0.013152000","234.2572","163444.72","144208.77"
"241.82.197.204","244.3.210.197","125","112828","38","8051","87","104777","0.015296000","48.0773","1339.68","17434.77"
"41.177.3.224","41.177.143.72","5610","5341801","3244","4139418","2366","1202383","0.015751000","234.3549","141304.27","41044.87"
"41.177.26.192","210.218.218.164","174","11484","174","11484","0","0","0.017291000","233.7245","393.08","N/A"
"41.177.98.68","41.177.98.160","1312","83968","656","41984","656","41984","0.018437000","234.2899","1433.57","1433.57"
"41.177.26.176","77.197.128.31","423","257883","251","240836","172","17047","0.018681000","76.1456","25302.69","1790.99"
"41.177.26.176","77.197.210.181","370","231091","221","215881","149","15210","0.019023000","67.7281","25499.74","1796.60"
"41.106.176.15","41.177.241.46","10003","1839989","3895","570547","6108","1269442","0.019084000","234.4537","19468.13","43315.74"
"244.3.153.55","244.3.176.118","2351","254190","1342","145750","1009","108440","0.019254000","234.4460","4973.43","3700.30"
"41.177.26.176","77.197.210.67","741","461059","449","431709","292","29350","0.023178000","68.6939","50276.24","3418.06"
"16.176.93.164","244.3.160.239","2357","1454246","936","159307","1421","1294939","0.027910000","234.4380","5436.22","44188.71"
"41.177.26.15","77.197.128.106","520","499004","348","487086","172","11918","0.034206000","4.9422","788456.89","19291.93"
"242.77.209.197","244.3.210.197","211","158391","91","23259","120","135132","0.037273000","6.3134","29472.46","171231.47"
"244.3.155.77","244.3.160.239","2323","715328","1176","243324","1147","472004","0.038220000","88.1087","22093.07","42856.51"
"128.71.90.164","244.3.160.239","2084","1331655","1135","1185096","949","146559","0.038675000","196.4123","48269.74","5969.44"
"41.177.26.176","77.197.210.186","520","312700","314","292010","206","20690","0.038887000","67.8563","34426.86","2439.27"
"41.177.3.47","41.177.3.91","478","47142","478","47142","0","0","0.043145000","234.3188","1609.50","N/A"
"41.177.241.46","151.77.15.152","9252","7790799","3285","808978","5967","6981821","0.043991000","222.7106","29059.34","250794.38"
"244.3.153.25","244.3.160.80","9084","7027221","5851","6470895","3233","556326","0.044223000","221.3634","233855.96","20105.43"
"41.177.31.164","210.218.218.197","16","1216","16","1216","0","0","0.044456000","206.8470","47.03","N/A"
"41.177.3.164","210.218.218.164","190","12504","190","12504","0","0","0.048225000","234.1001","427.30","N/A"
"41.177.241.46","244.3.39.224","587","202705","253","127519","334","75186","0.051774000","223.7001","4560.35","2688.81"
"85.241.98.37","244.3.160.239","902","494884","465","422403","437","72481","0.056242000","156.0216","21658.69","3716.46"
"41.177.26.176","77.197.210.123","617","388523","374","363486","243","25037","0.058846000","67.8569","42853.25","2951.74"
"41.177.241.46","244.3.64.188","1870","374498","98","25030","1772","349468","0.060078000","234.0024","855.72","11947.50"
"41.177.230.130","244.3.153.197","1634","168690","0","0","1634","168690","0.060536000","234.0021","N/A","5767.13"
"41.177.98.57","41.177.202.202","9156","1618012","4578","418987","4578","1199025","0.061904000","234.3422","14303.42","40932.45"
"41.177.98.127","194.224.157.64","49","26308","30","24810","19","1498","0.065270000","39.1030","5075.82","306.47"
"41.177.223.45","244.3.160.239","1640","834822","670","82951","970","751871","0.069348000","17.8595","37157.14","336793.69"
"41.177.230.117","244.3.153.116","982","223969","0","0","982","223969","0.075024000","233.6263","N/A","7669.31"
"246.142.244.80","246.142.244.177","264","16896","132","8448","132","8448","0.076160000","233.9234","288.92","288.92"
"41.177.98.127","122.244.155.71","262","110391","118","96337","144","14054","0.092827000","228.4511","3373.57","492.15"
"41.177.3.224","41.177.143.106","10009","9756497","5894","7500724","4115","2255773","0.097684000","200.6062","299122.30","89958.25"
"41.177.255.215","210.218.218.160","1264","80896","1264","80896","0","0","0.103753000","234.3156","2761.95","N/A"
"41.177.230.91","41.177.230.209","952","93296","0","0","952","93296","0.109419000","234.2764","N/A","3185.84"
"41.177.106.209","210.218.218.164","188","12376","188","12376","0","0","0.112239000","232.0961","426.58","N/A"
"41.177.31.192","210.218.218.164","172","11352","172","11352","0","0","0.113257000","232.7326","390.22","N/A"
"210.218.218.164","244.3.164.192","87","5742","0","0","87","5742","0.113314000","232.4604","N/A","197.61"
"41.177.224.111","244.3.41.84","4","2084","2","148","2","1936","0.126530000","0.0243","48802.61","638390.83"
"41.177.26.209","41.177.98.98","348","47092","0","0","348","47092","0.138510000","232.2686","N/A","1621.98"
"41.177.26.176","141.231.176.176","4","280","2","140","2","140","0.144332000","13.5435","82.70","82.70"
"41.177.98.127","244.41.38.43","8","745","5","407","3","338","0.157267000","1.0639","3060.52","2541.66"
"41.177.98.220","244.3.93.224","4","525","1","174","3","351","0.163879000","11.3748","N/A","246.86"
"210.218.218.164","244.3.61.68","192","12636","0","0","192","12636","0.176554000","233.9878","N/A","432.02"
"244.3.160.89","244.3.160.204","2835","449241","1507","360511","1328","88730","0.191314000","234.2594","12311.51","3030.14"
"244.3.160.204","244.3.160.254","2746","175744","1506","96384","1240","79360","0.192877000","234.2110","3292.21","2710.72"
"244.3.160.204","244.3.160.239","1888","120832","1062","67968","826","52864","0.194458000","234.2449","2321.26","1805.43"
"176.41.89.121","244.3.160.239","2187","1910012","1384","1850320","803","59692","0.196116000","234.0957","63232.95","2039.92"
"210.218.218.160","246.142.244.157","656","41984","0","0","656","41984","0.196968000","234.1926","N/A","1434.17"
"41.177.98.3","41.177.98.160","1310","83840","655","41920","655","41920","0.197011000","233.9233","1433.63","1433.63"
"246.142.244.122","246.142.244.157","656","41984","656","41984","0","0","0.197035000","234.1926","1434.17","N/A"
"246.142.244.48","246.142.244.157","656","41984","656","41984","0","0","0.197039000","234.1926","1434.17","N/A"
"41.177.98.43","246.142.244.157","653","41792","653","41792","0","0","0.197107000","234.1926","1427.61","N/A"
"246.142.244.41","246.142.244.157","656","41984","656","41984","0","0","0.197111000","234.1927","1434.17","N/A"
"246.142.244.157","246.142.244.198","656","41984","0","0","656","41984","0.197115000","234.1927","N/A","1434.17"
"246.142.244.80","246.142.244.157","656","41984","656","41984","0","0","0.197119000","234.1927","1434.17","N/A"
"41.177.98.142","246.142.244.157","656","41984","656","41984","0","0","0.197142000","234.1926","1434.17","N/A"
"246.142.244.31","246.142.244.157","1312","83968","1312","83968","0","0","0.197174000","234.1928","2868.34","N/A"
"246.142.244.98","246.142.244.157","1312","83968","1312","83968","0","0","0.197217000","234.1926","2868.34","N/A"
"246.142.244.108","246.142.244.157","656","41984","656","41984","0","0","0.197225000","234.1926","1434.17","N/A"
"246.142.244.72","246.142.244.157","656","41984","656","41984","0","0","0.197229000","234.1926","1434.17","N/A"
"246.142.244.64","246.142.244.157","656","41984","656","41984","0","0","0.197233000","234.1926","1434.17","N/A"
"246.142.244.157","246.142.244.176","656","41984","0","0","656","41984","0.197242000","234.1926","N/A","1434.17"
"41.177.40.117","244.3.160.239","2006","1900576","613","49676","1393","1850900","0.198820000","233.9969","1698.35","63279.48"
"41.177.98.176","151.77.135.33","678","566108","405","511744","273","54364","0.213561000","188.8502","21678.30","2302.95"
"41.177.255.46","210.218.218.160","1264","80896","1264","80896","0","0","0.213732000","234.1147","2764.32","N/A"
"41.177.98.108","41.177.98.160","1312","83968","656","41984","656","41984","0.216290000","234.0535","1435.02","1435.02"
"41.177.98.15","41.177.98.160","1308","83712","654","41856","654","41856","0.218453000","233.9399","1431.34","1431.34"
"41.177.98.143","186.45.149.67","3","298","1","140","2","158","0.222554000","0.1474","N/A","8573.04"
"18.181.151.91","41.177.98.176","189","118017","84","9947","105","108070","0.224163000","113.5114","701.04","7616.50"
"41.177.26.3","41.177.26.160","1312","83968","656","41984","656","41984","0.226976000","233.8029","1436.56","1436.56"
"246.142.202.202","246.142.202.211","2726","1748676","2351","1696578","375","52098","0.228823000","234.0064","58001.09","1781.08"
"41.177.26.176","77.197.210.198","815","499763","491","467143","324","32620","0.229876000","67.2518","55569.47","3880.34"
"145.95.41.251","145.95.48.57","4","408","0","0","4","408","0.243343000","177.7342","N/A","18.36"
"41.177.244.164","210.218.218.164","95","6252","95","6252","0","0","0.256251000","232.8480","214.80","N/A"
"41.177.26.108","41.177.26.160","1312","83968","656","41984","656","41984","0.266240000","234.1734","1434.29","1434.29"
"41.177.31.94","244.3.47.39","234","23868","156","14664","78","9204","0.269200000","231.2613","507.27","318.39"
"41.177.241.46","151.77.15.155","3173","1373400","1576","877096","1597","496304","0.273936000","229.3894","30588.89","17308.70"
"244.3.153.209","244.3.202.202","24","3428","12","1169","12","2259","0.274278000","193.4013","48.36","93.44"
"41.177.98.31","244.157.156.98","8","752","4","376","4","376","0.279097000","183.0052","16.44","16.44"
"244.3.31.67","244.3.41.84","1245","485709","582","208217","663","277492","0.283521000","231.9384","7181.80","9571.23"
"210.218.218.164","244.3.40.192","172","11352","0","0","172","11352","0.289247000","231.5086","N/A","392.28"
"41.177.26.176","77.197.210.128","751","468407","451","438149","300","30258","0.299065000","67.9971","51549.15","3559.92"
"41.177.241.108","244.3.93.198","443","39132","222","24988","221","14144","0.305426000","233.3106","856.81","484.98"
"15.186.110.142","41.177.26.176","1827","843252","892","96755","935","746497","0.324346000","233.2206","3318.92","25606.55"
"41.177.241.164","210.218.218.164","192","12636","192","12636","0","0","0.336252000","234.0521","431.90","N/A"
"41.177.26.176","77.197.210.160","94","63033","59","59530","35","3503","0.339741000","3.8833","122639.10","7216.61"
"244.3.31.117","244.3.153.34","246","95314","120","79873","126","15441","0.347734000","123.5587","5171.50","999.75"
"41.177.143.186","210.218.218.164","344","22704","344","22704","0","0","0.353243000","233.7887","776.91","N/A"
"210.218.218.160","246.142.244.3","1310","83840","0","0","1310","83840","0.366988000","233.7528","N/A","2869.36"
"41.177.98.142","246.142.244.3","655","41920","655","41920","0","0","0.367064000","233.7528","1434.68","N/A"
"246.142.244.3","246.142.244.77","655","41920","0","0","655","41920","0.367068000","233.7528","N/A","1434.68"
"41.177.98.43","246.142.244.3","652","41728","652","41728","0","0","0.367073000","233.7528","1428.11","N/A"
"246.142.244.3","246.142.244.205","261","16704","0","0","261","16704","0.367083000","233.7528","N/A","571.68"
"41.177.26.211","244.3.160.248","77","16015","39","11899","38","4116","0.370817000","223.2294","426.43","147.51"
"40.193.220.98","41.177.241.46","99060","22621606","49745","10942176","49315","11679430","0.371893000","234.1081","373918.79","399112.42"
"41.177.202.249","244.3.153.13","96242","15827879","47877","8062666","48365","7765213","0.372072000","234.1057","275522.30","265357.56"
"41.177.46.130","91.91.91.91","94","9588","94","9588","0","0","0.375519000","230.0065","333.49","N/A"
"41.177.202.116","210.218.218.57","224","14336","224","14336","0","0","0.379312000","233.6176","490.92","N/A"
"41.177.31.41","210.218.218.164","192","12636","192","12636","0","0","0.384277000","232.9921","433.87","N/A"
"41.177.98.176","41.177.194.186","166","126337","104","113437","62","12900","0.390268000","75.1396","12077.46","1373.44"
"244.3.31.251","244.3.153.209","54","5832","0","0","54","5832","0.390640000","202.2485","N/A","230.69"
"210.218.218.164","244.3.210.164","192","12636","0","0","192","12636","0.400223000","231.3601","N/A","436.93"
"244.3.160.239","244.3.181.123","4735","3007600","2846","2711342","1889","296258","0.427691000","141.0698","153758.89","16800.65"
"40.138.160.255","244.3.160.239","4398","3760137","1708","145686","2690","3614451","0.432910000","221.6956","5257.15","130429.32"
"41.177.213.223","244.3.41.184","24402","17346484","10315","2266766","14087","15079718","0.433207000","234.0355","77484.52","515467.74"
"253.37.253.43","253.160.108.141","39","2496","39","2496","0","0","0.433607000","230.0091","86.81","N/A"
"68.67.164.34","244.3.210.197","58","37919","30","10103","28","27816","0.444800000","68.0301","1188.06","3271.02"
"145.95.43.164","210.218.218.164","96","6318","96","6318","0","0","0.448280000","233.2480","216.70","N/A"
"41.177.244.177","244.3.210.254","1350","297107","662","46418","688","250689","0.460614000","233.3884","1591.10","8593.02"
"41.177.244.185","244.3.210.254","1129","252394","552","38976","577","213418","0.470995000","233.4103","1335.88","7314.77"
"244.3.41.41","244.3.41.184","468","38376","234","19188","234","19188","0.486332000","233.9734","656.07","656.07"
"253.37.253.160","253.37.253.164","468","38376","234","19188","234","19188","0.486383000","233.9734","656.07","656.07"
"210.218.218.164","244.3.141.201","190","12504","0","0","190","12504","0.496230000","232.1921","N/A","430.82"
"41.177.26.176","68.157.168.111","288","102796","144","89801","144","12995","0.498135000","198.7035","3615.48","523.19"
"41.177.93.176","244.3.41.84","84","31866","45","3726","39","28140","0.504793000","226.7087","131.48","992.99"
"41.177.204.209","210.218.218.197","16","1216","16","1216","0","0","0.512393000","207.4861","46.89","N/A"
"210.218.218.164","244.3.251.51","96","6318","0","0","96","6318","0.528232000","233.3281","N/A","216.62"
"210.218.218.164","244.3.47.186","174","11484","0","0","174","11484","0.533292000","232.0885","N/A","395.85"
"41.177.98.192","210.218.218.164","172","11352","172","11352","0","0","0.533362000","233.1445","389.53","N/A"
"210.218.218.164","244.3.160.41","285","18756","0","0","285","18756","0.544256000","231.8242","N/A","647.25"
"41.177.26.176","77.197.210.122","518","321002","309","300071","209","20931","0.554750000","70.0412","34273.66","2390.71"
"41.177.202.164","210.218.218.164","95","6252","95","6252","0","0","0.560219000","232.7681","214.87","N/A"
"210.218.218.197","244.3.39.186","16","1216","0","0","16","1216","0.585333000","208.1686","N/A","46.73"
"210.218.218.57","253.244.230.156","702","44928","0","0","702","44928","0.601083000","233.0079","N/A","1542.54"
"253.37.253.43","253.213.108.81","52","53430","52","53430","0","0","0.621005000","233.3997","1831.37","N/A"
"41.177.204.209","210.218.218.164","192","12624","192","12624","0","0","0.624225000","233.3482","432.80","N/A"
"41.177.98.220","244.3.185.64","3","391","1","134","2","257","0.636978000","0.2022","N/A","10169.01"
"246.142.244.77","246.142.244.194","260","16640","130","8320","130","8320","0.658496000","232.0997","286.77","286.77"
"41.177.241.254","244.3.93.198","484","34682","242","18802","242","15880","0.663992000","233.1708","645.09","544.84"
"41.177.98.43","41.177.202.202","350","48300","175","17640","175","30660","0.667353000","231.0534","610.77","1061.57"
"41.177.26.155","41.177.98.43","706","198448","322","101050","384","97398","0.669606000","231.0727","3498.47","3372.03"
"210.218.218.164","244.3.160.186","258","17028","0","0","258","17028","0.677399000","231.6565","N/A","588.04"
"41.177.98.127","254.210.244.164","37","3130","19","1511","18","1619","0.689828000","44.4678","271.84","291.27"
"176.41.89.210","244.3.160.239","2300","2027573","1463","1974005","837","53568","0.706013000","233.0057","67775.33","1839.20"
"68.33.164.161","244.3.160.239","2319","2051481","856","59920","1463","1991561","0.707266000","233.0317","2057.06","68370.48"
"246.142.244.108","246.142.244.177","260","16640","130","8320","130","8320","0.736259000","232.0433","286.84","286.84"
"246.142.244.77","246.142.244.244","260","16640","130","8320","130","8320","0.738461000","232.1097","286.76","286.76"
"41.177.26.176","68.157.168.13","282","105671","142","93288","140","12383","0.743642000","151.4320","4928.31","654.18"
"41.177.202.57","210.218.218.164","87","5742","87","5742","0","0","0.773254000","232.7446","197.37","N/A"
"41.177.244.90","244.3.210.254","12","804","6","402","6","402","0.781917000","200.5577","16.04","16.04"
"41.177.75.118","210.218.218.75","119","43518","119","43518","0","0","0.800298000","228.2641","1525.18","N/A"
"41.177.241.61","244.3.41.84","100","49400","50","3363","50","46037","0.822639000","152.8578","176.01","2409.40"
"253.37.253.43","253.213.108.150","53","56481","53","56481","0","0","0.825773000","151.7906","2976.79","N/A"
"244.3.160.254","244.3.202.202","84","15073","42","3456","42","11617","0.826685000","216.9896","127.42","428.30"
"198.123.241.156","244.3.160.239","6417","6143297","4295","5956535","2122","186762","0.827456000","228.3218","208706.63","6543.82"
"41.177.161.164","210.218.218.164","282","18564","282","18564","0","0","0.848236000","231.6161","641.20","N/A"
"41.177.98.220","244.3.220.84","35","5993","17","3707","18","2286","0.863083000","40.9146","724.83","446.98"
"41.177.26.209","41.177.98.31","74","13518","0","0","74","13518","0.864038000","225.0485","N/A","480.54"
"244.3.79.141","244.3.160.239","156","97264","60","7473","96","89791","0.870200000","50.4485","1185.05","14238.83"
"145.95.41.164","210.218.218.164","94","6186","94","6186","0","0","0.880229000","232.0641","213.25","N/A"
"41.177.108.204","210.218.218.164","190","12504","190","12504","0","0","0.880282000","232.3361","430.55","N/A"
"41.177.31.186","210.218.218.164","176","11616","176","11616","0","0","0.903762000","233.3820","398.18","N/A"
"82.242.98.77","244.3.160.239","113","94978","70","88232","43","6746","0.919385000","50.4335","13995.77","1070.08"
"41.177.98.220","41.177.211.151","30","5547","13","3423","17","2124","0.920511000","12.0739","2268.03","1407.33"
"253.37.253.43","253.213.108.188","26","27786","26","27786","0","0","0.925973000","191.7583","1159.21","N/A"
"41.177.241.46","77.139.113.224","278","53549","132","29968","146","23581","0.928159000","233.4865","1026.80","807.96"
"41.177.230.130","244.3.153.239","4","456","0","0","4","456","0.928319000","8.9980","N/A","405.42"
"41.177.161.192","210.218.218.164","258","17028","258","17028","0","0","0.933308000","232.5207","585.86","N/A"
"145.95.48.2","210.218.218.75","246","97884","246","97884","0","0","0.937367000","229.3294","3414.62","N/A"
"41.177.93.210","244.3.41.84","12","5032","6","413","6","4619","0.973624000","150.0268","22.02","246.30"
"41.177.241.46","151.77.15.128","945","222674","473","134745","472","87929","0.997528000","232.3039","4640.30","3028.07"
"244.3.153.0","244.3.202.202","16","2812","8","643","8","2169","0.997845000","40.3496","127.49","430.04"
"41.177.26.15","68.157.168.224","6437","6168428","4304","6006740","2133","161688","1.011149000","231.9935","207134.80","5575.61"
"41.177.117.186","210.218.218.164","172","11352","172","11352","0","0","1.013278000","231.4165","392.44","N/A"
"41.177.202.199","210.218.218.164","95","6252","95","6252","0","0","1.024243000","232.7040","214.93","N/A"
"41.177.3.203","41.177.202.202","54","7852","27","2246","27","5606","1.034029000","226.5585","79.31","197.95"
"41.177.3.203","41.177.230.224","44","19257","23","17452","21","1805","1.036590000","103.1967","1352.91","139.93"
"41.177.117.41","210.218.218.164","285","18762","285","18762","0","0","1.056240000","232.4161","645.81","N/A"
"41.177.98.98","41.177.202.202","206","29292","103","9194","103","20098","1.083321000","227.4049","323.44","707.04"
"41.177.3.224","41.177.202.202","26","4100","13","1120","13","2980","1.083471000","209.4697","42.77","113.81"
"41.177.3.224","41.177.230.224","97","72276","58","69315","39","2961","1.086530000","100.6056","5511.82","235.45"
"41.177.155.41","210.218.218.164","285","18762","285","18762","0","0","1.088242000","233.0602","644.02","N/A"
"41.177.241.46","244.3.77.239","85","8215","43","4097","42","4118","1.089987000","228.6748","143.33","144.06"
"41.177.204.41","210.218.218.164","174","11484","174","11484","0","0","1.093249000","232.8087","394.62","N/A"
"210.218.218.164","244.3.210.192","174","11484","0","0","174","11484","1.093306000","231.2245","N/A","397.33"
"41.177.241.31","41.177.241.176","249","38556","249","38556","0","0","1.094293000","231.0023","1335.26","N/A"
"41.177.26.193","244.3.160.248","17515","16040641","10650","13864528","6865","2176113","1.096138000","233.3423","475337.01","74606.73"
"41.177.46.164","210.218.218.164","190","12508","190","12508","0","0","1.104230000","231.0881","433.01","N/A"
"41.177.3.203","41.177.230.68","7","1280","4","646","3","634","1.107926000","0.1157","44649.88","43820.47"
"41.177.24.249","210.218.218.164","258","17028","258","17028","0","0","1.109256000","232.6646","585.50","N/A"
"41.177.108.186","210.218.218.164","174","11484","174","11484","0","0","1.109320000","232.9365","394.41","N/A"
"41.177.143.128","210.218.218.213","132","19008","132","19008","0","0","1.119908000","230.3143","660.25","N/A"
"210.218.218.164","244.3.210.41","190","12504","0","0","190","12504","1.120240000","230.5801","N/A","433.83"
"41.177.108.177","210.218.218.75","52","5184","52","5184","0","0","1.137968000","230.0034","180.31","N/A"
"41.177.155.186","210.218.218.164","258","17028","258","17028","0","0","1.141328000","231.5605","588.29","N/A"
"246.142.244.177","246.142.244.198","262","16768","131","8384","131","8384","1.146178000","232.0733","289.01","289.01"
"41.177.230.192","210.218.218.164","344","22704","344","22704","0","0","1.157242000","233.1767","778.95","N/A"
"210.218.218.164","244.3.153.192","172","11352","0","0","172","11352","1.157301000","231.5925","N/A","392.14"
"210.218.218.164","244.3.176.15","86","5676","0","0","86","5676","1.173248000","230.8445","N/A","196.70"
"253.37.253.43","253.213.108.56","25","25092","25","25092","0","0","1.183065000","226.3181","886.96","N/A"
"210.218.218.164","244.3.210.186","174","11484","0","0","174","11484","1.189241000","232.6166","N/A","394.95"
"41.177.26.176","77.197.210.48","553","334582","332","312579","221","22003","1.209615000","67.4083","37096.82","2611.31"
"41.177.26.176","77.197.128.94","172","107197","101","100064","71","7133","1.215870000","7.9934","100147.16","7138.93"
"253.37.253.43","253.160.108.89","491","182062","491","182062","0","0","1.248019000","232.0563","6276.48","N/A"
"41.177.3.192","210.218.218.164","174","11484","174","11484","0","0","1.253249000","232.9365","394.41","N/A"
"244.3.210.230","253.23.23.108","36","2376","36","2376","0","0","1.277014000","231.8682","81.98","N/A"
"41.177.204.64","210.218.218.164","86","5676","86","5676","0","0","1.285248000","233.0965","194.80","N/A"
"210.218.218.164","244.3.41.41","190","12504","0","0","190","12504","1.312287000","232.0801","N/A","431.02"
"145.95.43.192","210.218.218.164","86","5676","86","5676","0","0","1.333243000","231.4325","196.20","N/A"
"41.177.241.192","210.218.218.164","174","11484","174","11484","0","0","1.333299000","231.3525","397.11","N/A"
"145.95.41.192","210.218.218.164","86","5676","86","5676","0","0","1.349240000","230.5845","196.93","N/A"
"41.177.72.186","210.218.218.164","174","11484","174","11484","0","0","1.365321000","231.2245","397.33","N/A"
"210.218.218.164","244.3.31.192","170","11220","0","0","170","11220","1.365364000","232.2647","N/A","386.46"
"41.177.98.77","244.3.202.202","6","608","4","424","2","184","1.366337000","30.0008","113.06","49.07"
"41.177.98.77","41.177.202.202","26","3442","14","1374","12","2068","1.366731000","51.5267","213.33","321.08"
"41.177.202.57","210.218.218.75","49","5194","49","5194","0","0","1.377290000","228.9568","181.48","N/A"
"15.128.184.13","41.177.26.176","110","62000","42","5700","68","56300","1.386606000","232.6236","196.02","1936.17"
"41.177.108.68","210.218.218.164","186","12244","186","12244","0","0","1.392267000","230.4801","424.99","N/A"
"41.177.75.46","210.218.218.75","51","21486","51","21486","0","0","1.419811000","230.0098","747.31","N/A"
"41.177.106.41","210.218.218.164","172","11352","172","11352","0","0","1.429428000","230.5212","393.96","N/A"
"41.177.26.141","244.3.160.248","80","22042","41","17114","39","4928","1.431608000","225.9243","606.01","174.50"
"145.95.225.41","210.218.218.164","96","6318","96","6318","0","0","1.456288000","232.2561","217.62","N/A"
"41.177.180.186","210.218.218.164","86","5676","86","5676","0","0","1.461246000","232.6645","195.17","N/A"
"41.177.26.55","244.3.160.248","1919","1016139","1033","871661","886","144478","1.480974000","232.7474","29960.75","4966.00"
"41.177.26.214","41.177.202.202","2226","317862","1113","105789","1113","212073","1.487340000","232.7843","3635.61","7288.22"
"41.177.98.176","145.95.67.26","353","277541","217","241705","136","35836","1.502883000","36.6999","52687.87","7811.68"
"246.142.244.48","246.142.244.177","262","16768","131","8384","131","8384","1.506186000","232.1432","288.93","288.93"
"41.177.116.204","210.218.218.164","95","6252","95","6252","0","0","1.536236000","230.9440","216.57","N/A"
"145.95.41.41","210.218.218.164","95","6254","95","6254","0","0","1.536293000","231.9840","215.67","N/A"
"210.218.218.164","244.3.141.213","172","11352","0","0","172","11352","1.541267000","230.7766","N/A","393.52"
"41.177.98.43","244.3.164.39","6","564","3","282","3","282","1.544177000","192.0031","11.75","11.75"
"41.177.230.164","210.218.218.164","376","24744","376","24744","0","0","1.584230000","231.1202","856.49","N/A"
"41.177.202.192","210.218.218.164","86","5676","86","5676","0","0","1.605589000","231.0642","196.52","N/A"
"41.177.106.121","210.218.218.197","8","608","8","608","0","0","1.629628000","206.2642","23.58","N/A"
"210.218.218.164","253.244.77.186","172","11352","0","0","172","11352","1.637258000","231.3366","N/A","392.57"
"41.177.26.205","244.3.41.252","12","1096","4","408","8","688","1.659557000","179.4514","18.19","30.67"
"210.218.218.164","244.3.61.15","172","11352","0","0","172","11352","1.669247000","230.8726","N/A","393.36"
"68.33.110.176","244.3.160.239","4206","3226377","1100","158015","3106","3068362","1.697794000","229.6630","5504.24","106882.23"
"244.3.31.75","244.3.160.239","6296","4432369","3635","4070036","2661","362333","1.709385000","229.6538","141779.89","12621.89"
"41.106.180.77","41.177.241.46","737","134455","459","80472","278","53983","1.716062000","232.7166","2766.35","1855.75"
"41.177.117.203","244.3.153.177","138","19734","46","6394","92","13340","1.716578000","229.6908","222.70","464.62"
"210.218.218.164","244.3.47.41","192","12636","0","0","192","12636","1.728232000","231.6642","N/A","436.36"
"41.177.4.192","210.218.218.164","85","5610","85","5610","0","0","1.733106000","230.2946","194.88","N/A"
"41.177.26.176","68.157.168.139","461","178407","231","157520","230","20887","1.734335000","208.4931","6044.13","801.45"
"210.218.218.164","253.244.77.41","188","12376","0","0","188","12376","1.744224000","231.7601","N/A","427.20"
"41.177.241.46","151.77.15.248","179","32601","49","6971","130","25630","1.744551000","230.4107","242.04","889.89"
"244.3.64.12","244.3.153.117","19","2539","0","0","19","2539","1.744698000","229.1943","N/A","88.62"
"246.142.244.157","246.142.244.205","116","7424","0","0","116","7424","1.747126000","231.2326","N/A","256.85"
"244.3.64.71","244.3.153.117","18","2381","0","0","18","2381","1.748314000","229.1912","N/A","83.11"
"41.177.98.176","95.197.89.124","19","9463","10","8533","9","930","1.755335000","18.2154","3747.60","408.45"
"41.177.116.186","210.218.218.164","86","5676","86","5676","0","0","1.765265000","231.3045","196.31","N/A"
"210.218.218.164","244.3.41.186","174","11484","0","0","174","11484","1.765319000","232.1045","N/A","395.82"
"210.218.218.164","244.3.153.164","190","12504","0","0","190","12504","1.792243000","232.1324","N/A","430.93"
"210.218.218.164","244.3.176.68","95","6254","0","0","95","6254","1.808217000","232.5161","N/A","215.18"
"41.177.143.204","210.218.218.164","380","25008","380","25008","0","0","1.824221000","230.7682","866.95","N/A"
"41.177.26.176","68.157.168.209","459","173212","229","152506","230","20706","1.835569000","228.5523","5338.16","724.77"
"210.218.218.164","244.3.31.164","188","12372","0","0","188","12372","1.872245000","230.0481","N/A","430.24"
"41.177.18.186","210.218.218.164","86","5676","86","5676","0","0","1.893251000","231.3206","196.30","N/A"
"210.218.218.164","244.3.40.164","192","12636","0","0","192","12636","1.920238000","232.3242","N/A","435.12"
"210.218.218.164","244.3.41.201","95","6252","0","0","95","6252","1.920312000","230.5759","N/A","216.92"
"41.177.244.188","244.3.210.197","21","10085","10","1595","11","8490","1.950133000","91.1983","139.91","744.75"
"41.177.202.17","210.218.218.75","47","4418","47","4418","0","0","1.965827000","230.0167","153.66","N/A"
"41.177.72.41","210.218.218.164","190","12504","190","12504","0","0","1.984329000","232.4840","430.27","N/A"
"145.95.41.186","210.218.218.164","86","5676","86","5676","0","0","1.989471000","230.1717","197.28","N/A"
"41.177.117.160","210.218.218.164","170","11220","170","11220","0","0","2.005292000","229.9843","390.29","N/A"
"210.218.218.160","244.3.41.77","16","1376","0","0","16","1376","2.044376000","210.0116","N/A","52.42"
"41.177.180.204","210.218.218.164","95","6252","95","6252","0","0","2.080263000","231.2484","216.29","N/A"
"210.218.218.164","244.3.164.41","172","11352","0","0","172","11352","2.149411000","230.3604","N/A","394.23"
"210.218.218.164","253.244.230.213","86","5676","0","0","86","5676","2.149472000","229.5683","N/A","197.80"
"210.218.218.164","244.3.4.192","258","17028","0","0","258","17028","2.149520000","230.9204","N/A","589.92"
"210.218.218.160","244.3.31.22","32","2848","0","0","32","2848","2.152170000","209.9887","N/A","108.50"
"41.177.26.91","244.3.160.248","34","5108","17","3139","17","1969","2.172089000","221.1345","113.56","71.23"
"41.177.4.164","210.218.218.164","95","6252","95","6252","0","0","2.176785000","231.8462","215.73","N/A"
"210.218.218.164","244.3.4.164","285","18756","0","0","285","18756","2.208286000","230.8161","N/A","650.08"
"210.218.218.164","244.3.39.186","172","11352","0","0","172","11352","2.213251000","230.7126","N/A","393.63"
"41.177.241.67","210.218.218.164","86","5676","86","5676","0","0","2.229244000","232.0885","195.65","N/A"
"41.177.204.57","210.218.218.164","94","6188","94","6188","0","0","2.272239000","230.9440","214.35","N/A"
"210.218.218.164","253.244.230.201","96","6318","0","0","96","6318","2.272296000","231.4240","N/A","218.40"
"210.218.218.164","244.3.164.209","190","12504","0","0","190","12504","2.304242000","229.9041","N/A","435.10"
"68.157.168.82","244.3.210.197","306","201979","150","13862","156","188117","2.304785000","208.2866","532.42","7225.31"
"41.177.83.194","210.218.218.164","261","17226","261","17226","0","0","2.373256000","231.9767","594.06","N/A"
"210.218.218.164","244.3.251.164","85","5610","0","0","85","5610","2.389243000","230.8886","N/A","194.38"
"145.95.225.186","210.218.218.164","86","5676","86","5676","0","0","2.405239000","230.8727","196.68","N/A"
"41.177.31.164","210.218.218.164","190","12504","190","12504","0","0","2.416238000","229.4881","435.89","N/A"
"41.177.98.164","210.218.218.164","190","12504","190","12504","0","0","2.416309000","230.9280","433.17","N/A"
"41.177.24.241","244.3.153.197","36","6314","14","3666","22","2648","2.423617000","209.7873","139.80","100.98"
"41.177.24.188","210.218.218.164","285","18762","285","18762","0","0","2.464241000","231.0402","649.65","N/A"
"41.177.108.15","210.218.218.164","172","11352","172","11352","0","0","2.469287000","231.9765","391.49","N/A"
"244.3.164.157","244.3.164.161","12","1152","12","1152","0","0","2.475729000","1.5179","6071.37","N/A"
"41.177.117.138","210.218.218.164","190","12504","190","12504","0","0","2.496223000","230.8961","433.23","N/A"
"41.177.83.214","210.218.218.164","282","18564","282","18564","0","0","2.528222000","230.0962","645.43","N/A"
"46.100.160.135","244.3.61.18","1","66","1","66","0","0","2.586195000","0.0000","N/A","N/A"
"41.177.204.57","210.218.218.197","8","608","8","608","0","0","2.596416000","206.3042","23.58","N/A"
"41.177.241.46","41.177.241.154","94","11844","47","5922","47","5922","2.602276000","230.2929","205.72","205.72"
"244.3.153.116","244.3.153.255","94","11844","47","5922","47","5922","2.602464000","230.2929","205.72","205.72"
"41.177.26.164","210.218.218.164","188","12376","188","12376","0","0","2.608223000","229.2961","431.79","N/A"
"210.218.218.164","244.3.39.41","188","12376","0","0","188","12376","2.608287000","231.0241","N/A","428.56"
"41.177.98.176","254.204.205.197","226","167006","133","153352","93","13654","2.635193000","142.4483","8612.36","766.82"
"210.218.218.164","244.3.164.164","94","6188","0","0","94","6188","2.640233000","231.6360","N/A","213.71"
"41.177.24.241","244.3.153.25","16","1484","7","516","9","968","2.661192000","220.0933","18.76","35.19"
"15.186.110.41","244.3.210.197","287","182306","139","14643","148","167663","2.683910000","212.6617","550.85","6307.22"
"18.185.55.142","244.3.31.168","4","320","2","132","2","188","2.725240000","2.9590","356.88","508.29"
"41.177.46.192","210.218.218.164","172","11352","172","11352","0","0","2.725264000","230.2645","394.40","N/A"
"41.177.143.181","210.218.218.213","96","13824","96","13824","0","0","2.732277000","222.9458","496.05","N/A"
"41.177.241.181","210.218.218.164","96","6318","96","6318","0","0","2.752243000","230.7360","219.06","N/A"
"41.177.26.209","244.3.160.248","704","159336","0","0","704","159336","2.799654000","227.6739","N/A","5598.74"
"41.177.244.192","210.218.218.164","86","5676","86","5676","0","0","2.805283000","231.5446","196.11","N/A"
"210.218.218.164","244.3.41.213","85","5610","0","0","85","5610","2.805347000","230.5684","N/A","194.65"
"47.167.26.197","244.3.41.84","10","4312","6","396","4","3916","2.805402000","23.4029","135.37","1338.64"
"41.108.167.85","244.3.210.197","4","256","4","256","0","0","2.857324000","17.2443","118.76","N/A"
"253.37.253.43","253.160.108.177","55","5483","55","5483","0","0","2.872614000","230.0003","190.71","N/A"
"67.122.211.41","244.3.153.255","2","132","2","132","0","0","2.888554000","3.0068","351.20","N/A"
"41.177.98.143","244.110.40.40","82","10590","41","7936","41","2654","2.891278000","146.2779","434.02","145.15"
"41.177.98.220","244.3.31.117","369","63947","166","34418","203","29529","2.921981000","226.4141","1216.11","1043.36"
"41.177.241.176","41.177.241.254","243","37380","0","0","243","37380","2.929887000","231.0068","N/A","1294.51"
"41.177.98.98","244.3.31.94","81","22657","45","7442","36","15215","2.947630000","156.4930","380.44","777.80"
"244.3.77.218","244.3.160.239","2840","1897623","1339","95780","1501","1801843","3.012422000","226.0616","3389.52","63764.67"
"41.177.108.186","210.218.218.75","52","5144","52","5144","0","0","3.017365000","226.7925","181.45","N/A"
"41.177.98.71","244.3.160.248","55","3826","25","1871","30","1955","3.028636000","154.8353","96.67","101.01"
"41.177.202.199","210.218.218.75","49","5194","49","5194","0","0","3.032317000","228.5280","181.82","N/A"
"15.186.110.132","41.177.26.91","1037","680572","501","52149","536","628423","3.091876000","222.2268","1877.33","22622.76"
"90.218.72.197","244.3.160.239","194","81692","79","12346","115","69346","3.101245000","89.1539","1107.84","6222.59"
"145.95.41.186","210.218.218.197","8","608","8","608","0","0","3.117413000","207.4165","23.45","N/A"
"253.37.253.43","253.160.108.225","764","81114","764","81114","0","0","3.122640000","230.5527","2814.59","N/A"
"41.177.26.176","68.157.168.160","164","67032","81","59367","83","7665","3.157604000","89.2330","5322.43","687.19"
"41.177.202.192","210.218.218.197","8","608","8","608","0","0","3.173465000","207.4576","23.45","N/A"
"210.218.218.160","244.3.47.41","8","512","0","0","8","512","3.176383000","180.1197","N/A","22.74"
"41.177.204.209","210.218.218.160","8","512","8","512","0","0","3.176552000","180.1196","22.74","N/A"
"145.95.41.164","210.218.218.160","4","256","4","256","0","0","3.176666000","180.1193","11.37","N/A"
"145.95.41.41","210.218.218.160","4","256","4","256","0","0","3.176731000","180.1195","11.37","N/A"
"210.218.218.160","244.3.164.209","8","512","0","0","8","512","3.177963000","180.1196","N/A","22.74"
"41.177.75.118","210.218.218.160","4","256","4","256","0","0","3.178826000","180.1196","11.37","N/A"
"210.218.218.160","244.3.39.41","8","512","0","0","8","512","3.179001000","180.1206","N/A","22.74"
"41.177.31.41","210.218.218.160","8","512","8","512","0","0","3.179234000","180.1206","22.74","N/A"
"210.218.218.160","253.244.77.41","8","512","0","0","8","512","3.179415000","180.1206","N/A","22.74"
"41.177.26.164","210.218.218.160","8","512","8","512","0","0","3.179527000","180.1205","22.74","N/A"
"145.95.225.41","210.218.218.160","4","256","4","256","0","0","3.179591000","180.1197","11.37","N/A"
"41.177.202.164","210.218.218.160","4","256","4","256","0","0","3.179969000","180.1195","11.37","N/A"
"41.177.202.199","210.218.218.160","4","256","4","256","0","0","3.180036000","180.1195","11.37","N/A"
"210.218.218.160","244.3.164.164","4","256","0","0","4","256","3.180110000","180.1196","N/A","11.37"
"41.177.106.209","210.218.218.160","8","512","8","512","0","0","3.180265000","180.1200","22.74","N/A"
"210.218.218.160","244.3.31.164","8","512","0","0","8","512","3.180526000","180.1198","N/A","22.74"
"210.218.218.197","253.244.77.41","8","608","0","0","8","608","3.186762000","207.2339","N/A","23.47"
"48.151.224.205","244.3.160.239","325","186501","173","163141","152","23360","3.266753000","130.0210","10037.82","1437.31"
"210.218.218.3","244.3.164.128","4","256","0","0","4","256","3.288156000","60.2643","N/A","33.98"
"41.177.241.46","151.77.15.90","113","14443","36","3167","77","11276","3.327555000","226.4074","111.90","398.43"
"168.91.64.164","244.3.210.255","176","87465","75","7608","101","79857","3.352193000","226.1865","269.09","2824.47"
"68.157.168.41","244.3.160.239","20","2938","10","1112","10","1826","3.380539000","152.2452","58.43","95.95"
"118.16.167.139","244.3.210.197","20","2169","14","1389","6","780","3.460606000","2.8226","3936.73","2210.69"
"41.177.98.141","177.139.224.48","2","243","1","130","1","113","3.468096000","0.0012","N/A","N/A"
"210.218.218.197","253.244.77.186","8","608","0","0","8","608","3.477404000","205.9212","N/A","23.62"
"41.177.26.91","68.157.168.38","560","324538","275","299537","285","25001","3.537901000","226.8408","10563.78","881.71"
"244.3.31.251","244.3.153.48","30","3420","0","0","30","3420","3.548371000","150.0003","N/A","182.40"
"41.177.3.203","41.177.3.224","743","378693","422","207760","321","170933","3.556787000","230.4140","7213.45","5934.81"
"41.177.98.220","244.3.142.22","364","263297","208","249271","156","14026","3.561020000","182.5799","10922.17","614.57"
"41.177.98.220","244.3.79.121","4","1916","2","1720","2","196","3.640634000","0.0217","633955.31","72241.42"
"253.37.253.43","253.180.108.127","157","49599","157","49599","0","0","3.669205000","192.8130","2057.91","N/A"
"41.177.241.46","151.77.15.13","115","15999","33","3334","82","12665","3.675387000","223.1716","119.51","454.00"
"210.218.218.197","244.3.31.192","16","1216","0","0","16","1216","3.793423000","207.9677","N/A","46.78"
"41.177.26.91","77.197.106.128","45","40758","28","39352","17","1406","3.830890000","1.0965","287115.39","10258.29"
"15.225.3.77","244.3.210.197","44","26009","20","2394","24","23615","3.888272000","131.3941","145.76","1437.81"
"41.177.26.209","41.177.98.121","138","26714","0","0","138","26714","3.959536000","221.6115","N/A","964.35"
"68.188.168.202","244.3.210.197","16","1120","8","560","8","560","3.969896000","55.8152","80.26","80.26"
"203.22.116.24","244.3.41.84","10","2956","6","554","4","2402","3.974039000","16.3040","271.84","1178.61"
"41.177.106.217","210.218.218.164","6","384","6","384","0","0","3.974630000","180.0089","17.07","N/A"
"40.193.255.164","244.3.210.197","14","7891","7","943","7","6948","3.978747000","0.0411","183516.59","1352145.57"
"41.177.176.156","244.3.160.239","1829","895765","765","144172","1064","751593","4.004497000","222.2175","5190.30","27057.93"
"41.177.31.57","41.177.31.176","96","34346","96","34346","0","0","4.059951000","229.9998","1194.64","N/A"
"41.177.204.64","210.218.218.197","8","608","8","608","0","0","4.071318000","207.1305","23.48","N/A"
"41.177.26.214","244.3.64.176","310","39332","113","21510","197","17822","4.109996000","111.4715","1543.71","1279.04"
"241.141.156.123","244.3.210.197","1","64","1","64","0","0","4.121345000","0.0000","N/A","N/A"
"253.37.253.43","253.98.108.71","1","64","1","64","0","0","4.157550000","0.0000","N/A","N/A"
"41.177.98.220","244.3.79.4","42","6972","20","4248","22","2724","4.193379000","14.1970","2393.75","1534.98"
"41.177.75.18","210.218.218.75","51","21486","51","21486","0","0","4.199344000","230.0099","747.31","N/A"
"41.177.26.176","68.157.168.253","551","187615","280","163761","271","23854","4.202916000","230.1645","5691.96","829.11"
"244.3.31.244","244.3.139.251","2620","525160","965","299350","1655","225810","4.242077000","61.8186","38739.17","29222.29"
"41.177.202.202","244.3.31.46","1976","301706","988","211369","988","90337","4.250333000","215.5589","7844.50","3352.66"
"41.177.4.164","210.218.218.197","8","608","8","608","0","0","4.273156000","206.3100","23.58","N/A"
"244.3.31.24","244.3.31.91","2","244","2","244","0","0","4.375846000","0.0001","36148148.15","N/A"
"68.83.160.23","244.3.210.230","36","2340","18","1152","18","1188","4.415806000","155.0874","59.42","61.28"
"41.177.93.203","244.3.41.84","48","25864","20","2262","28","23602","4.475289000","199.1743","90.86","947.99"
"41.177.24.108","244.3.153.77","10","980","5","320","5","660","4.521248000","220.0572","11.63","23.99"
"120.111.16.47","244.3.61.225","2","132","2","132","0","0","4.525565000","2.8556","369.80","N/A"
"244.3.153.67","244.3.202.202","74","9472","37","3298","37","6174","4.538808000","77.3393","341.15","638.64"
"244.3.4.181","244.3.41.91","3","288","3","288","0","0","4.548913000","0.0005","4871035.94","N/A"
"41.177.26.176","215.43.45.145","136","56066","77","39416","59","16650","4.558990000","100.2640","3144.98","1328.49"
"41.177.98.220","244.3.79.176","1406","472085","657","267394","749","204691","4.668582000","214.5282","9971.42","7633.16"
"41.177.3.224","244.3.34.165","46","4462","23","1472","23","2990","4.696294000","220.1342","53.49","108.66"
"41.177.98.176","244.3.180.219","29","15347","17","13298","12","2049","4.773870000","19.7897","5375.74","828.31"
"244.3.153.22","244.3.202.202","50","10507","25","2038","25","8469","4.808129000","38.9261","418.84","1740.53"
"253.37.253.43","253.201.253.26","12","10460","12","10460","0","0","4.828263000","106.2006","787.94","N/A"
"41.177.3.81","145.95.48.2","46","5723","23","2827","23","2896","4.867399000","195.9270","115.43","118.25"
"41.177.202.113","210.218.218.75","50","4580","50","4580","0","0","4.880975000","225.0081","162.84","N/A"
"210.218.218.213","244.3.160.4","93","13392","0","0","93","13392","4.882188000","227.7327","N/A","470.45"
"41.177.230.130","244.3.153.209","18","1728","0","0","18","1728","4.898466000","202.2489","N/A","68.35"
"210.218.218.230","244.3.47.117","8","512","0","0","8","512","5.021468000","178.3168","N/A","22.97"
"41.177.71.18","244.3.41.84","11","2220","6","406","5","1814","5.208415000","24.1084","134.73","601.95"
"41.177.98.220","41.177.211.160","128","30892","58","20823","70","10069","5.254938000","164.0058","1015.72","491.15"
"145.95.41.192","210.218.218.197","8","608","8","608","0","0","5.325369000","207.2404","23.47","N/A"
"242.161.82.241","244.3.210.197","644","508632","261","28493","383","480139","5.431255000","206.5359","1103.65","18597.80"
"41.177.98.220","41.177.168.251","50","15175","23","8691","27","6484","5.437749000","218.2011","318.64","237.73"
"41.177.26.176","204.22.67.156","2","140","1","70","1","70","5.459100000","0.0003","N/A","N/A"
"145.95.48.22","210.218.218.75","116","43320","116","43320","0","0","5.493323000","227.6725","1522.19","N/A"
"41.177.24.241","244.3.153.13","12","1512","6","788","6","724","5.566691000","220.0719","28.65","26.32"
"41.177.244.177","244.3.210.90","72","5644","36","2872","36","2772","5.620335000","215.1431","106.79","103.08"
"41.177.244.142","244.3.210.90","78","6273","39","3129","39","3144","5.620364000","210.0125","119.19","119.76"
"41.177.26.176","177.149.224.75","107","45725","61","39020","46","6705","5.664357000","70.4373","4431.74","761.53"
"41.177.46.91","41.177.46.252","2","494","0","0","2","494","5.678452000","0.0001","N/A","26346666.67"
"41.177.26.176","252.77.177.67","193","100929","112","86943","81","13986","5.694237000","224.9887","3091.46","497.30"
"41.177.26.176","165.160.217.193","4","5032","4","5032","0","0","5.734425000","179.9998","223.64","N/A"
"210.218.218.164","246.142.47.253","2","128","0","0","2","128","5.743934000","0.0002","N/A","6606451.61"
"41.177.3.20","41.177.3.91","116","12182","116","12182","0","0","5.832517000","225.7463","431.71","N/A"
"253.37.253.43","253.116.23.165","33","23013","33","23013","0","0","5.874253000","170.4123","1080.34","N/A"
"71.138.110.40","244.3.210.197","390","272621","181","59475","209","213146","5.932982000","87.4408","5441.39","19500.82"
"41.177.241.46","90.48.117.203","715","272476","357","204274","358","68202","5.933240000","224.9913","7263.36","2425.05"
"90.38.138.255","244.3.160.239","404","267359","118","14822","286","252537","6.023386000","223.0919","531.51","9055.89"
"253.37.253.43","253.160.108.145","101","13246","101","13246","0","0","6.039182000","219.3021","483.21","N/A"
"41.177.106.77","210.218.218.197","16","1216","16","1216","0","0","6.109490000","212.9204","45.69","N/A"
"41.177.98.127","142.197.48.208","56","4676","28","2192","28","2484","6.129486000","98.1279","178.71","202.51"
"41.177.31.192","210.218.218.197","16","1216","16","1216","0","0","6.141913000","206.8840","47.02","N/A"
"244.3.41.84","244.3.247.116","14","6502","6","5734","8","768","6.219558000","47.4692","966.35","129.43"
"41.177.26.15","177.149.224.75","229","180538","147","173606","82","6932","6.224287000","54.3675","25545.54","1020.02"
"41.177.66.219","41.177.98.176","8","7240","0","0","8","7240","6.333923000","214.5423","N/A","269.97"
"41.177.26.176","106.217.244.253","2225","1701456","1373","1577395","852","124061","6.380141000","212.5904","59359.04","4668.55"
"41.177.31.98","244.3.153.142","46","4462","23","1472","23","2990","6.449515000","220.1413","53.49","108.66"
"41.177.3.184","41.177.3.224","61","7172","30","3494","31","3678","6.534247000","226.6674","123.32","129.81"
"41.177.3.184","41.177.3.203","61","7172","30","3494","31","3678","6.534252000","226.6674","123.32","129.81"
"244.3.48.41","244.3.160.239","30","6412","15","3990","15","2422","6.577495000","17.7817","1795.11","1089.66"
"43.106.84.108","244.3.160.239","30","6217","12","2407","18","3810","6.583748000","17.8069","1081.38","1711.70"
"41.177.241.46","151.77.15.40","184","37035","68","13943","116","23092","6.630262000","218.7041","510.02","844.68"
"41.177.98.127","151.41.242.13","49","6061","23","3971","26","2090","6.676965000","157.3404","201.91","106.27"
"210.218.218.3","244.3.164.55","4","544","0","0","4","544","6.721474000","179.8926","N/A","24.19"
"41.177.26.176","208.51.205.98","208","110137","121","97799","87","12338","6.784854000","213.7400","3660.48","461.79"
"41.177.93.64","244.3.41.84","176","86454","88","10559","88","75895","6.795338000","224.6828","375.96","2702.30"
"41.177.3.203","244.3.31.68","86","12436","42","6325","44","6111","6.797117000","180.5531","280.25","270.77"
"41.177.26.176","61.194.168.142","30","15551","18","13504","12","2047","6.804563000","30.0299","3597.48","545.32"
"41.177.98.192","210.218.218.197","14","1064","14","1064","0","0","6.841403000","206.5864","41.20","N/A"
"244.3.153.91","244.3.153.95","3","741","0","0","3","741","6.857279000","0.0001","N/A","41454545.45"
"41.177.4.139","244.3.41.84","675","194033","344","96277","331","97756","6.893368000","223.4047","3447.63","3500.59"
"244.3.153.91","244.3.153.108","12","1605","0","0","12","1605","6.930854000","29.3843","N/A","436.97"
"244.3.41.84","244.3.141.84","25","2330","12","1132","13","1198","6.963820000","180.4619","50.18","53.11"
"41.177.3.241","210.218.218.3","28","2240","28","2240","0","0","6.992839000","220.5598","81.25","N/A"
"244.3.31.84","244.3.41.84","24","2260","12","1128","12","1132","6.998674000","195.3308","46.20","46.36"
"244.3.124.145","244.3.153.142","46","4462","23","1472","23","2990","7.007545000","220.0167","53.52","108.72"
"41.177.241.98","41.177.241.176","198","45333","198","45333","0","0","7.099363000","221.1132","1640.17","N/A"
"41.177.26.176","68.157.168.121","329","129574","163","114388","166","15186","7.171581000","226.7918","4035.00","535.68"
"41.177.241.98","246.142.218.160","44","12804","44","12804","0","0","7.201656000","221.0108","463.47","N/A"
"244.3.124.153","244.3.153.142","46","4462","23","1472","23","2990","7.247756000","220.0165","53.52","108.72"
"41.177.31.41","210.218.218.197","8","608","8","608","0","0","7.432556000","206.2932","23.58","N/A"
"68.157.168.254","244.3.210.197","167","109371","73","8087","94","101284","7.454968000","177.9215","363.62","4554.10"
"90.210.201.231","244.3.160.239","21","5814","0","0","21","5814","7.544479000","179.9979","N/A","258.40"
"244.3.39.242","244.3.153.117","18","2381","0","0","18","2381","7.828493000","213.8692","N/A","89.06"
"41.177.3.103","91.91.91.91","8","4752","8","4752","0","0","7.976157000","183.6653","206.99","N/A"
"41.177.3.192","91.91.91.91","8","2768","8","2768","0","0","7.978358000","183.6647","120.57","N/A"
"41.177.202.57","210.218.218.197","8","608","8","608","0","0","7.989355000","206.0086","23.61","N/A"
"15.71.149.241","41.177.26.15","4181","5105362","646","47162","3535","5058200","8.029973000","25.8120","14617.06","1567703.18"
"41.177.31.186","210.218.218.197","8","608","8","608","0","0","8.081379000","207.1124","23.48","N/A"
"41.177.241.46","151.77.15.118","200","46555","76","18218","124","28337","8.083867000","225.5906","646.06","1004.90"
"168.223.67.89","244.3.210.197","425","242678","237","64004","188","178674","8.120821000","74.0917","6910.79","19292.21"
"210.218.218.197","244.3.164.41","16","1216","0","0","16","1216","8.221850000","207.6322","N/A","46.85"
"210.218.218.3","244.3.164.193","5","349","0","0","5","349","8.286924000","179.1791","N/A","15.58"
"151.77.192.83","244.3.160.239","3389","3115050","1177","89273","2212","3025777","8.384680000","130.4413","5475.14","185571.74"
"41.177.98.127","77.161.130.31","28","2344","14","1072","14","1272","8.454175000","120.5348","71.15","84.42"
"41.177.26.192","210.218.218.197","16","1216","16","1216","0","0","8.529400000","207.0846","46.98","N/A"
"41.177.3.145","244.3.153.197","102","23528","42","8657","60","14871","8.581858000","225.0025","307.80","528.74"
"41.177.75.141","210.218.218.75","115","43222","115","43222","0","0","8.681594000","219.0859","1578.27","N/A"
"41.177.98.92","244.3.90.4","8212","7378863","5229","7138908","2983","239955","8.766078000","220.5568","258941.33","8703.61"
"41.177.98.176","186.181.210.108","2","128","1","64","1","64","8.788062000","0.0001","N/A","N/A"
"41.177.26.176","77.197.128.251","887","562021","520","526396","367","35625","8.999970000","88.3628","47657.68","3225.34"
"41.177.13.249","244.3.41.84","35","17025","20","1407","15","15618","9.043239000","225.1814","49.99","554.86"
"210.218.218.197","244.3.164.164","8","608","0","0","8","608","9.099142000","206.2135","N/A","23.59"
"244.3.31.108","244.3.160.239","966","467051","527","364904","439","102147","9.099535000","193.3039","15101.77","4227.42"
"41.177.26.176","77.197.128.167","643","388848","385","363394","258","25454","9.188004000","28.5413","101857.79","7134.65"
"41.177.3.241","210.218.218.160","16","1392","16","1392","0","0","9.211983000","210.0063","53.03","N/A"
"41.177.98.220","41.177.168.68","203","33776","103","21154","100","12622","9.213905000","211.0175","801.98","478.52"
"41.177.98.220","244.3.79.224","880","263357","490","217455","390","45902","9.292590000","222.0830","7833.29","1653.51"
"67.122.211.41","244.3.47.102","1","66","1","66","0","0","9.360826000","0.0000","N/A","N/A"
"41.177.98.220","244.3.185.188","104","19807","44","12897","60","6910","9.362081000","218.5484","472.10","252.94"
"41.177.26.176","77.197.217.224","1069","655208","642","611475","427","43733","9.380295000","89.6845","54544.56","3901.05"
"244.3.153.91","244.3.153.209","90","8640","0","0","90","8640","9.407284000","200.7467","N/A","344.31"
"67.122.211.41","244.3.47.181","1","66","1","66","0","0","9.422351000","0.0000","N/A","N/A"
"244.3.84.23","244.3.210.197","61","46714","28","3809","33","42905","9.446784000","0.0567","537311.33","6052334.60"
"41.177.31.94","210.218.218.3","12","768","12","768","0","0","9.464795000","178.7567","34.37","N/A"
"68.83.160.23","244.3.210.255","48","3120","24","1536","24","1584","9.465282000","146.0004","84.16","86.79"
"41.177.26.46","83.155.208.75","8","512","4","256","4","256","9.482322000","122.0002","16.79","16.79"
"41.177.24.241","244.3.153.111","23","2194","11","1074","12","1120","9.526783000","193.1985","44.47","46.38"
"68.83.168.127","244.3.210.197","944","785931","372","70439","572","715492","9.547326000","138.9026","4056.88","41208.26"
"210.218.218.3","244.3.164.164","4","544","0","0","4","544","9.588487000","180.0460","N/A","24.17"
"253.37.253.43","253.116.23.22","26","7767","26","7767","0","0","9.671484000","165.6585","375.08","N/A"
"41.177.26.176","244.150.152.117","2","128","1","64","1","64","9.673507000","0.0002","N/A","N/A"
"67.122.211.41","244.3.47.242","2","132","2","132","0","0","9.686658000","2.9506","357.89","N/A"
"41.177.24.241","244.3.153.67","36","6216","18","2416","18","3800","9.811482000","170.1530","113.59","178.66"
"41.177.26.176","77.197.128.139","872","521038","516","485866","356","35172","9.855761000","89.3237","43515.08","3150.07"
"41.177.26.176","77.197.128.12","575","347484","341","323945","234","23539","9.867362000","29.4521","87992.22","6393.83"
"41.177.26.91","203.68.117.241","6","384","5","320","1","64","9.876327000","180.0324","14.22","N/A"
"41.177.93.84","244.3.41.84","26","11833","12","964","14","10869","9.909858000","174.3085","44.24","498.84"
"41.177.202.249","244.3.153.156","39","4372","16","2015","23","2357","9.920336000","212.7559","75.77","88.63"
"41.177.202.0","244.3.153.156","30","3194","11","1371","19","1823","9.920399000","212.9264","51.51","68.49"
"244.3.3.72","244.3.41.84","10","4028","4","264","6","3764","10.020280000","3.2683","646.20","9213.24"
"41.177.26.176","77.197.217.20","1162","708726","695","661526","467","47200","10.021813000","86.9341","60876.06","4343.52"
"41.177.26.15","208.51.205.98","715","641241","450","620078","265","21163","10.039514000","212.8398","23306.84","795.45"
"41.177.26.15","77.197.210.202","226","216373","150","211097","76","5276","10.063254000","1.6698","1011361.21","25277.20"
"41.177.26.91","77.197.210.231","122","100415","75","95970","47","4445","10.206128000","130.9111","5864.74","271.63"
"41.177.98.220","244.3.185.141","5","1724","2","1383","3","341","10.284372000","0.3051","36259.36","8940.31"
"41.177.26.15","77.197.210.108","389","357877","255","347907","134","9970","10.308290000","12.3520","225329.15","6457.28"
"41.177.230.40","91.91.91.91","4","988","4","988","0","0","10.313084000","0.0003","30754863.81","N/A"
"41.177.26.176","77.197.128.176","382","234011","225","218302","157","15709","10.340966000","27.5188","63462.58","4566.76"
"41.177.26.15","77.197.210.123","36","24426","21","22776","15","1650","10.355638000","122.6264","1485.88","107.64"
"41.177.98.121","244.157.13.98","8","752","4","376","4","376","10.498577000","175.0021","17.19","17.19"
"41.177.244.220","244.3.210.254","12","804","6","402","6","402","10.558545000","200.4369","16.04","16.04"
"41.177.106.143","210.218.218.197","8","608","8","608","0","0","10.581393000","207.3147","23.46","N/A"
"41.177.26.91","77.197.210.123","21","17512","13","16694","8","818","10.641623000","0.4501","296695.19","14537.96"
"244.3.34.194","244.3.160.254","138","14521","88","7996","50","6525","10.685075000","126.6685","505.00","412.10"
"41.177.98.220","244.3.79.181","193","67546","88","56219","105","11327","10.803434000","220.0229","2044.11","411.85"
"41.177.26.91","77.197.210.247","22","17263","13","16381","9","882","10.833193000","0.4475","292813.94","15765.94"
"67.122.211.41","244.3.47.210","1","66","1","66","0","0","10.888246000","0.0000","N/A","N/A"
"41.177.230.142","91.91.91.91","12","3320","12","3320","0","0","10.904377000","119.9981","221.34","N/A"
"244.3.160.239","244.3.241.204","204","123321","127","115896","77","7425","10.924426000","210.1466","4412.01","282.66"
"67.122.211.41","244.3.47.17","1","66","1","66","0","0","10.925352000","0.0000","N/A","N/A"
"67.122.211.41","244.3.47.113","1","66","1","66","0","0","10.935741000","0.0000","N/A","N/A"
"67.122.211.41","244.3.47.93","1","66","1","66","0","0","10.948843000","0.0000","N/A","N/A"
"41.177.26.15","77.197.210.81","314","334635","236","329036","78","5599","10.954963000","8.8172","298541.55","5080.09"
"67.122.211.41","244.3.47.199","1","66","1","66","0","0","10.965909000","0.0000","N/A","N/A"
"67.122.211.41","244.3.47.57","1","66","1","66","0","0","10.991952000","0.0000","N/A","N/A"
"67.122.211.41","244.3.47.45","1","66","1","66","0","0","10.997079000","0.0000","N/A","N/A"
"41.177.117.153","244.3.41.84","189","61870","95","38634","94","23236","11.019640000","222.2987","1390.35","836.21"
"41.177.26.176","68.157.168.23","146","50080","73","43525","73","6555","11.160824000","177.7382","1959.06","295.04"
"41.177.230.130","244.3.153.156","9","1026","0","0","9","1026","11.253299000","12.0000","N/A","684.00"
"145.95.41.34","145.95.81.118","16","6832","0","0","16","6832","11.324778000","210.1075","N/A","260.13"
"41.177.26.15","77.197.210.198","203","189168","134","183844","69","5324","11.345511000","103.6329","14191.94","410.99"
"41.177.26.91","77.197.217.20","25","19777","15","18832","10","945","11.348214000","0.5030","299486.33","15028.39"
"41.177.26.91","77.197.210.108","22","17135","13","16253","9","882","11.378653000","0.4632","280728.12","15234.25"
"244.3.153.13","244.3.202.202","12","1738","6","583","6","1155","11.388935000","151.0250","30.88","61.18"
"41.177.3.81","145.95.81.118","83","72989","42","33525","41","39464","11.394949000","189.5193","1415.16","1665.86"
"41.177.26.15","77.197.210.56","94","93278","66","91183","28","2095","11.402623000","1.1298","645685.64","14835.13"
"41.177.26.176","77.197.128.127","235","149589","141","140126","94","9463","11.445561000","27.3157","41038.94","2771.44"
"41.177.24.249","210.218.218.197","24","1824","24","1824","0","0","11.685469000","205.9530","70.85","N/A"
"41.177.26.46","77.197.210.186","7","919","3","355","4","564","11.722214000","0.1912","14853.01","23597.46"
"253.37.253.43","253.160.251.85","3656","5041676","3656","5041676","0","0","11.755215000","206.3584","195453.16","N/A"
"41.177.106.41","210.218.218.197","8","608","8","608","0","0","11.777585000","207.7230","23.42","N/A"
"41.177.26.39","41.177.230.224","22","2244","11","1122","11","1122","11.988141000","205.7260","43.63","43.63"
"41.177.13.164","244.3.41.84","76","39324","36","5294","40","34030","12.186521000","166.4518","254.44","1635.55"
"244.3.210.197","254.157.30.67","2","128","0","0","2","128","12.199798000","0.0014","N/A","743105.95"
"41.177.98.31","244.157.13.98","8","752","4","376","4","376","12.280649000","188.0060","16.00","16.00"
"41.177.244.128","244.3.210.254","12","804","6","402","6","402","12.408417000","203.7873","15.78","15.78"
"41.177.26.176","68.157.168.164","107","38155","53","33339","54","4816","12.483983000","157.7649","1690.57","244.21"
"210.218.218.3","244.3.31.22","8","512","0","0","8","512","12.508448000","176.4034","N/A","23.22"
"210.218.218.197","244.3.164.192","8","608","0","0","8","608","12.629530000","205.4043","N/A","23.68"
"41.177.3.203","244.3.41.252","79","16724","34","8190","45","8534","12.638478000","195.1494","335.74","349.84"
"85.224.40.142","244.3.160.239","3222","3179992","2095","3098313","1127","81679","12.919907000","125.9427","196807.83","5188.33"
"244.3.153.77","244.3.176.224","30","3402","19","1977","11","1425","12.964020000","212.9604","74.27","53.53"
"41.177.143.248","176.41.55.154","8","1152","8","1152","0","0","13.009534000","8.4994","1084.32","N/A"
"41.177.244.142","244.3.210.254","61","4716","35","2642","26","2074","13.228724000","220.2226","95.98","75.34"
"41.177.26.15","77.197.210.181","926","891685","625","870245","301","21440","13.309640000","190.4944","36546.80","900.39"
"244.3.153.108","244.3.176.224","4","256","2","128","2","128","13.380499000","120.0997","8.53","8.53"
"244.3.160.254","244.157.67.98","8","752","4","376","4","376","13.464522000","164.9986","18.23","18.23"
"41.177.98.220","244.3.185.209","216","75587","108","45557","108","30030","13.470672000","111.3345","3273.52","2157.82"
"210.218.218.197","244.3.31.164","16","1216","0","0","16","1216","13.492511000","205.5243","N/A","47.33"
"41.177.26.15","117.98.57.20","3","192","1","64","2","128","13.614336000","16.5536","N/A","61.86"
"41.177.98.197","244.3.90.209","7","466","3","199","4","267","13.632866000","0.0183","87175.56","116964.19"
"41.177.26.176","117.98.57.20","3","192","1","64","2","128","13.644177000","16.5238","N/A","61.97"
"106.37.181.3","244.3.210.197","126","73267","61","5694","65","67573","13.647284000","168.0853","271.01","3216.13"
"41.177.26.91","77.197.210.181","22","17596","13","16704","9","892","13.851449000","0.4193","318729.96","17020.30"
"41.177.93.251","244.3.41.84","75","38086","38","5004","37","33082","13.874328000","213.8882","187.16","1237.36"
"253.37.253.43","253.127.160.213","17","7969","17","7969","0","0","13.945211000","12.6396","5043.81","N/A"
"41.43.180.128","244.3.160.239","1519","987559","861","854736","658","132823","13.954100000","220.5129","31009.02","4818.69"
"168.67.39.121","244.3.210.197","384","313896","167","42691","217","271205","13.954360000","201.6032","1694.06","10761.93"
"41.177.98.176","145.95.168.155","179","111236","111","101265","68","9971","14.077004000","104.8726","7724.80","760.62"
"41.177.98.31","41.177.230.31","8","752","4","376","4","376","14.280972000","174.0039","17.29","17.29"
"41.177.26.176","198.208.198.164","117","61270","64","53786","53","7484","14.674223000","120.8015","3561.94","495.62"
"41.177.4.164","210.218.218.160","4","256","4","256","0","0","14.685805000","179.9959","11.38","N/A"
"41.177.244.141","244.3.210.254","12","804","6","402","6","402","14.724942000","200.4707","16.04","16.04"
"41.177.241.98","244.3.202.202","12","1716","6","633","6","1083","14.744557000","112.4725","45.02","77.03"
"41.177.24.241","244.3.153.56","8","784","4","256","4","528","14.772140000","165.1275","12.40","25.58"
"41.177.98.121","244.3.47.145","30","3021","15","1224","15","1797","14.873615000","195.0500","50.20","73.70"
"41.177.98.121","41.177.202.202","20","2486","10","916","10","1570","14.880168000","195.0420","37.57","64.40"
"244.3.56.90","244.3.160.239","799","550442","285","29351","514","521091","14.897171000","7.1280","32941.51","584836.09"
"177.124.75.164","244.3.160.239","3923","2840782","2317","2535209","1606","305573","14.900415000","204.2027","99321.27","11971.36"
"41.177.181.91","244.3.41.84","92","13409","61","4028","31","9381","14.984054000","92.2946","349.14","813.13"
"41.177.230.91","41.177.230.151","12","3012","0","0","12","3012","15.020308000","67.5630","N/A","356.64"
"41.177.26.176","68.157.168.51","369","144525","184","127572","185","16953","15.189838000","218.9858","4660.47","619.33"
"41.177.106.39","210.218.218.197","8","608","8","608","0","0","15.217587000","207.6970","23.42","N/A"
"41.177.181.165","244.3.41.84","45","19278","18","1737","27","17541","15.246269000","147.6292","94.13","950.54"
"90.199.135.132","244.3.210.197","6","384","0","0","6","384","15.281931000","0.0001","N/A","22588235.29"
"41.177.244.197","244.3.210.197","3","192","0","0","3","192","15.282075000","14.9999","N/A","102.40"
"41.177.75.18","41.177.98.176","62","46121","24","4850","38","41271","15.366555000","22.2553","1743.40","14835.48"
"210.218.218.160","244.3.41.186","32","2752","0","0","32","2752","15.478610000","210.0084","N/A","104.83"
"15.128.184.13","41.177.26.46","65","32788","31","4576","34","28212","15.496795000","188.3199","194.39","1198.47"
"41.177.72.186","210.218.218.197","8","608","8","608","0","0","15.613383000","207.0367","23.49","N/A"
"253.37.253.31","253.160.108.83","30","15536","17","5692","13","9844","15.863706000","23.1172","1969.79","3406.64"
"244.3.3.185","244.3.210.254","12","804","6","402","6","402","15.931146000","200.4401","16.04","16.04"
"145.95.225.186","210.218.218.197","8","608","8","608","0","0","15.985401000","208.3165","23.35","N/A"
"41.177.98.220","244.3.185.203","103","75781","64","72248","39","3533","16.016401000","197.2778","2929.80","143.27"
"41.177.98.220","244.3.79.218","23","4237","9","2644","14","1593","16.030750000","55.3513","382.14","230.24"
"244.3.31.124","244.145.124.223","4","320","2","188","2","132","16.186695000","2.9592","508.25","356.86"
"41.177.230.41","244.3.160.254","17","1583","8","999","9","584","16.396522000","0.9587","8336.39","4873.33"
"41.177.24.241","244.3.153.41","6","504","2","196","4","308","16.402633000","121.0965","12.95","20.35"
"41.177.241.254","244.3.202.202","10","1509","5","567","5","942","16.418427000","0.0089","511559.72","849892.86"
"41.177.143.71","176.252.72.186","4","576","4","576","0","0","16.424255000","0.0001","33151079.14","N/A"
"41.177.143.67","106.160.164.255","4","592","4","592","0","0","16.504686000","0.0001","33828571.43","N/A"
"253.37.253.90","253.37.253.91","1","247","1","247","0","0","16.554707000","0.0000","N/A","N/A"
"244.3.41.84","244.3.111.39","35","16133","19","12188","16","3945","16.646944000","189.6887","514.02","166.38"
"253.37.253.167","253.160.239.39","4","264","2","128","2","136","16.711848000","13.5635","75.50","80.22"
"41.177.98.143","244.239.193.77","3","298","1","140","2","158","16.781774000","0.2025","N/A","6240.96"
"145.95.41.251","145.95.48.2","8","816","4","408","4","408","16.795749000","177.8854","18.35","18.35"
"244.3.31.251","244.3.153.241","18","2052","0","0","18","2052","16.893118000","132.0018","N/A","124.36"
"41.177.98.15","66.55.217.218","1","113","0","0","1","113","17.021580000","0.0000","N/A","N/A"
"41.177.98.98","244.3.31.33","28","3190","16","1916","12","1274","17.042131000","169.6532","90.35","60.08"
"244.3.31.251","244.3.153.95","18","2052","0","0","18","2052","17.106694000","131.9997","N/A","124.36"
"244.3.31.251","244.3.153.24","3","288","0","0","3","288","17.213923000","3.0000","N/A","767.99"
"168.91.64.164","244.3.210.230","95","79098","36","2610","59","76488","17.493209000","181.1348","115.27","3378.17"
"41.177.98.220","41.177.199.31","243","39322","123","24082","120","15240","17.514318000","211.8895","909.23","575.39"
"253.37.253.43","253.160.251.79","1963","2562721","1963","2562721","0","0","17.536084000","207.8853","98620.58","N/A"
"41.177.75.141","210.218.218.197","8","608","8","608","0","0","17.990396000","207.0920","23.49","N/A"
"145.95.48.22","210.218.218.197","8","608","8","608","0","0","18.013395000","208.0565","23.38","N/A"
"41.177.202.199","210.218.218.197","8","608","8","608","0","0","18.097106000","206.8040","23.52","N/A"
"244.3.153.91","244.3.153.142","6","1500","0","0","6","1500","18.197787000","67.7161","N/A","177.21"
"210.244.26.210","253.37.253.204","1","64","0","0","1","64","18.272960000","0.0000","N/A","N/A"
"244.3.160.239","244.3.213.252","856","577701","559","543816","297","33885","18.281760000","21.1913","205297.77","12792.04"
"94.2.202.203","244.3.160.239","818","704518","510","657363","308","47155","18.284490000","148.0617","35518.33","2547.86"
"41.177.98.143","194.143.194.43","3","298","1","140","2","158","18.383663000","0.2333","N/A","5416.96"
"244.3.41.91","244.3.41.145","21","1890","0","0","21","1890","18.450476000","187.2383","N/A","80.75"
"41.177.93.67","244.3.41.84","102","47264","52","3380","50","43884","18.494724000","23.7096","1140.47","14807.18"
"176.108.82.117","244.3.160.113","3","441","0","0","3","441","18.719331000","0.0001","N/A","23837837.84"
"244.3.153.177","244.3.202.202","2","274","1","77","1","197","18.765327000","0.0010","N/A","N/A"
"253.37.253.43","253.213.108.145","46","51959","46","51959","0","0","18.793381000","188.0735","2210.16","N/A"
"244.3.31.251","244.3.153.177","12","1314","0","0","12","1314","18.914689000","49.4757","N/A","212.47"
"41.177.26.176","244.3.202.202","56","5971","28","2525","28","3446","18.944853000","57.2395","352.90","481.63"
"145.95.41.251","145.95.81.118","211","52666","94","7885","117","44781","19.146195000","194.5079","324.31","1841.82"
"253.37.253.43","253.254.77.24","44","37326","44","37326","0","0","19.161195000","205.9649","1449.80","N/A"
"41.177.26.176","77.197.128.135","20","12707","12","11882","8","825","19.229470000","0.5695","166901.36","11588.42"
"253.23.23.108","253.244.77.47","12","792","0","0","12","792","19.282438000","201.5758","N/A","31.43"
"41.177.26.176","77.197.128.254","42","25507","25","23773","17","1734","19.475399000","56.5444","3363.45","245.33"
"210.218.218.197","244.3.39.41","16","1216","0","0","16","1216","19.676475000","206.1001","N/A","47.20"
"244.3.160.239","254.204.39.13","4","6072","4","6072","0","0","19.694523000","179.9979","269.87","N/A"
"194.66.204.47","244.3.41.84","24","14145","10","1095","14","13050","20.236499000","120.6480","72.61","865.33"
"41.177.106.160","210.218.218.197","8","608","8","608","0","0","20.397385000","207.2732","23.47","N/A"
"41.177.106.220","210.218.218.197","8","608","8","608","0","0","20.405363000","206.8406","23.52","N/A"
"41.177.98.143","186.198.89.242","31","3942","16","2828","15","1114","20.407163000","1.9612","11535.91","4544.20"
"244.3.153.89","244.3.176.224","24","2288","16","1400","8","888","20.525331000","212.9595","52.59","33.36"
"94.2.202.197","244.3.160.239","49","16280","21","10281","28","5999","20.744795000","145.9359","563.59","328.86"
"41.177.75.118","210.218.218.197","8","608","8","608","0","0","20.760500000","207.2200","23.47","N/A"
"91.91.91.91","218.218.218.218","64","23200","0","0","64","23200","20.885605000","195.5741","N/A","949.00"
"41.177.98.220","244.3.185.214","46","23771","24","18370","22","5401","20.969377000","59.3094","2477.85","728.52"
"41.177.26.176","77.197.128.204","49","26450","29","24562","20","1888","21.062447000","56.6598","3468.00","266.57"
"41.177.26.141","106.193.145.84","2","249","1","130","1","119","21.075478000","0.0002","N/A","N/A"
"41.177.202.164","210.218.218.197","8","608","8","608","0","0","21.080103000","207.0044","23.50","N/A"
"41.177.204.41","210.218.218.197","16","1216","16","1216","0","0","21.089374000","207.5095","46.88","N/A"
"41.177.98.31","244.157.67.98","8","752","4","376","4","376","21.282035000","165.0027","18.23","18.23"
"41.177.230.130","244.3.153.24","21","2340","0","0","21","2340","21.713813000","167.6233","N/A","111.68"
"41.177.3.145","244.3.153.34","111","23176","45","8457","66","14719","21.725317000","195.0242","346.91","603.78"
"41.177.24.241","244.3.153.156","33","5796","17","4028","16","1768","21.822691000","183.3398","175.76","77.15"
"253.37.253.31","253.37.253.254","8","512","4","256","4","256","22.077482000","180.3789","11.35","11.35"
"225.79.120.111","244.3.210.197","15","960","15","960","0","0","22.278004000","0.0208","368964.69","N/A"
"41.177.230.40","244.3.153.48","2","128","1","64","1","64","22.287080000","0.0717","N/A","N/A"
"41.177.24.241","244.3.153.117","45","6905","22","2905","23","4000","22.297417000","197.2013","117.85","162.27"
"41.177.98.176","244.3.79.141","76","50453","44","46633","32","3820","22.381166000","58.3248","6396.32","523.96"
"41.177.46.91","41.177.46.253","4","1068","0","0","4","1068","22.399701000","0.0003","N/A","32486692.02"
"168.91.64.164","244.3.210.197","48","38124","18","1302","30","36822","22.430483000","174.9739","59.53","1683.54"
"210.218.218.3","244.3.164.149","4","544","0","0","4","544","22.472327000","179.9915","N/A","24.18"
"41.177.26.164","210.218.218.197","16","1216","16","1216","0","0","22.480474000","206.8563","47.03","N/A"
"41.177.3.224","244.3.41.252","69","15704","29","7680","40","8024","22.528955000","188.0774","326.67","341.31"
"41.177.106.47","210.218.218.197","8","608","8","608","0","0","22.629407000","207.0844","23.49","N/A"
"210.244.26.210","244.3.41.71","1","64","0","0","1","64","22.724215000","0.0000","N/A","N/A"
"145.67.150.3","244.3.160.239","100","80667","31","3740","69","76927","22.915974000","1.3338","22432.92","461416.42"
"244.3.164.37","244.3.164.161","12","1152","12","1152","0","0","23.070768000","1.5249","6043.60","N/A"
"41.177.143.128","123.160.164.192","4","688","4","688","0","0","23.100286000","0.0003","16831804.28","N/A"
"41.177.26.176","68.157.168.192","485","195992","245","174518","240","21474","23.147595000","191.0731","7306.86","899.09"
"244.3.210.197","254.40.82.123","2","128","0","0","2","128","23.286291000","0.0000","N/A","127999999.98"
"41.177.46.176","244.3.41.252","1","70","0","0","1","70","23.321572000","0.0000","N/A","N/A"
"41.177.4.192","210.218.218.197","8","608","8","608","0","0","23.363423000","208.6928","23.31","N/A"
"41.177.230.130","244.3.153.177","12","1314","0","0","12","1314","23.415057000","164.9772","N/A","63.72"
"219.22.0.211","244.3.210.197","3","192","0","0","3","192","23.449919000","0.0001","N/A","25600000.00"
"41.177.98.252","244.3.160.239","683","471445","268","36306","415","435139","23.554368000","21.2498","13668.29","163818.85"
"106.160.164.255","244.3.160.218","3","444","0","0","3","444","23.601523000","0.0002","N/A","20297142.86"
"41.177.244.124","244.3.210.254","12","912","6","456","6","456","23.758208000","200.1188","18.23","18.23"
"145.95.41.164","210.218.218.197","8","608","8","608","0","0","23.772635000","206.0430","23.61","N/A"
"41.177.244.38","244.3.210.254","12","804","6","402","6","402","23.857609000","200.5385","16.04","16.04"
"41.177.106.230","210.218.218.197","8","608","8","608","0","0","23.873515000","205.8323","23.63","N/A"
"41.177.24.247","244.3.153.55","8","784","4","256","4","528","23.908045000","165.1226","12.40","25.58"
"215.67.202.111","244.3.61.68","2","132","2","132","0","0","23.975437000","3.0196","349.71","N/A"
"168.91.64.164","244.3.210.98","49","39645","18","1305","31","38340","24.192816000","174.8672","59.70","1754.02"
"41.177.26.72","244.3.160.248","74","19743","34","12052","40","7691","24.280699000","208.9838","461.36","294.42"
"15.251.180.105","41.177.26.214","78","8418","36","4866","42","3552","24.291704000","209.0075","186.25","135.96"
"41.177.3.203","244.157.156.98","2","188","1","94","1","94","24.327980000","0.0004","N/A","N/A"
"41.177.98.176","41.177.176.198","162","108521","96","95991","66","12530","24.339504000","207.5132","3700.62","483.05"
"41.177.98.127","198.222.241.108","42","3522","21","1593","21","1929","24.344017000","205.5136","62.01","75.09"
"41.177.26.214","244.3.160.186","90","16290","48","3840","42","12450","24.432445000","208.8319","147.10","476.94"
"15.205.242.71","244.3.210.197","30","4515","18","3117","12","1398","24.517869000","138.4589","180.10","80.77"
"253.37.253.43","253.176.108.193","3","2732","3","2732","0","0","24.605236000","28.8631","757.23","N/A"
"41.177.3.117","244.3.153.111","68","14760","32","7280","36","7480","24.617065000","180.7163","322.27","331.13"
"41.177.106.209","210.218.218.197","8","608","8","608","0","0","24.676450000","206.8281","23.52","N/A"
"41.177.72.41","210.218.218.197","8","608","8","608","0","0","24.688340000","207.8281","23.40","N/A"
"41.177.24.241","244.3.153.0","620","113522","346","83918","274","29604","24.740907000","165.0501","4067.52","1434.91"
"145.95.225.41","210.218.218.197","8","608","8","608","0","0","24.876500000","206.5120","23.55","N/A"
"244.3.202.95","244.3.202.235","7","829","7","829","0","0","24.976101000","174.3579","38.04","N/A"
"41.177.124.47","244.3.160.239","917","558723","348","60774","569","497949","24.976238000","201.2267","2416.14","19796.54"
"244.3.160.239","244.3.213.210","208","84742","118","61885","90","22857","24.978088000","2.9158","169793.68","62712.68"
"197.154.128.197","244.3.160.239","4087","3514253","2500","3348259","1587","165994","24.985660000","201.2185","133119.32","6599.55"
"41.177.98.176","244.3.199.218","210","147494","128","130981","82","16513","25.134864000","195.4572","5361.01","675.87"
"41.177.230.164","210.218.218.197","32","2432","32","2432","0","0","25.156475000","205.8564","94.51","N/A"
"41.177.168.181","244.3.160.239","994","544972","367","43595","627","501377","25.174443000","54.2202","6432.29","73976.46"
"154.108.181.150","244.3.210.197","1","64","0","0","1","64","25.281984000","0.0000","N/A","N/A"
"41.177.24.241","244.3.153.34","125","27649","49","14901","76","12748","25.308482000","182.7408","652.33","558.08"
"210.218.218.197","244.3.164.209","16","1216","0","0","16","1216","25.316489000","206.8401","N/A","47.03"
"41.177.98.220","244.3.185.201","24","3447","9","1638","15","1809","25.456746000","197.2687","66.43","73.36"
"145.95.41.41","210.218.218.197","8","608","8","608","0","0","25.484412000","206.2681","23.58","N/A"
"210.218.218.197","244.3.47.41","16","1216","0","0","16","1216","25.516428000","206.6561","N/A","47.07"
"41.177.98.220","41.177.110.39","67","12263","32","8063","35","4200","25.644454000","194.7796","331.16","172.50"
"244.3.153.95","244.3.202.202","4","548","2","214","2","334","25.702599000","3.3920","504.72","787.74"
"244.3.153.142","244.3.202.202","2","579","1","83","1","496","25.797648000","0.0021","N/A","N/A"
"244.3.31.251","244.3.153.108","21","2340","0","0","21","2340","25.805203000","168.3802","N/A","111.18"
"41.177.155.82","145.95.41.197","1","167","1","167","0","0","25.845898000","0.0000","N/A","N/A"
"41.177.3.192","210.218.218.197","16","1216","16","1216","0","0","26.033396000","206.4727","47.12","N/A"
"244.3.153.24","244.3.153.91","9","864","9","864","0","0","26.224771000","1.5000","4608.08","N/A"
"41.177.26.176","193.71.15.176","50","14940","24","12912","26","2028","26.234217000","0.7555","136732.41","21475.63"
"41.177.3.117","244.3.153.177","4","256","2","128","2","128","26.385233000","120.0328","8.53","8.53"
"41.177.116.91","41.177.116.210","7","630","0","0","7","630","26.683925000","187.4385","N/A","26.89"
"41.177.98.176","85.186.116.57","14","3021","6","712","8","2309","26.697582000","20.6260","276.16","895.57"
"41.177.230.192","210.218.218.197","32","2432","32","2432","0","0","26.749403000","206.7741","94.09","N/A"
"41.177.24.188","210.218.218.197","24","1824","24","1824","0","0","26.753648000","206.3353","70.72","N/A"
"41.177.202.202","244.3.153.142","34","9021","17","7588","17","1433","26.809650000","204.1147","297.40","56.16"
"41.177.98.167","244.3.79.176","4191","729771","2083","487763","2108","242008","27.183119000","195.7255","19936.62","9891.73"
"244.3.153.209","244.3.176.224","2944","1072932","1431","343024","1513","729908","27.284333000","196.3792","13973.94","29734.64"
"41.177.26.176","77.197.13.176","21","13837","12","12910","9","927","27.348538000","0.6234","165683.02","11896.84"
"41.177.98.220","244.3.79.202","66","23264","32","15311","34","7953","27.353246000","42.4855","2883.05","1497.55"
"253.37.253.43","253.127.160.2","11","1683","11","1683","0","0","27.439272000","0.4470","30123.10","N/A"
"244.3.164.161","244.3.164.217","12","1152","0","0","12","1152","27.496941000","1.5175","N/A","6073.19"
"41.116.229.239","244.3.160.239","209","75283","95","18947","114","56336","27.511446000","9.0591","16731.95","49749.89"
"41.177.98.43","244.157.156.98","4","376","2","188","2","188","27.543106000","128.0059","11.75","11.75"
"188.68.72.71","244.3.160.239","780","286430","389","217910","391","68520","27.549425000","108.2363","16106.24","5064.48"
"244.3.31.251","244.3.153.204","18","2052","0","0","18","2052","27.617423000","132.0011","N/A","124.36"
"41.177.26.205","244.157.156.98","8","752","4","376","4","376","27.656706000","182.0028","16.53","16.53"
"41.177.26.46","68.157.15.122","40","4718","18","1972","22","2746","27.659260000","202.6022","77.87","108.43"
"41.177.98.98","244.3.164.39","4","376","2","188","2","188","27.681120000","127.9999","11.75","11.75"
"41.177.244.185","244.3.210.90","14","1568","7","784","7","784","27.856684000","180.0109","34.84","34.84"
"244.3.153.91","244.3.153.177","9","864","0","0","9","864","27.925725000","1.5007","N/A","4606.00"
"41.177.106.230","210.218.218.160","4","256","4","256","0","0","27.956623000","180.1423","11.37","N/A"
"210.218.218.197","244.3.47.186","14","1064","0","0","14","1064","27.982738000","177.8432","N/A","47.86"
"244.3.153.106","244.3.202.202","8","1698","4","300","4","1398","28.010417000","0.1666","14404.98","67127.23"
"244.3.153.48","244.3.176.224","21","2002","14","1225","7","777","28.081244000","182.5596","53.68","34.05"
"41.177.3.117","244.3.153.48","21","2002","7","777","14","1225","28.082437000","182.5585","34.05","53.68"
"123.160.164.192","244.3.160.4","3","516","0","0","3","516","28.223363000","0.0001","N/A","32503937.01"
"244.3.202.202","244.3.210.230","12","2269","6","1758","6","511","28.432697000","174.0547","80.80","23.49"
"68.83.39.67","244.3.210.255","9","594","0","0","9","594","28.443248000","33.9406","N/A","140.01"
"41.177.26.176","68.157.168.106","394","151890","195","133656","199","18234","28.496768000","204.3548","5232.31","713.82"
"253.37.253.43","253.213.108.239","16","16172","16","16172","0","0","28.539843000","95.4316","1355.69","N/A"
"41.177.56.222","244.3.41.84","126","31026","57","4784","69","26242","28.556408000","195.2498","196.02","1075.22"
"145.95.48.20","244.3.31.46","3108","378224","2072","219676","1036","158548","28.586448000","1.8374","956454.68","690307.44"
"41.177.3.164","210.218.218.197","14","1064","14","1064","0","0","28.592453000","178.4470","47.70","N/A"
"41.177.202.249","244.3.153.67","1512","213206","752","99002","760","114204","28.829773000","200.5424","3949.37","4555.80"
"16.45.55.23","41.177.98.176","19","8191","9","790","10","7401","29.127316000","15.4140","410.02","3841.18"
"41.177.26.15","68.224.16.165","2777","2199785","1744","2131345","1033","68440","29.477673000","44.4806","383330.30","12309.19"
"244.3.153.241","244.3.202.202","2","288","1","84","1","204","29.535592000","0.0010","N/A","N/A"
"41.177.24.241","244.3.153.48","8","784","4","256","4","528","29.547606000","165.0681","12.41","25.59"
"244.3.153.142","244.3.176.68","18","1716","12","1050","6","666","29.551668000","180.2821","46.59","29.55"
"41.177.46.23","244.3.153.142","397","176422","225","157695","172","18727","29.551743000","180.2821","6997.70","831.01"
"41.177.26.205","244.3.164.39","8","752","4","376","4","376","29.656670000","167.0034","18.01","18.01"
"41.177.98.176","145.67.149.81","470","240866","229","207768","241","33098","29.747612000","151.2014","10992.92","1751.20"
"41.177.98.127","46.142.20.230","54","11463","29","9333","25","2130","29.786369000","196.5751","379.82","86.68"
"41.177.31.94","210.218.218.160","21","1848","21","1848","0","0","29.801055000","180.0082","82.13","N/A"
"210.244.26.118","244.3.41.71","1","92","0","0","1","92","29.809028000","0.0000","N/A","N/A"
"15.111.142.246","244.3.210.197","5","320","0","0","5","320","30.282066000","5.0000","N/A","512.00"
"41.177.230.130","244.3.153.108","3","288","0","0","3","288","30.304868000","2.9995","N/A","768.14"
"188.68.161.253","244.3.160.239","15","4820","7","3596","8","1224","30.752010000","0.4480","64216.58","21857.92"
"41.177.98.156","241.157.67.72","211","157447","98","7328","113","150119","30.774738000","200.5416","292.33","5988.54"
"41.177.24.241","244.3.153.106","10","1316","5","724","5","592","30.785864000","165.1256","35.08","28.68"
"188.68.194.244","244.3.160.239","13","3165","6","2005","7","1160","30.801596000","0.3978","40321.67","23328.25"
"188.68.194.102","244.3.160.239","13","4426","6","3266","7","1160","30.805540000","0.3942","66288.81","23544.10"
"188.68.161.141","244.3.160.239","13","3965","6","2805","7","1160","30.813190000","0.3872","57959.34","23968.92"
"41.177.26.151","66.55.75.213","6","384","5","320","1","64","30.886660000","180.0324","14.22","N/A"
"41.177.26.176","241.82.197.177","1911","1657870","1219","1562744","692","95126","31.083510000","104.3065","119857.85","7295.88"
"242.22.218.106","244.3.61.118","2","132","2","132","0","0","31.110444000","2.9070","363.26","N/A"
"89.161.209.108","244.3.210.197","384","297662","164","34079","220","263583","31.158994000","134.1235","2032.69","15721.81"
"41.177.98.156","41.177.202.202","12","2688","6","591","6","2097","31.247329000","173.9418","27.18","96.45"
"210.244.26.118","253.37.253.204","1","92","0","0","1","92","31.276743000","0.0000","N/A","N/A"
"40.193.210.13","244.3.210.197","425","337738","175","25315","250","312423","31.650668000","138.6318","1460.85","18028.93"
"15.71.149.82","41.177.26.91","82","51361","41","3629","41","47732","31.941579000","120.5116","240.91","3168.62"
"89.160.185.98","244.3.210.197","1077","806319","559","107981","518","698338","31.968941000","107.1358","8063.11","52145.99"
"41.177.3.224","244.3.176.149","138","63928","59","22498","79","41430","31.979038000","54.1489","3323.87","6120.90"
"41.177.26.15","215.43.45.145","31791","30863387","21154","30180134","10637","683253","32.000317000","118.7816","2032647.78","46017.45"
"244.3.153.204","244.3.202.202","16","2360","8","768","8","1592","32.029047000","115.0741","53.39","110.68"
"41.177.3.117","244.3.153.0","4","256","2","128","2","128","32.181984000","120.0367","8.53","8.53"
"41.177.4.43","91.91.91.91","6","516","6","516","0","0","32.319783000","172.2937","23.96","N/A"
"41.177.67.85","244.3.41.84","4","256","2","128","2","128","32.447356000","0.2020","5069.11","5069.11"
"244.3.41.84","244.3.224.4","4","256","2","128","2","128","32.448175000","0.1304","7854.81","7854.81"
"47.3.161.224","244.3.41.84","5","320","2","128","3","192","32.448671000","0.3018","3393.32","5089.99"
"41.177.142.37","244.3.41.84","8","1025","4","260","4","765","32.449104000","157.3812","13.22","38.89"
"41.177.222.224","244.3.41.84","4","256","2","128","2","128","32.449424000","0.2569","3986.34","3986.34"
"244.3.34.61","244.3.41.84","4","256","2","128","2","128","32.449796000","0.1955","5237.66","5237.66"
"184.75.224.164","244.3.41.84","3","192","1","64","2","128","32.450170000","0.3006","N/A","3406.69"
"184.4.145.199","244.3.41.84","5","320","2","128","3","192","32.451677000","0.2977","3439.66","5159.49"
"244.3.41.84","244.3.218.55","4","256","2","128","2","128","32.452612000","0.1704","6008.68","6008.68"
"203.22.116.204","244.3.41.84","44","15659","25","1721","19","13938","32.453113000","187.9052","73.27","593.41"
"224.143.111.145","244.3.41.84","5","320","2","128","3","192","32.453681000","0.2964","3454.22","5181.33"
"244.3.41.67","244.3.41.84","4","256","2","128","2","128","32.454047000","0.1764","5804.23","5804.23"
"244.3.41.84","244.3.77.235","4","256","2","128","2","128","32.454838000","0.1357","7544.67","7544.67"
"194.66.220.4","244.3.41.84","5","320","2","128","3","192","32.455112000","0.2951","3469.52","5204.27"
"41.177.93.111","244.3.41.84","4","256","2","128","2","128","32.455616000","0.1644","6228.03","6228.03"
"41.177.13.66","244.3.41.84","4","256","2","128","2","128","32.456306000","0.1520","6735.34","6735.34"
"41.177.132.22","244.3.41.84","8","1025","4","260","4","765","32.457920000","157.3288","13.22","38.90"
"186.181.192.154","244.3.41.84","5","320","2","128","3","192","32.458179000","0.2916","3511.18","5266.77"
"41.177.13.205","244.3.41.84","24","7398","14","977","10","6421","32.458938000","99.6011","78.47","515.74"
"244.3.41.176","244.3.41.208","2","128","2","128","0","0","32.459178000","0.0023","454303.46","N/A"
"94.145.155.254","244.3.41.84","5","320","2","128","3","192","32.459996000","0.2896","3536.30","5304.45"
"244.3.41.84","244.3.47.210","4","256","2","128","2","128","32.460423000","0.2262","4526.71","4526.71"
"41.177.13.246","244.3.41.84","4","256","2","128","2","128","32.461002000","0.1933","5297.44","5297.44"
"244.3.41.84","244.3.90.194","4","256","2","128","2","128","32.461745000","0.1977","5180.85","5180.85"
"194.66.164.108","244.3.41.84","5","320","2","128","3","192","32.462370000","0.2873","3564.68","5347.02"
"41.177.37.57","244.3.41.84","4","256","2","128","2","128","32.463492000","0.1428","7170.47","7170.47"
"41.177.82.121","244.3.41.84","2","128","2","128","0","0","32.463572000","0.3128","3273.69","N/A"
"41.177.37.95","244.3.41.84","38","13589","21","1405","17","12184","32.463927000","60.1603","186.83","1620.21"
"41.177.239.219","244.3.41.84","5","359","3","213","2","146","32.464690000","0.0106","160120.28","109753.81"
"94.145.155.118","244.3.41.84","5","320","2","128","3","192","32.465373000","0.2837","3609.93","5414.90"
"244.3.39.95","244.3.41.84","4","256","2","128","2","128","32.466188000","0.1307","7832.58","7832.58"
"41.177.43.188","244.3.41.84","2","128","2","128","0","0","32.466251000","0.1746","5865.71","N/A"
"244.3.41.84","244.3.188.241","14","2511","7","2057","7","454","32.466932000","75.6481","217.53","48.01"
"41.177.160.57","244.3.41.84","4","256","2","128","2","128","32.467247000","0.1722","5946.02","5946.02"
"41.177.153.153","244.3.41.84","4","256","2","128","2","128","32.467570000","0.1543","6636.12","6636.12"
"41.177.161.13","244.3.41.84","4","256","2","128","2","128","32.468186000","0.2065","4958.19","4958.19"
"244.3.41.84","244.3.203.37","5","359","2","146","3","213","32.468687000","0.0104","111845.26","163171.50"
"41.177.142.111","244.3.41.84","7","957","3","194","4","763","32.469213000","157.1873","9.87","38.83"
"184.75.224.75","244.3.41.84","3","192","1","64","2","128","32.469623000","0.2810","N/A","3644.05"
"194.66.143.56","244.3.41.84","5","320","2","128","3","192","32.470565000","0.2786","3675.16","5512.75"
"41.177.43.16","244.3.41.84","6","429","3","213","3","216","32.470813000","0.0068","250994.26","254529.39"
"244.3.41.84","244.3.144.142","7","1553","3","1278","4","275","32.471508000","112.4430","90.93","19.57"
"244.3.41.84","244.3.90.4","4","256","2","128","2","128","32.471944000","0.1414","7240.84","7240.84"
"41.177.4.31","244.3.153.197","15","3205","5","2000","10","1205","32.475215000","179.3840","89.19","53.74"
"41.177.24.241","244.3.153.142","32","5955","14","3829","18","2126","32.477652000","180.2881","169.91","94.34"
"41.177.75.223","41.177.98.220","3","318","2","189","1","129","32.500095000","0.2966","5098.43","N/A"
"41.177.26.205","244.157.13.98","6","564","3","282","3","282","32.656655000","157.0025","14.37","14.37"
"41.177.98.127","241.151.91.231","14","1215","6","472","8","743","32.799354000","186.9008","20.20","31.80"
"244.3.210.197","254.51.75.100","102","79168","60","72058","42","7110","32.882886000","163.7578","3520.22","347.34"
"41.177.244.224","244.3.210.254","14","1104","8","614","6","490","32.922588000","190.2551","25.82","20.60"
"41.177.24.241","244.3.153.33","8","784","4","256","4","528","33.008347000","165.0433","12.41","25.59"
"41.177.3.67","210.218.218.3","8","1088","8","1088","0","0","33.069722000","179.9949","48.36","N/A"
"85.41.34.188","244.3.210.197","934","776816","415","75603","519","701213","33.182099000","12.0273","50287.80","466416.18"
"41.177.98.31","244.3.164.39","8","752","4","376","4","376","33.283552000","191.9962","15.67","15.67"
"244.3.153.40","244.3.202.202","10","2181","5","405","5","1776","33.685604000","138.9124","23.32","102.28"
"41.177.26.194","41.177.202.202","8","1336","4","360","4","976","33.757783000","164.8528","17.47","47.36"
"186.136.103.68","244.3.160.239","3459","2886158","1419","133723","2040","2752435","33.823156000","87.2682","12258.58","252319.73"
"41.177.26.176","68.157.168.41","161","66190","78","58535","83","7655","33.837940000","168.9880","2771.08","362.39"
"244.3.31.40","244.3.34.55","12","1104","4","360","8","744","33.883948000","181.6667","15.85","32.76"
"244.3.106.254","244.3.210.254","12","804","6","402","6","402","33.923606000","200.4727","16.04","16.04"
"168.117.3.145","244.3.160.239","8717","8423210","2992","227152","5725","8196058","33.955692000","167.9568","10819.54","390388.82"
"41.177.3.121","210.218.218.3","6","514","6","514","0","0","34.000177000","197.1491","20.86","N/A"
"122.248.218.117","244.3.160.239","459","212698","237","166670","222","46028","34.028645000","160.5267","8306.16","2293.85"
"41.177.3.204","210.218.218.3","6","476","6","476","0","0","34.099128000","191.0489","19.93","N/A"
"41.177.26.176","168.82.82.108","4","6040","4","6040","0","0","34.324318000","179.9999","268.44","N/A"
"41.177.98.176","254.204.205.13","11","1639","5","531","6","1108","34.388241000","30.0085","141.56","295.38"
"244.3.31.251","244.3.153.41","36","4104","0","0","36","4104","34.445096000","163.4971","N/A","200.81"
"244.3.31.251","244.3.153.30","39","4392","0","0","39","4392","34.464243000","163.5023","N/A","214.90"
"253.37.253.43","253.160.251.90","3779","5135964","3779","5135964","0","0","34.523487000","183.5988","223790.76","N/A"
"41.177.180.176","244.3.31.84","12","1056","12","1056","0","0","34.737236000","180.5327","46.79","N/A"
"41.177.3.18","244.3.153.48","40","6482","19","4293","21","2189","34.880539000","60.1654","570.83","291.06"
"253.244.77.71","253.244.77.85","4","686","4","686","0","0","35.024996000","52.9529","103.64","N/A"
"244.3.210.176","244.3.210.255","14","1646","0","0","14","1646","35.025080000","8.8121","N/A","1494.30"
"41.177.93.17","244.3.41.84","29","2279","29","2279","0","0","35.316613000","196.6747","92.70","N/A"
"253.244.77.67","253.244.77.135","1","247","1","247","0","0","35.382210000","0.0000","N/A","N/A"
"244.3.31.91","244.3.31.150","2","494","0","0","2","494","35.382257000","0.0002","N/A","24700000.00"
"244.3.41.47","244.3.41.185","16","4382","7","452","9","3930","35.385251000","160.3380","22.55","196.09"
"244.3.41.120","244.3.41.185","16","4382","7","452","9","3930","35.385286000","160.3773","22.55","196.04"
"41.177.98.143","82.181.188.253","61","6563","29","3328","32","3235","35.501461000","198.5592","134.09","130.34"
"41.177.230.130","244.3.153.33","36","4104","0","0","36","4104","36.006435000","163.4828","N/A","200.83"
"41.177.26.176","41.202.64.43","178","115365","105","106982","73","8383","36.049431000","74.8705","11431.16","895.73"
"244.3.164.161","244.3.164.205","12","1152","0","0","12","1152","36.072932000","1.5189","N/A","6067.45"
"244.3.41.145","244.3.164.39","2","188","1","94","1","94","36.130282000","0.0002","N/A","N/A"
"41.177.98.57","244.157.13.98","4","376","2","188","2","188","36.294239000","128.0005","11.75","11.75"
"142.122.248.71","244.3.210.197","9","1225","5","724","4","501","36.329817000","0.1802","32146.70","22245.16"
"244.3.41.91","244.3.41.203","20","2452","0","0","20","2452","36.423206000","127.0688","N/A","154.37"
"41.177.230.31","244.3.160.254","8","752","4","376","4","376","36.464241000","173.9983","17.29","17.29"
"41.177.26.176","68.157.168.43","409","154831","204","136149","205","18682","36.497610000","186.0700","5853.67","803.22"
"194.66.204.94","244.3.41.84","20","8073","10","769","10","7304","36.775186000","37.3898","164.54","1562.78"
"150.160.203.244","244.3.61.39","2","132","2","132","0","0","36.898504000","2.9287","360.57","N/A"
"41.177.98.124","197.48.26.167","16","1205","9","689","7","516","37.012698000","0.4796","11492.00","8606.49"
"41.177.98.220","244.3.142.138","138","46622","64","38611","74","8011","37.128845000","194.6752","1586.68","329.20"
"253.37.253.43","253.84.160.167","1","64","1","64","0","0","37.388113000","0.0000","N/A","N/A"
"41.177.26.176","55.161.39.39","57","32013","33","27838","24","4175","37.417250000","63.2331","3521.95","528.20"
"244.3.210.197","254.71.77.18","5","350","2","140","3","210","37.540951000","0.0117","95449.12","143173.68"
"41.177.98.143","41.194.123.57","3","298","1","140","2","158","37.559732000","0.2040","N/A","6197.51"
"244.3.153.91","244.3.153.204","3","741","0","0","3","741","37.614096000","0.0002","N/A","37050000.00"
"151.77.185.176","244.3.160.239","481","285534","185","26539","296","258995","37.624788000","2.3512","90299.50","881235.86"
"41.177.26.91","100.176.176.204","1245","1435127","935","1413105","310","22022","37.742295000","5.6511","2000454.07","31175.32"
"67.122.211.41","244.3.41.185","1","66","1","66","0","0","37.873379000","0.0000","N/A","N/A"
"41.177.98.176","41.177.211.160","135","53441","68","25145","67","28296","37.875782000","30.4416","6608.07","7436.14"
"41.177.98.176","41.177.181.81","320","256008","204","239454","116","16554","38.376210000","125.5043","15263.47","1055.20"
"244.3.4.55","244.3.41.91","9","864","9","864","0","0","38.473077000","1.4987","4611.89","N/A"
"244.3.31.31","244.3.31.91","14","1646","14","1646","0","0","38.500125000","17.2990","761.20","N/A"
"41.177.244.188","244.3.210.254","10","760","5","374","5","386","38.573365000","160.0726","18.69","19.29"
"41.177.98.127","213.197.255.209","56","4916","28","2404","28","2512","38.737438000","74.2330","259.08","270.72"
"194.66.204.41","244.3.41.84","33","6561","18","2298","15","4263","38.770682000","6.2938","2920.98","5418.69"
"41.177.26.91","77.197.210.224","71","57492","44","54877","27","2615","38.789113000","124.3525","3530.41","168.23"
"244.3.77.218","244.3.210.254","10","670","5","338","5","332","38.873606000","160.3215","16.87","16.57"
"77.197.210.217","244.3.210.197","53","34466","26","2657","27","31809","38.998137000","60.9772","348.59","4173.23"
"67.122.211.41","244.3.41.224","1","66","1","66","0","0","39.127302000","0.0000","N/A","N/A"
"67.122.211.41","244.3.41.41","1","66","1","66","0","0","39.215412000","0.0000","N/A","N/A"
"41.177.26.176","77.197.128.180","1130","674157","677","628513","453","45644","39.216149000","59.3885","84664.62","6148.53"
"77.197.210.82","244.3.210.197","56","43083","24","2107","32","40976","39.353211000","9.4848","1777.16","34561.46"
"253.37.253.31","253.37.253.91","1","253","1","253","0","0","39.407379000","0.0000","N/A","N/A"
"244.3.160.91","244.3.160.210","48","6177","0","0","48","6177","39.519648000","146.6580","N/A","336.95"
"41.177.26.176","149.214.203.116","22","11467","11","10119","11","1348","39.598194000","2.0381","39719.81","5291.26"
"41.177.26.91","214.111.3.85","4","5672","4","5672","0","0","39.706967000","180.0323","252.04","N/A"
"41.177.3.91","41.177.3.202","2","494","0","0","2","494","39.787162000","0.0002","N/A","25496774.19"
"68.159.161.215","244.3.210.197","25","9686","13","1408","12","8278","39.881763000","0.5899","19093.69","112256.82"
"67.122.211.41","244.3.41.246","1","66","1","66","0","0","39.967152000","0.0000","N/A","N/A"
"67.122.211.41","244.3.41.244","1","66","1","66","0","0","39.982654000","0.0000","N/A","N/A"
"41.177.26.176","77.197.210.249","336","203689","199","189836","137","13853","40.006540000","28.5379","53216.45","3883.39"
"41.177.98.92","41.177.202.202","10","1240","5","455","5","785","40.166948000","1.0866","3349.90","5779.49"
"41.177.26.176","77.197.210.80","470","286024","279","266878","191","19146","40.197268000","28.4598","75019.06","5381.92"
"41.177.26.15","77.197.210.213","39","34899","26","33764","13","1135","40.253805000","0.7603","355292.25","11943.39"
"117.98.154.128","244.3.210.197","4","256","0","0","4","256","40.282019000","5.0000","N/A","409.60"
"203.164.144.197","244.3.210.197","2","128","0","0","2","128","40.282041000","0.0000","N/A","23272727.27"
"41.177.26.91","77.197.128.241","42","33197","25","31558","17","1639","40.319922000","9.0419","27921.41","1450.13"
"41.177.117.241","145.95.41.251","8","816","4","408","4","408","40.870410000","177.9352","18.34","18.34"
"67.81.116.154","244.3.31.46","4","320","2","132","2","188","40.980235000","2.9881","353.40","503.32"
"41.177.24.241","244.3.153.248","7","568","3","260","4","308","40.983891000","124.2044","16.75","19.84"
"41.177.26.15","77.197.210.217","170","145017","103","139978","67","5039","41.091599000","17.8539","62721.55","2257.88"
"41.177.26.15","77.197.210.176","284","271300","190","264677","94","6623","41.103001000","182.1329","11625.66","290.91"
"41.177.230.164","210.218.218.160","16","1024","16","1024","0","0","41.113201000","180.1800","45.47","N/A"
"41.177.31.164","210.218.218.160","8","512","8","512","0","0","41.113325000","180.1760","22.73","N/A"
"41.177.3.164","210.218.218.160","8","512","8","512","0","0","41.113480000","180.1759","22.73","N/A"
"41.177.204.57","210.218.218.160","4","256","4","256","0","0","41.113811000","180.1752","11.37","N/A"
"41.177.72.41","210.218.218.160","8","512","8","512","0","0","41.113887000","180.1756","22.73","N/A"
"41.177.24.188","210.218.218.160","12","768","12","768","0","0","41.113956000","180.1792","34.10","N/A"
"41.177.3.90","210.218.218.3","6","442","6","442","0","0","41.245277000","61.3942","57.60","N/A"
"41.177.26.91","77.197.210.128","43","35418","27","33822","16","1596","41.311192000","10.4383","25921.38","1223.18"
"244.3.41.91","244.3.41.144","2","458","0","0","2","458","41.423422000","0.0004","N/A","9983651.23"
"41.177.26.15","77.197.210.153","138","127037","89","123598","49","3439","41.481559000","1.0455","945741.42","26314.38"
"41.177.26.15","77.197.210.110","203","207085","146","202832","57","4253","41.524496000","12.6099","128680.88","2698.19"
"41.177.98.205","41.177.230.31","8","752","4","376","4","376","41.656803000","173.0025","17.39","17.39"
"41.177.26.15","77.197.210.2","224","208290","147","202757","77","5533","41.666613000","9.5354","170109.11","4642.08"
"41.177.26.91","77.197.210.217","24","16364","12","15293","12","1071","41.788499000","0.4667","262160.47","18359.63"
"41.177.26.176","68.157.168.156","292","118759","145","105153","147","13606","41.869233000","188.6493","4459.19","576.99"
"41.177.230.130","244.3.153.111","21","2340","0","0","21","2340","41.934744000","132.0016","N/A","141.82"
"41.177.230.91","41.177.230.185","8","2016","0","0","8","2016","42.037808000","0.0003","N/A","62270270.27"
"41.177.230.91","41.177.230.253","136","14284","0","0","136","14284","42.039934000","84.6143","N/A","1350.50"
"41.177.230.43","41.177.230.91","8","1996","8","1996","0","0","42.040023000","84.6143","188.72","N/A"
"41.177.230.91","41.177.230.218","8","1996","0","0","8","1996","42.040103000","84.6143","N/A","188.72"
"41.177.230.91","41.177.230.210","8","1996","0","0","8","1996","42.040173000","84.6143","N/A","188.72"
"41.177.230.91","41.177.230.217","8","1996","0","0","8","1996","42.040242000","84.6143","N/A","188.72"
"41.177.230.37","41.177.230.91","8","1996","8","1996","0","0","42.040308000","84.6143","188.72","N/A"
"41.177.230.91","41.177.230.168","8","1996","0","0","8","1996","42.040378000","84.6143","N/A","188.72"
"41.177.230.91","41.177.230.204","8","1996","0","0","8","1996","42.040431000","84.6143","N/A","188.72"
"41.177.230.46","41.177.230.91","8","2076","8","2076","0","0","42.051532000","0.0003","50480243.16","N/A"
"41.177.230.12","41.177.230.91","8","2076","8","2076","0","0","42.051708000","0.0003","55731543.62","N/A"
"244.3.153.197","244.3.202.202","10","1791","5","427","5","1364","42.082107000","11.4899","297.31","949.71"
"253.37.253.251","253.37.253.254","32","9670","14","913","18","8757","42.097378000","160.2811","45.57","437.08"
"41.177.26.91","77.197.210.153","29","19453","14","18162","15","1291","42.168539000","0.6252","232405.92","16519.99"
"41.177.230.130","244.3.153.142","36","4104","0","0","36","4104","42.295736000","163.5062","N/A","200.80"
"41.177.98.127","85.26.113.153","14","1162","7","531","7","631","42.369824000","1.7971","2363.84","2809.00"
"41.177.108.224","244.3.160.254","6","564","3","282","3","282","42.464171000","191.9981","11.75","11.75"
"41.177.98.176","151.77.108.215","354","254744","198","225093","156","29651","42.496037000","53.6329","33575.38","4422.81"
"41.177.98.121","244.157.156.98","8","752","4","376","4","376","42.498862000","160.0035","18.80","18.80"
"244.3.153.77","244.3.202.202","8","1644","4","327","4","1317","42.701399000","171.0210","15.30","61.61"
"41.177.26.46","77.197.128.41","7","934","3","354","4","580","42.778198000","0.1713","16531.82","27086.03"
"215.203.31.218","244.3.210.197","1483","1449842","510","88650","973","1361192","42.862973000","66.8477","10609.20","162900.78"
"244.3.153.30","244.3.202.202","4","603","2","163","2","440","43.022049000","56.2142","23.20","62.62"
"41.203.225.103","244.3.210.197","339","267403","155","64257","184","203146","43.376362000","69.1833","7430.35","23490.77"
"41.177.106.217","116.91.164.164","2","134","2","134","0","0","43.424939000","0.0002","4375510.20","N/A"
"41.177.26.176","66.95.68.201","11","1850","5","841","6","1009","43.496262000","0.7637","8810.03","10569.94"
"41.177.3.224","244.3.41.117","276","141531","136","93798","140","47733","43.510023000","156.9629","4780.64","2432.83"
"244.3.160.239","254.204.210.149","6","384","6","384","0","0","43.694052000","60.0893","51.12","N/A"
"41.177.26.91","77.197.128.211","136","110546","85","105423","51","5123","44.029166000","20.3307","41483.19","2015.86"
"194.66.204.209","244.3.41.84","212","93014","103","8277","109","84737","44.182863000","183.5694","360.71","3692.86"
"41.177.98.176","41.177.164.128","4","268","3","198","1","70","44.362570000","60.0077","26.40","N/A"
"41.177.26.91","77.197.210.239","106","84120","64","79874","42","4246","44.687157000","15.8327","40359.03","2145.43"
"41.177.98.220","244.3.31.181","8","512","4","256","4","256","44.737776000","119.3727","17.16","17.16"
"41.177.98.98","244.3.31.26","13","1935","7","1322","6","613","44.743738000","161.5868","65.45","30.35"
"41.177.24.241","244.3.153.30","17","1743","9","847","8","896","44.775451000","165.0616","41.05","43.43"
"41.177.98.220","244.3.31.241","17","4393","7","2834","10","1559","44.901946000","0.7342","30880.96","16987.80"
"41.177.230.83","244.3.153.30","20","3290","10","1576","10","1714","44.905572000","0.5829","21631.64","23525.78"
"197.154.128.43","244.3.160.239","8007","8192748","5323","8015776","2684","176972","45.083823000","156.7817","409015.81","9030.24"
"41.177.98.176","145.95.139.141","173","97350","94","64345","79","33005","45.096950000","27.8621","18475.27","9476.67"
"41.177.75.141","210.218.218.160","4","256","4","256","0","0","45.189694000","179.9965","11.38","N/A"
"145.95.48.22","210.218.218.160","4","256","4","256","0","0","45.216359000","179.9899","11.38","N/A"
"41.177.106.121","210.218.218.160","4","256","4","256","0","0","45.216725000","179.9901","11.38","N/A"
"41.177.106.77","210.218.218.160","8","512","8","512","0","0","45.216784000","179.9936","22.76","N/A"
"41.177.106.47","210.218.218.160","4","256","4","256","0","0","45.216842000","179.9901","11.38","N/A"
"41.177.106.160","210.218.218.160","4","256","4","256","0","0","45.216901000","179.9901","11.38","N/A"
"41.177.98.192","210.218.218.160","8","512","8","512","0","0","45.216959000","179.9936","22.76","N/A"
"41.177.106.143","210.218.218.160","4","256","4","256","0","0","45.217019000","179.9932","11.38","N/A"
"41.177.106.220","210.218.218.160","4","256","4","256","0","0","45.217155000","179.9931","11.38","N/A"
"41.177.106.39","210.218.218.160","4","256","4","256","0","0","45.217281000","179.9931","11.38","N/A"
"246.142.98.43","246.142.244.157","3","192","3","192","0","0","45.278518000","131.3015","11.70","N/A"
"246.142.98.43","246.142.244.3","3","192","3","192","0","0","45.337717000","131.3415","11.69","N/A"
"41.177.204.139","210.218.218.123","4","256","4","256","0","0","45.457150000","176.5099","11.60","N/A"
"244.3.160.254","244.3.164.39","8","752","4","376","4","376","45.464161000","179.9981","16.71","16.71"
"244.3.160.254","244.157.156.98","8","752","4","376","4","376","45.464261000","164.9983","18.23","18.23"
"242.194.160.18","244.3.210.255","16","8388","8","7644","8","744","45.494493000","180.0718","339.60","33.05"
"41.177.98.121","244.157.67.98","8","752","4","376","4","376","45.498915000","161.0020","18.68","18.68"
"41.177.98.121","244.3.164.39","6","564","3","282","3","282","45.498968000","128.0013","17.62","17.62"
"244.3.153.30","244.3.160.80","30","13562","12","2416","18","11146","45.557116000","15.5047","1246.59","5751.02"
"41.106.180.204","41.177.241.46","10","640","0","0","10","640","45.831786000","175.4250","N/A","29.19"
"41.177.117.41","145.95.41.251","4","408","0","0","4","408","45.891487000","178.0848","N/A","18.33"
"41.177.230.31","145.95.81.118","4","376","2","188","2","188","46.021652000","128.0009","11.75","11.75"
"41.177.98.176","145.51.132.23","11","1369","5","610","6","759","46.026985000","23.0933","211.32","262.93"
"41.177.98.251","249.13.130.167","2","158","0","0","2","158","46.366096000","1.5442","N/A","818.56"
"41.177.98.98","244.157.156.98","4","376","2","188","2","188","46.681136000","128.0001","11.75","11.75"
"18.132.77.186","244.3.160.239","2300","1401162","900","120781","1400","1280381","46.916679000","172.2825","5608.51","59454.96"
"41.177.108.224","145.95.81.118","4","376","2","188","2","188","47.021629000","128.0011","11.75","11.75"
"41.177.26.15","46.144.210.156","63","41056","31","38339","32","2717","47.136934000","17.6593","17368.27","1230.85"
"244.3.4.48","244.3.41.91","3","741","3","741","0","0","47.172933000","0.0005","12748387.10","N/A"
"244.3.202.203","244.3.202.235","1","247","1","247","0","0","47.173038000","0.0000","N/A","N/A"
"41.177.26.176","41.177.202.202","10182","1808218","5091","465496","5091","1342722","47.228353000","130.1795","28606.41","82515.12"
"244.3.153.108","244.3.202.202","2","288","1","84","1","204","47.248531000","0.0011","N/A","N/A"
"41.177.98.98","244.3.31.224","4","256","2","128","2","128","47.393544000","0.1706","6002.17","6002.17"
"41.177.98.176","244.3.164.145","431","316264","268","268770","163","47494","47.412742000","170.4974","12611.10","2228.49"
"41.177.98.220","244.3.31.194","2","128","1","64","1","64","47.572749000","0.0001","N/A","N/A"
"244.3.34.157","244.3.41.84","388","150475","254","16986","134","133489","47.719471000","163.2084","832.60","6543.24"
"244.3.31.64","244.3.153.33","20","3791","9","2117","11","1674","47.946674000","67.3116","251.61","198.96"
"41.18.225.254","244.3.210.197","87","5742","29","1856","58","3886","48.337995000","20.1119","738.27","1545.75"
"41.177.26.205","244.157.67.98","6","564","3","282","3","282","48.656884000","120.0021","18.80","18.80"
"41.177.230.130","244.3.153.102","21","2178","0","0","21","2178","48.921988000","162.8638","N/A","106.99"
"41.177.26.176","41.177.108.224","2","188","1","94","1","94","49.294360000","0.0002","N/A","N/A"
"41.177.98.156","203.123.156.224","4","480","4","480","0","0","49.346830000","180.0325","21.33","N/A"
"41.177.46.91","41.177.46.225","8","1070","0","0","8","1070","49.730647000","86.3648","N/A","99.11"
"41.177.204.139","210.218.218.3","4","256","4","256","0","0","49.957312000","179.0101","11.44","N/A"
"41.177.98.127","165.188.210.111","17","2285","9","1558","8","727","50.166885000","2.0125","6193.21","2889.90"
"41.177.98.141","197.48.26.167","16","1252","9","767","7","485","50.210283000","0.4614","13298.74","8409.24"
"41.177.26.91","165.0.138.176","12","7737","7","6793","5","944","50.347374000","0.5546","97986.33","13616.82"
"41.177.24.247","244.3.153.40","8","784","4","256","4","528","50.381583000","165.0521","12.41","25.59"
"46.214.75.153","244.3.210.197","4","256","2","128","2","128","50.922019000","0.0388","26414.90","26414.90"
"91.108.108.122","244.3.61.118","2","132","2","132","0","0","51.027280000","2.8533","370.09","N/A"
"41.177.26.176","68.157.168.98","180","65150","89","56953","91","8197","51.134430000","167.1716","2725.49","392.27"
"41.177.24.241","244.3.153.209","53","13047","27","8000","26","5047","51.320331000","165.0621","387.73","244.61"
"41.177.26.151","223.72.203.218","1368","1325126","896","1293131","472","31995","51.359228000","182.4906","56688.10","1402.59"
"77.197.67.186","244.3.210.197","595","655095","160","38004","435","617091","51.632981000","28.2897","10747.11","174506.42"
"244.3.31.168","244.3.77.177","90","21988","46","14136","44","7852","51.788330000","120.3324","939.80","522.02"
"41.177.98.176","203.117.47.177","9","1314","4","461","5","853","51.792726000","15.2491","241.85","447.50"
"90.218.241.186","244.3.210.197","788","655763","321","75564","467","580199","51.877952000","172.4983","3504.45","26908.05"
"244.3.153.177","244.3.160.80","31","6475","16","3099","15","3376","52.045908000","150.8076","164.39","179.09"
"41.177.98.127","77.13.122.26","5","322","2","128","3","194","52.375899000","0.0763","13414.03","20330.63"
"41.177.202.26","41.177.202.235","4","988","4","988","0","0","52.590124000","0.0007","11975757.58","N/A"
"41.177.98.143","224.41.61.218","85","14051","42","9919","43","4132","52.603581000","173.2320","458.07","190.82"
"18.197.161.77","244.3.61.177","2","132","2","132","0","0","52.607208000","2.9744","355.03","N/A"
"41.177.24.108","244.3.153.235","8","784","4","256","4","528","52.773992000","165.1239","12.40","25.58"
"41.177.98.176","90.38.138.177","2","140","1","70","1","70","53.105334000","0.0002","N/A","N/A"
"41.177.26.176","151.239.66.180","185","99617","105","85999","80","13618","53.560178000","139.0618","4947.38","783.42"
"253.37.253.43","253.142.253.218","11","4868","11","4868","0","0","53.585837000","153.4141","253.85","N/A"
"41.177.3.220","210.218.218.3","16","2176","16","2176","0","0","53.592468000","179.9923","96.72","N/A"
"26.244.48.209","41.177.26.91","235","237549","69","4933","166","232616","53.671396000","166.5477","236.95","11173.54"
"41.177.26.176","68.157.168.39","254","98575","125","86613","129","11962","53.896731000","137.8155","5027.77","694.38"
"244.3.164.64","244.3.164.161","12","1152","12","1152","0","0","54.055052000","1.5200","6063.31","N/A"
"253.37.253.43","253.213.108.181","14","13959","14","13959","0","0","54.231638000","29.2802","3813.91","N/A"
"41.177.24.241","244.3.153.239","190","28087","96","19035","94","9052","54.324284000","180.0902","845.58","402.11"
"41.177.26.205","41.177.230.224","4","408","2","204","2","204","54.586747000","137.6344","11.86","11.86"
"67.122.211.41","244.3.61.215","1","66","1","66","0","0","54.849318000","0.0000","N/A","N/A"
"41.177.26.91","41.177.230.224","22","13015","12","12299","10","716","54.868165000","0.1413","696250.27","40532.99"
"67.122.211.41","244.3.61.118","1","66","1","66","0","0","54.878205000","0.0000","N/A","N/A"
"186.98.185.39","244.3.210.39","1","66","1","66","0","0","54.906119000","0.0000","N/A","N/A"
"67.122.211.41","244.3.61.40","1","66","1","66","0","0","54.919483000","0.0000","N/A","N/A"
"67.122.211.41","244.3.61.124","1","66","1","66","0","0","54.935610000","0.0000","N/A","N/A"
"67.122.211.41","244.3.61.244","1","66","1","66","0","0","54.973516000","0.0000","N/A","N/A"
"41.177.26.46","41.177.230.224","87","34398","45","31302","42","3096","54.979571000","30.7762","8136.66","804.78"
"67.122.211.41","244.3.61.68","1","66","1","66","0","0","54.985251000","0.0000","N/A","N/A"
"67.122.211.41","244.3.61.151","1","66","1","66","0","0","55.001788000","0.0000","N/A","N/A"
"67.122.211.41","244.3.61.22","1","66","1","66","0","0","55.087341000","0.0000","N/A","N/A"
"67.122.211.41","244.3.61.177","1","66","1","66","0","0","55.109888000","0.0000","N/A","N/A"
"41.177.83.247","244.3.160.239","169","132515","63","9287","106","123228","55.121661000","0.5538","134151.41","1780037.63"
"67.122.211.41","244.3.61.92","1","66","1","66","0","0","55.125553000","0.0000","N/A","N/A"
"41.177.230.67","244.3.160.239","51","23132","27","18044","24","5088","55.125729000","0.4597","314005.29","88542.39"
"67.122.211.41","244.3.61.225","1","66","1","66","0","0","55.175687000","0.0000","N/A","N/A"
"67.122.211.41","244.3.61.39","1","66","1","66","0","0","55.189264000","0.0000","N/A","N/A"
"67.122.211.41","244.3.61.209","1","66","1","66","0","0","55.206754000","0.0000","N/A","N/A"
"67.122.211.41","244.3.61.41","1","66","1","66","0","0","55.227764000","0.0000","N/A","N/A"
"41.177.26.15","244.3.160.239","194","214578","156","209620","38","4958","55.559536000","0.1110","15104754.01","357262.52"
"41.177.26.176","244.3.164.39","4","376","2","188","2","188","56.294285000","128.0001","11.75","11.75"
"41.177.199.139","244.3.160.239","3691","1915261","1512","237261","2179","1678000","56.347613000","175.8771","10792.13","76326.03"
"41.177.26.176","68.157.168.110","172","65619","85","57704","87","7915","56.481855000","167.3605","2758.31","378.34"
"41.177.98.84","177.202.167.210","1","66","0","0","1","66","56.925154000","0.0000","N/A","N/A"
"41.177.26.176","77.197.127.136","20","12676","12","11864","8","812","56.978023000","0.4962","191271.16","13091.05"
"41.177.98.220","244.3.79.201","129","92850","79","88590","50","4260","57.269022000","169.3802","4184.20","201.20"
"41.177.26.77","41.177.26.209","22","3638","22","3638","0","0","57.330213000","132.5604","219.55","N/A"
"41.177.98.43","41.177.230.31","4","376","2","188","2","188","57.542151000","128.0055","11.75","11.75"
"41.39.218.67","244.3.210.197","842","607577","374","41737","468","565840","57.648122000","41.7112","8004.94","108525.19"
"41.177.98.127","197.154.210.84","62","5951","29","3085","33","2866","57.950183000","146.0738","168.96","156.96"
"68.83.160.23","244.3.210.98","42","2730","21","1344","21","1386","57.968145000","161.7251","66.48","68.56"
"244.3.164.51","244.3.164.161","12","1152","12","1152","0","0","58.091978000","1.3856","6651.31","N/A"
"41.177.98.98","244.3.31.184","4","256","2","128","2","128","58.298308000","0.1673","6122.24","6122.24"
"244.3.39.203","244.3.41.176","3","198","0","0","3","198","58.338371000","7.0231","N/A","225.54"
"41.177.230.130","244.3.153.103","9","1026","0","0","9","1026","58.426075000","20.9976","N/A","390.90"
"41.177.98.220","244.3.31.98","14","2433","7","1179","7","1254","58.473937000","64.5248","146.18","155.48"
"41.177.98.176","90.218.155.193","277","214990","171","190440","106","24550","58.483501000","29.2260","52128.85","6720.03"
"244.3.31.251","244.3.153.117","9","1026","0","0","9","1026","58.762465000","21.1849","N/A","387.45"
"41.177.98.220","244.3.142.57","67","41876","37","25762","30","16114","58.801142000","175.3469","1175.36","735.18"
"41.177.241.108","210.218.218.123","132","9768","132","9768","0","0","58.811123000","168.2470","464.46","N/A"
"181.127.47.67","244.3.61.151","1","66","1","66","0","0","58.957111000","0.0000","N/A","N/A"
"41.177.3.108","145.95.81.118","4","376","2","188","2","188","59.021675000","128.0010","11.75","11.75"
"41.177.230.130","244.3.153.248","18","2052","0","0","18","2052","59.109367000","43.8822","N/A","374.09"
"41.177.241.108","41.177.241.176","252","24192","252","24192","0","0","59.112838000","169.6467","1140.82","N/A"
"72.208.154.177","244.3.61.244","2","132","2","132","0","0","59.127371000","2.9362","359.64","N/A"
"244.3.160.254","244.157.13.98","8","752","4","376","4","376","59.463962000","168.9985","17.80","17.80"
"210.244.26.18","244.3.41.71","1","92","0","0","1","92","59.804977000","0.0000","N/A","N/A"
"41.177.241.120","244.3.210.197","20","1400","12","840","8","560","59.823220000","0.0012","5838401.39","3892267.59"
"15.186.51.17","41.177.98.79","55","43449","24","2130","31","41319","60.324739000","0.4214","40440.00","784479.01"
"41.177.98.142","41.177.202.202","8","1294","4","372","4","922","60.394721000","0.0577","51578.02","127835.84"
"41.177.3.57","244.3.39.203","3","198","3","198","0","0","60.655407000","7.0078","226.03","N/A"
"253.37.253.43","253.213.108.176","32","33733","32","33733","0","0","61.228482000","67.3887","4004.59","N/A"
"210.244.26.18","253.37.253.204","1","92","0","0","1","92","61.274359000","0.0000","N/A","N/A"
"244.3.164.128","244.3.164.161","12","1152","12","1152","0","0","61.461872000","1.5241","6046.66","N/A"
"244.3.31.251","244.3.153.0","20","2244","0","0","20","2244","61.605513000","171.6960","N/A","104.56"
"244.3.31.18","244.3.31.91","2","502","2","502","0","0","61.643208000","0.0002","26077922.08","N/A"
"41.177.3.224","41.177.117.153","64","14968","33","7229","31","7739","61.713691000","59.7130","968.50","1036.83"
"253.37.253.139","253.108.13.253","10","1439","5","430","5","1009","61.787623000","0.1613","21332.67","50057.36"
"41.177.26.176","68.157.168.204","350","142272","173","125895","177","16377","61.814642000","165.9296","6069.80","789.59"
"41.177.230.224","253.37.253.139","41","19668","18","1747","23","17921","61.951976000","47.9629","291.39","2989.14"
"244.3.31.241","244.3.41.84","29","2235","15","994","14","1241","61.971711000","1.7221","4617.68","5765.13"
"41.177.26.176","77.64.39.119","16","5215","8","4424","8","791","62.109336000","0.7017","50434.06","9017.48"
"41.177.26.209","244.3.31.46","846","87106","0","0","846","87106","62.454188000","157.3687","N/A","4428.12"
"41.177.180.176","41.177.230.197","10","1610","10","1610","0","0","62.462659000","0.3548","36300.20","N/A"
"41.177.180.176","41.177.230.117","3","1391","3","1391","0","0","62.474019000","152.1182","73.15","N/A"
"41.177.98.121","41.177.230.31","6","564","3","282","3","282","62.499131000","128.0013","17.62","17.62"
"33.157.202.242","244.3.61.39","2","132","2","132","0","0","62.526373000","2.7296","386.88","N/A"
"41.177.180.176","244.3.41.152","35","5424","35","5424","0","0","62.582955000","152.1373","285.22","N/A"
"244.3.22.180","244.3.41.84","13","3613","7","530","6","3083","62.637872000","5.5068","769.96","4478.82"
"244.3.210.197","246.121.210.224","29","22451","18","20690","11","1761","62.729499000","132.5532","1248.71","106.28"
"253.37.253.43","253.213.108.77","5","4971","5","4971","0","0","62.833196000","122.2427","325.32","N/A"
"210.94.68.176","244.3.61.225","2","132","2","132","0","0","62.891517000","2.9969","352.36","N/A"
"41.177.98.220","244.3.220.197","3","316","1","128","2","188","63.080763000","0.2185","N/A","6881.85"
"41.177.26.176","79.108.231.213","7","460","3","198","4","262","63.101975000","0.5707","2775.63","3672.80"
"244.3.41.84","244.3.154.100","15","1054","0","0","15","1054","63.256130000","18.9597","N/A","444.73"
"41.177.26.176","68.159.161.120","37","15495","19","14009","18","1486","63.312335000","1.1221","99878.71","10594.60"
"41.177.176.106","244.3.160.239","1688","1129525","587","49181","1101","1080344","63.465051000","12.6697","31054.32","682160.67"
"188.68.214.181","244.3.160.239","1179","1098742","747","1061005","432","37737","63.471300000","12.7272","666920.09","23720.49"
"41.177.241.253","244.3.93.241","4","256","2","128","2","128","63.522164000","120.7545","8.48","8.48"
"41.106.90.203","244.3.210.197","689","428465","340","55265","349","373200","63.806920000","90.0914","4907.46","33139.67"
"244.3.39.203","244.3.41.100","2","128","0","0","2","128","63.848774000","0.0001","N/A","16786885.25"
"41.177.3.224","41.177.230.150","144","120981","91","117589","53","3392","64.031447000","0.0511","18409597.06","531047.57"
"253.37.253.43","253.213.108.71","13","9860","13","9860","0","0","64.144327000","27.5521","2862.94","N/A"
"41.177.98.57","244.3.202.202","4","499","2","177","2","322","64.284378000","11.7431","120.58","219.36"
"41.177.230.130","244.3.153.106","18","2052","0","0","18","2052","64.291565000","132.0383","N/A","124.33"
"41.177.56.138","244.3.41.84","97","54256","49","3184","48","51072","64.328081000","22.8975","1112.44","17843.69"
"244.3.31.251","244.3.153.55","18","2052","0","0","18","2052","64.502282000","131.9991","N/A","124.36"
"41.177.26.176","41.177.230.31","4","376","2","188","2","188","65.294275000","107.0001","14.06","14.06"
"41.177.230.130","244.3.153.25","18","1890","0","0","18","1890","65.296896000","71.1950","N/A","212.37"
"244.3.153.103","244.3.176.224","4","256","2","128","2","128","65.450757000","120.3151","8.51","8.51"
"210.218.218.3","244.3.164.211","5","347","0","0","5","347","65.692348000","59.7942","N/A","46.43"
"41.177.57.211","244.3.210.197","943","790350","390","58927","553","731423","65.715590000","70.2119","6714.19","83338.87"
"18.198.66.77","244.3.210.197","349","270125","156","66024","193","204101","66.115780000","73.1125","7224.38","22332.82"
"41.177.3.13","210.218.218.3","4","310","4","310","0","0","66.281608000","95.0588","26.09","N/A"
"41.177.34.163","244.3.160.239","1200","273828","600","171228","600","102600","66.394842000","142.6406","9603.32","5754.32"
"41.177.202.17","244.3.153.197","1","346","0","0","1","346","66.851204000","0.0000","N/A","N/A"
"244.3.202.117","244.3.202.235","1","247","1","247","0","0","66.891765000","0.0000","N/A","N/A"
"244.3.4.211","244.3.41.91","3","741","3","741","0","0","66.891960000","0.0005","12559322.03","N/A"
"244.3.4.80","244.3.41.91","3","741","3","741","0","0","66.892135000","0.0003","19629139.07","N/A"
"244.3.202.81","244.3.202.235","1","247","1","247","0","0","66.892265000","0.0000","N/A","N/A"
"244.3.153.197","244.3.160.108","3","437","3","437","0","0","66.906466000","68.1438","51.30","N/A"
"244.3.40.98","244.3.124.91","4","988","4","988","0","0","67.445393000","15.9960","494.12","N/A"
"41.177.31.176","41.177.31.203","4","988","0","0","4","988","67.445963000","15.9957","N/A","494.13"
"41.177.230.130","244.3.153.56","21","2340","0","0","21","2340","67.584176000","141.6319","N/A","132.17"
"244.3.31.251","244.3.153.22","21","2340","0","0","21","2340","67.600053000","132.0014","N/A","141.82"
"41.177.98.220","244.3.79.219","16","3223","6","2023","10","1200","68.134562000","37.7126","429.14","254.56"
"41.177.98.143","203.67.168.48","3","298","1","140","2","158","68.178676000","0.2159","N/A","5854.32"
"244.3.41.84","244.3.117.205","52","11128","28","9109","24","2019","68.353415000","16.8543","4323.64","958.33"
"41.177.244.177","244.3.210.197","1","64","0","0","1","64","68.449948000","0.0000","N/A","N/A"
"244.3.41.84","244.3.218.224","6","596","2","336","4","260","68.551911000","4.9011","548.45","424.39"
"253.37.253.121","253.160.108.127","15","4210","9","2026","6","2184","68.665091000","9.2770","1747.12","1883.37"
"41.177.4.98","244.3.153.142","2","132","1","68","1","64","68.695255000","0.2803","N/A","N/A"
"77.197.128.167","244.3.210.197","23","18788","9","810","14","17978","68.845136000","0.8301","7805.98","173254.17"
"41.177.106.37","210.218.218.164","2","128","2","128","0","0","69.026994000","0.0004","2767567.57","N/A"
"41.177.26.176","77.197.217.218","921","759849","609","732563","312","27286","69.085247000","29.4043","199307.98","7423.69"
"41.177.26.91","77.197.210.48","57","40594","32","38112","25","2482","69.153089000","95.0468","3207.85","208.91"
"210.218.218.164","244.3.47.138","2","128","0","0","2","128","69.162970000","0.0008","N/A","1226347.31"
"41.177.26.176","77.197.217.152","483","301943","291","282711","192","19232","69.296726000","28.0132","80736.57","5492.27"
"41.177.26.15","77.197.210.80","14","9737","8","8890","6","847","69.372154000","0.4188","169833.53","16180.99"
"41.177.26.176","77.197.210.2","535","328848","322","307128","213","21720","69.514667000","29.2467","84010.39","5941.19"
"41.177.98.142","244.3.93.239","50","35231","31","29343","19","5888","69.750312000","19.6332","11956.46","2399.20"
"41.177.26.15","77.197.210.224","262","220404","156","212489","106","7915","69.787523000","91.7367","18530.34","690.24"
"41.177.26.15","77.197.128.209","177","163683","117","158935","60","4748","70.129465000","12.2204","104045.64","3108.24"
"41.77.105.0","244.3.210.197","229","138126","129","41441","100","96685","70.163612000","77.1945","4294.71","10019.88"
"244.3.31.251","244.3.153.67","12","1314","0","0","12","1314","70.355387000","148.9436","N/A","70.58"
"41.177.26.15","77.197.210.186","551","516842","361","503699","190","13143","70.381199000","42.9584","93802.24","2447.58"
"41.177.26.15","77.197.128.186","118","98007","74","94194","44","3813","70.488641000","6.6239","113763.00","4605.16"
"41.177.98.205","41.177.108.224","2","188","1","94","1","94","70.657309000","0.0002","N/A","N/A"
"41.177.26.91","77.197.210.186","159","138409","98","133634","61","4775","70.803753000","124.8622","8562.02","305.94"
"41.177.26.176","77.197.210.159","411","255022","246","238556","165","16466","70.815686000","27.9139","68368.98","4719.07"
"253.37.253.43","253.142.108.12","49","32028","49","32028","0","0","70.858487000","67.8537","3776.12","N/A"
"41.177.26.15","77.197.128.225","254","239830","169","233784","85","6046","70.994782000","6.1815","302559.13","7824.63"
"41.177.26.91","77.197.217.152","23","17926","14","17027","9","899","71.021235000","0.5251","259401.24","13696.00"
"145.95.81.118","244.3.164.39","4","376","2","188","2","188","71.021759000","128.0009","11.75","11.75"
"41.177.241.128","41.177.241.219","1","247","0","0","1","247","71.030042000","0.0000","N/A","N/A"
"244.3.41.91","244.3.41.132","2","494","0","0","2","494","71.030115000","0.0002","N/A","23664670.66"
"145.95.41.43","145.95.81.118","6","676","3","245","3","431","71.057711000","0.0206","95358.57","167753.24"
"244.3.153.102","244.3.202.202","6","915","3","254","3","661","71.267189000","126.1798","16.10","41.91"
"41.177.26.91","77.197.128.153","23","18649","14","17799","9","850","71.314097000","0.5226","272444.97","13010.74"
"41.177.98.127","241.204.15.82","42","3687","21","1803","21","1884","71.335624000","26.3702","546.98","571.56"
"41.177.26.15","77.197.210.82","497","444254","308","430828","189","13426","71.339207000","9.9506","346374.77","10794.16"
"41.177.26.15","77.197.210.71","144","133047","93","129480","51","3567","71.662439000","1.1472","902934.38","24874.63"
"244.3.164.161","244.3.164.210","12","1152","0","0","12","1152","71.679908000","1.5215","N/A","6057.02"
"46.194.188.194","244.3.210.197","43","27516","19","3566","24","23950","71.939627000","133.3430","213.94","1436.90"
"41.177.26.91","77.197.210.67","43","36190","27","34566","16","1624","71.957898000","31.6808","8728.56","410.09"
"71.241.210.40","244.3.31.68","4","320","2","132","2","188","72.160420000","2.9399","359.19","511.58"
"41.177.26.176","68.157.168.197","253","91357","125","79816","128","11541","72.484004000","42.2717","15105.34","2184.16"
"41.177.26.15","77.197.210.128","610","587698","407","574099","203","13599","72.776881000","30.4771","150696.55","3569.63"
"244.3.41.84","244.3.79.15","24","7243","10","6274","14","969","72.940874000","85.7731","585.17","90.38"
"244.3.210.91","244.3.210.95","3","741","0","0","3","741","73.076056000","0.0002","N/A","33303370.79"
"244.3.31.251","244.3.153.89","9","1026","0","0","9","1026","73.101673000","11.9999","N/A","684.01"
"41.177.98.143","244.160.18.105","3","298","1","140","2","158","73.165913000","0.1884","N/A","6709.17"
"244.3.31.251","244.3.153.235","18","2052","0","0","18","2052","73.204203000","132.0009","N/A","124.36"
"253.37.253.43","253.142.253.106","10","8957","10","8957","0","0","73.346059000","94.0476","761.91","N/A"
"193.253.223.2","244.3.210.197","3","198","3","198","0","0","73.390893000","9.0144","175.72","N/A"
"41.177.161.91","41.177.161.110","6","1482","0","0","6","1482","73.807442000","0.0005","N/A","26000000.00"
"41.177.218.48","41.177.218.142","2","494","0","0","2","494","73.807560000","0.0001","N/A","64786885.24"
"41.177.142.41","244.3.41.84","26","12945","14","1985","12","10960","73.928311000","153.1894","103.66","572.36"
"41.177.84.66","244.3.31.168","107","28822","60","12016","47","16806","74.047263000","120.0341","800.84","1120.08"
"244.3.164.3","244.3.164.161","12","1152","12","1152","0","0","74.109341000","1.5159","6079.52","N/A"
"41.177.3.177","176.48.132.197","1","66","0","0","1","66","74.236132000","0.0000","N/A","N/A"
"244.3.31.251","244.3.153.102","21","2178","0","0","21","2178","74.267514000","133.0184","N/A","130.99"
"41.177.26.91","77.197.128.12","47","38018","28","36174","19","1844","74.325252000","9.6814","29891.47","1523.74"
"253.37.253.43","253.213.108.203","11","1334","11","1334","0","0","74.413884000","0.0669","159583.69","N/A"
"253.37.253.43","253.213.108.105","17","18277","17","18277","0","0","74.822710000","159.2761","918.00","N/A"
"41.177.230.130","244.3.153.67","12","1314","0","0","12","1314","74.854867000","24.4451","N/A","430.03"
"188.68.214.108","244.3.160.239","768","579620","453","537748","315","41872","74.910584000","15.0210","286397.29","22300.46"
"41.177.98.220","41.177.110.130","39","20398","18","9815","21","10583","74.941796000","64.9556","1208.83","1303.41"
"41.177.230.77","244.3.202.202","1","86","1","86","0","0","75.038094000","0.0000","N/A","N/A"
"41.177.230.224","244.3.31.46","4","408","2","204","2","204","75.203501000","129.8534","12.57","12.57"
"41.177.26.22","198.177.110.202","22","3334","10","2178","12","1156","75.271762000","151.5580","114.97","61.02"
"203.103.84.181","244.3.210.197","1","64","0","0","1","64","75.282138000","0.0000","N/A","N/A"
"145.67.223.161","244.3.160.239","106","56186","43","8491","63","47695","75.724555000","1.7981","37776.96","212197.87"
"41.177.230.224","244.3.31.124","20","3915","11","1228","9","2687","76.628289000","0.2060","47689.09","104349.01"
"41.177.98.98","47.167.160.79","2","128","1","64","1","64","76.696648000","0.0002","N/A","N/A"
"43.106.84.231","244.3.160.239","879","542535","501","495043","378","47492","76.789885000","2.6367","1502026.61","144097.07"
"244.3.210.91","244.3.210.108","2","494","0","0","2","494","77.102457000","0.0002","N/A","22078212.29"
"41.177.3.203","41.177.3.215","28","4868","12","2114","16","2754","77.356516000","120.9988","139.77","182.08"
"41.177.98.57","41.177.230.224","4","408","2","204","2","204","77.378718000","127.7247","12.78","12.78"
"41.177.26.46","77.197.128.251","16","1991","6","712","10","1279","77.531051000","15.3053","372.16","668.52"
"41.177.105.80","244.3.41.84","20","8013","10","938","10","7075","77.730405000","50.1426","149.65","1128.78"
"253.37.253.43","253.176.160.161","50","25773","50","25773","0","0","77.998834000","78.4695","2627.57","N/A"
"41.177.26.176","41.177.230.224","11","1402","5","936","6","466","78.194413000","9.7347","769.21","382.96"
"41.177.26.84","41.177.230.224","24","11755","13","10970","11","785","78.203906000","9.7311","9018.49","645.35"
"41.177.26.13","41.177.230.224","25","16064","14","15276","11","788","78.209124000","19.1580","6378.96","329.05"
"41.177.26.22","41.177.230.224","17","4582","8","3823","9","759","78.214703000","22.6950","1347.61","267.55"
"68.157.145.13","244.3.210.255","28","15955","13","1500","15","14455","78.245663000","6.6117","1814.95","17490.11"
"41.177.98.210","41.177.230.224","4","408","2","204","2","204","78.532353000","126.5808","12.89","12.89"
"41.177.26.117","41.177.26.209","20","3292","20","3292","0","0","78.614468000","152.1033","173.15","N/A"
"41.177.98.98","244.157.13.98","4","376","2","188","2","188","78.681048000","128.0001","11.75","11.75"
"41.177.26.15","128.119.167.108","1296","1134657","776","1099227","520","35430","79.013917000","90.9805","96656.02","3115.39"
"41.177.3.117","244.3.153.41","4","256","2","128","2","128","79.212501000","120.3283","8.51","8.51"
"41.177.116.45","244.3.153.156","581","290340","369","268259","212","22081","79.251488000","154.9613","13849.08","1139.95"
"244.3.153.67","244.3.153.91","18","1728","18","1728","0","0","79.369534000","4.0108","3446.73","N/A"
"41.177.98.145","41.177.230.224","4","408","2","204","2","204","79.533873000","125.5885","12.99","12.99"
"41.177.98.98","41.177.230.224","4","408","2","204","2","204","80.218038000","124.9132","13.07","13.07"
"68.33.186.67","244.3.160.239","174","127370","52","14195","122","113175","80.748590000","31.6884","3583.65","28572.01"
"244.3.153.30","244.3.153.91","39","5259","39","5259","0","0","80.867885000","21.7612","1933.35","N/A"
"67.122.211.41","244.3.39.224","1","66","1","66","0","0","81.217972000","0.0000","N/A","N/A"
"67.122.211.41","244.3.39.95","1","66","1","66","0","0","81.405190000","0.0000","N/A","N/A"
"67.122.211.41","244.3.39.102","1","66","1","66","0","0","81.437160000","0.0000","N/A","N/A"
"41.177.26.15","92.244.186.20","910","818584","583","794498","327","24086","81.813504000","37.1326","171169.83","5189.18"
"41.177.26.176","85.108.117.193","27","7508","16","6165","11","1343","82.120870000","16.7070","2952.06","643.08"
"41.177.22.92","41.177.98.220","242","207128","93","7037","149","200091","82.134474000","48.4719","1161.41","33023.81"
"244.3.210.197","244.3.224.188","775","716710","498","680200","277","36510","82.398901000","63.7283","85387.43","4583.20"
"244.3.153.156","244.3.202.202","58","11517","29","2378","29","9139","82.650460000","3.3590","5663.53","21765.77"
"244.3.202.103","244.3.202.235","1","247","1","247","0","0","82.696229000","0.0000","N/A","N/A"
"244.3.4.235","244.3.41.91","3","741","3","741","0","0","82.696423000","0.0009","6861111.11","N/A"
"41.177.153.71","244.3.153.117","2","251","1","127","1","124","82.895968000","0.0021","N/A","N/A"
"41.177.98.31","41.177.230.224","4","408","2","204","2","204","82.905929000","122.2428","13.35","13.35"
"41.177.98.98","184.4.77.132","2","128","1","64","1","64","82.907170000","0.0002","N/A","N/A"
"244.3.31.251","244.3.153.40","18","2052","0","0","18","2052","83.276009000","132.0013","N/A","124.36"
"244.3.153.91","244.3.153.102","36","3456","0","0","36","3456","83.282549000","131.5195","N/A","210.22"
"41.177.98.220","41.177.202.141","27","5035","14","3138","13","1897","83.377117000","7.4601","3365.12","2034.30"
"128.75.71.215","244.3.210.197","6","384","0","0","6","384","83.449909000","0.0001","N/A","25388429.75"
"244.3.160.89","244.106.85.43","2","143","1","79","1","64","83.475543000","0.0001","N/A","N/A"
"244.3.160.254","244.106.85.43","2","143","1","79","1","64","83.488732000","0.0001","N/A","N/A"
"244.3.160.239","244.106.85.43","2","143","1","79","1","64","83.497871000","0.0001","N/A","N/A"
"41.177.98.151","177.90.90.176","2","248","1","130","1","118","83.508543000","0.0006","N/A","N/A"
"244.3.31.155","244.106.85.43","2","143","1","79","1","64","83.675609000","0.0001","N/A","N/A"
"244.3.31.168","244.106.85.43","2","143","1","79","1","64","83.690987000","0.0001","N/A","N/A"
"244.3.31.46","244.106.85.43","2","143","1","79","1","64","83.695363000","0.0000","N/A","N/A"
"244.3.31.40","244.106.85.43","2","143","1","79","1","64","83.704118000","0.0001","N/A","N/A"
"244.3.31.124","244.106.85.43","2","143","1","79","1","64","83.706282000","0.0001","N/A","N/A"
"244.3.31.26","244.106.85.43","2","143","1","79","1","64","83.708481000","0.0000","N/A","N/A"
"244.3.31.244","244.106.85.43","2","143","1","79","1","64","83.710679000","0.0000","N/A","N/A"
"244.3.31.68","244.106.85.43","2","143","1","79","1","64","83.713153000","0.0001","N/A","N/A"
"244.3.31.41","244.106.85.43","2","143","1","79","1","64","83.739462000","0.0001","N/A","N/A"
"41.177.98.121","244.3.47.239","20","4513","10","3195","10","1318","83.890880000","95.0041","269.04","110.98"
"244.3.153.25","244.3.202.202","10","1534","5","449","5","1085","84.109373000","44.5641","80.60","194.78"
"244.3.164.111","244.3.164.161","12","1152","12","1152","0","0","84.340899000","1.3807","6674.69","N/A"
"41.177.98.127","254.214.213.72","781","621878","475","600162","306","21716","84.539654000","108.2852","44339.35","1604.36"
"244.3.153.239","244.3.176.118","5","411","3","225","2","186","84.794270000","52.1039","34.55","28.56"
"41.177.230.224","244.3.160.254","70","57206","27","1885","43","55321","84.924645000","132.8613","113.50","3331.05"
"41.177.230.130","244.3.153.30","3","288","0","0","3","288","85.368372000","2.9986","N/A","768.37"
"41.177.98.127","197.45.108.197","22","3217","10","2225","12","992","85.411646000","1.7721","10044.42","4478.23"
"41.177.98.220","244.3.90.142","319","70544","168","52013","151","18531","85.836357000","64.2160","6479.75","2308.58"
"41.177.98.121","41.177.230.224","4","408","2","204","2","204","86.357238000","131.4378","12.42","12.42"
"41.177.26.176","71.193.83.117","79","45600","57","43356","22","2244","86.860267000","1.9258","180105.09","9321.80"
"253.37.253.43","253.160.13.253","4","338","4","338","0","0","87.189461000","53.8346","50.23","N/A"
"253.37.253.43","253.160.108.253","280","21660","280","21660","0","0","87.192568000","36.5074","4746.43","N/A"
"41.177.98.43","41.177.230.224","4","408","2","204","2","204","87.249786000","130.5540","12.50","12.50"
"145.95.31.210","244.3.160.239","231","133753","94","14595","137","119158","87.252612000","1.5840","73710.49","601794.78"
"41.122.117.224","41.177.26.176","17","7017","8","1152","9","5865","87.292662000","16.7264","550.99","2805.15"
"41.177.98.220","244.3.93.229","273","53821","139","36479","134","17342","87.329814000","103.9216","2808.19","1335.01"
"41.177.26.176","77.197.127.51","32","17662","18","16162","14","1500","87.411832000","5.0787","25458.48","2362.81"
"15.186.164.176","41.177.26.46","12","3221","6","842","6","2379","87.505063000","0.1635","41210.37","116436.43"
"26.47.18.84","244.3.31.124","4","320","2","132","2","188","87.669892000","3.0597","345.13","491.55"
"41.177.98.142","41.177.230.224","19","5378","9","4583","10","795","87.929312000","129.8832","282.28","48.97"
"41.177.98.176","41.177.230.224","19","8014","10","7358","9","656","87.935248000","21.0966","2790.21","248.76"
"41.177.98.176","177.213.85.47","4","256","2","128","2","128","88.147474000","0.0019","529746.51","529746.51"
"41.177.92.145","41.177.98.220","14","2885","7","1011","7","1874","88.893149000","0.2911","27780.74","51494.66"
"41.177.98.220","244.3.90.143","31","5568","14","3116","17","2452","89.163120000","31.0134","803.78","632.50"
"77.197.106.40","244.3.210.197","66","50765","27","2682","39","48083","89.441053000","68.0470","315.31","5652.92"
"41.177.98.176","244.3.90.185","267","200797","165","181441","102","19356","89.467341000","126.3136","11491.46","1225.90"
"41.177.98.3","68.248.77.34","4","316","0","0","4","316","89.570540000","10.5586","N/A","239.43"
"197.33.223.168","244.3.210.197","69","53540","31","2805","38","50735","89.584794000","2.9222","7679.23","138896.92"
"225.79.185.181","244.3.210.197","2","128","0","0","2","128","90.282217000","5.0000","N/A","204.80"
"244.3.31.47","244.3.31.91","2","494","2","494","0","0","90.356922000","0.0002","22582857.14","N/A"
"244.3.31.91","244.3.31.224","2","494","0","0","2","494","90.356999000","0.0002","N/A","24097560.98"
"253.244.77.135","253.244.77.156","4","535","0","0","4","535","90.357069000","135.8449","N/A","31.51"
"244.3.31.91","244.3.31.223","8","1070","0","0","8","1070","90.357168000","135.8450","N/A","63.01"
"41.177.98.43","244.157.13.98","2","188","1","94","1","94","90.550953000","0.0003","N/A","N/A"
"253.37.253.43","253.142.108.93","46","7341","46","7341","0","0","90.777760000","50.5631","1161.48","N/A"
"91.91.91.91","246.142.123.211","1","346","0","0","1","346","91.459097000","0.0000","N/A","N/A"
"41.177.98.127","194.168.61.239","27","2146","14","1074","13","1072","91.756213000","51.3661","167.27","166.96"
"41.177.244.77","244.3.210.90","22","1720","14","1152","8","568","91.945929000","126.4851","72.86","35.93"
"41.84.117.71","244.3.210.197","18","11396","8","1040","10","10356","92.157370000","0.2532","32855.12","327161.15"
"244.3.153.22","244.3.176.224","4","256","2","128","2","128","92.286138000","120.0984","8.53","8.53"
"197.33.223.253","244.3.210.197","50","33091","26","2429","24","30662","92.342235000","2.2967","8460.83","106803.58"
"197.33.149.117","244.3.210.197","24","12919","13","1589","11","11330","92.418907000","2.2428","5667.95","40414.04"
"253.37.253.43","253.116.108.124","10","2805","10","2805","0","0","92.721366000","25.8965","866.53","N/A"
"41.177.31.64","41.177.31.176","2","494","2","494","0","0","93.058491000","0.0002","25171974.52","N/A"
"244.3.202.224","244.3.202.235","1","247","1","247","0","0","93.117823000","0.0000","N/A","N/A"
"244.3.4.116","244.3.41.91","3","741","3","741","0","0","93.118315000","0.0006","9996627.32","N/A"
"151.77.217.75","244.3.160.239","709","368646","314","40429","395","328217","93.186902000","11.9628","27036.57","219492.51"
"197.33.223.117","244.3.210.197","12","5995","7","1125","5","4870","93.304906000","0.1482","60748.83","262974.94"
"188.68.193.91","244.3.160.239","662","340373","330","276522","332","63851","93.347437000","106.2609","20818.34","4807.11"
"197.33.149.144","244.3.210.197","10","1709","6","1241","4","468","93.544706000","2.1466","4624.96","1744.14"
"41.177.3.215","41.177.3.224","28","4884","16","2770","12","2114","93.754846000","121.4198","182.51","139.29"
"41.177.26.91","168.84.123.138","2907","3387034","2235","3343552","672","43482","93.778481000","83.3586","320883.61","4173.01"
"210.218.218.3","244.3.210.108","2","182","0","0","2","182","93.816695000","0.0000","N/A","291199999.91"
"210.218.218.3","244.3.210.64","2","186","0","0","2","186","93.891509000","0.0000","N/A","297599999.91"
"197.33.149.122","244.3.210.197","10","1710","6","1242","4","468","93.940762000","2.1529","4615.08","1739.01"
"41.177.3.215","41.177.180.176","10","1990","0","0","10","1990","94.336959000","120.4027","N/A","132.22"
"41.177.26.176","168.72.165.153","368","163402","250","145868","118","17534","94.975568000","65.3322","17861.70","2147.06"
"244.3.153.33","244.3.176.224","4","256","2","128","2","128","95.068535000","120.4148","8.50","8.50"
"41.177.26.176","239.152.167.98","3","204","1","70","2","134","95.175105000","0.5077","N/A","2111.45"
"194.66.204.242","244.3.41.84","6","2660","3","233","3","2427","95.240704000","13.0562","142.77","1487.11"
"41.177.98.145","244.3.34.194","658","72940","280","41152","378","31788","95.572613000","44.9137","7329.97","5662.06"
"40.248.176.156","244.3.160.239","4816","3506899","2871","3231630","1945","275269","96.023120000","136.2660","189724.74","16160.68"
"15.68.47.117","244.3.210.197","47","39768","18","2859","29","36909","96.032587000","134.2502","170.37","2199.42"
"41.177.3.203","244.157.67.98","2","188","1","94","1","94","96.327104000","0.0003","N/A","N/A"
"215.160.91.82","244.3.210.197","131","90678","66","10589","65","80089","96.349436000","10.7426","7885.62","59642.22"
"41.177.241.176","41.177.241.253","3","741","0","0","3","741","97.007215000","0.0002","N/A","36592592.59"
"244.3.41.85","244.3.41.208","2","494","0","0","2","494","97.075927000","0.0002","N/A","17642857.14"
"68.164.185.120","244.3.210.197","153","123015","62","11719","91","111296","97.173017000","119.7000","783.22","7438.33"
"41.177.98.127","194.168.141.39","45","3676","21","1655","24","2021","97.435923000","88.6196","149.40","182.44"
"244.3.160.239","244.176.48.167","274","110751","149","28495","125","82256","97.489632000","26.1907","8703.86","25125.29"
"91.91.91.91","246.142.202.157","1","346","0","0","1","346","97.633585000","0.0000","N/A","N/A"
"41.177.98.220","41.177.225.164","2242","741629","1183","609430","1059","132199","98.599965000","127.2887","38302.22","8308.61"
"41.177.26.176","77.197.128.47","683","419175","402","390915","281","28260","98.636304000","58.5564","53407.01","3860.90"
"41.177.98.143","194.31.194.116","3","298","1","140","2","158","99.021838000","0.1326","N/A","9529.91"
"41.177.3.215","244.3.210.95","26","4734","16","2744","10","1990","99.706479000","120.6045","182.02","132.00"
"41.177.26.176","77.197.128.72","294","190873","174","179023","120","11850","99.983964000","121.9148","11747.42","777.59"
"244.3.153.252","244.3.202.202","34","5847","17","1536","17","4311","100.157870000","69.2696","177.39","497.88"
"244.3.31.24","244.3.153.142","2","132","1","68","1","64","100.240662000","0.2829","N/A","N/A"
"188.68.211.24","244.3.160.239","44","29709","27","27071","17","2638","100.242880000","3.5512","60984.99","5942.83"
"41.177.26.15","77.197.210.164","34","26516","20","25317","14","1199","100.457118000","0.7514","269549.87","12765.74"
"41.177.26.209","244.3.160.254","2","280","0","0","2","280","100.464834000","0.0001","N/A","37966101.69"
"41.177.26.91","77.197.210.241","48","40323","30","38538","18","1785","100.553434000","4.2060","73300.63","3395.13"
"41.177.26.176","77.197.128.118","1468","898040","880","838716","588","59324","100.608758000","118.8580","56451.62","3992.93"
"41.177.230.130","244.3.153.77","24","2628","0","0","24","2628","100.611702000","132.0000","N/A","159.27"
"41.177.26.176","77.197.128.223","1299","795897","767","742314","532","53583","100.761229000","133.6923","44419.25","3206.35"
"41.177.98.176","198.98.203.67","10","1260","4","421","6","839","101.057903000","19.5610","172.18","343.13"
"41.177.218.48","41.177.218.119","1","96","0","0","1","96","101.193249000","0.0000","N/A","N/A"
"41.177.98.31","41.177.108.224","6","564","3","282","3","282","101.282849000","113.9957","19.79","19.79"
"41.177.26.15","77.197.210.103","198","177864","125","172533","73","5331","101.288465000","6.3386","217755.31","6728.30"
"90.218.193.20","244.3.160.239","909","572727","324","52944","585","519783","101.329511000","97.4139","4347.96","42686.55"
"41.177.26.91","77.197.210.110","49","40582","30","38688","19","1894","101.726479000","7.3734","41975.53","2054.94"
"41.177.26.91","77.197.210.136","67","50793","39","48176","28","2617","101.769905000","10.3418","37266.94","2024.40"
"41.177.135.193","244.3.160.239","423","242534","169","27643","254","214891","101.821022000","51.3271","4308.52","33493.59"
"41.177.3.176","210.218.218.3","2","128","2","128","0","0","101.829568000","0.0005","2064516.13","N/A"
"41.177.3.156","210.218.218.3","2","128","2","128","0","0","101.829609000","0.0005","2106995.88","N/A"
"81.67.210.81","244.3.160.239","24","5976","11","3508","13","2468","101.876128000","0.7923","35418.87","24918.41"
"41.177.26.15","77.197.128.139","547","527115","367","514687","180","12428","102.005047000","12.2543","336004.84","8113.41"
"41.177.202.202","244.3.153.39","6","989","3","720","3","269","102.045701000","66.6978","86.36","32.26"
"244.3.31.251","244.3.153.13","18","2052","0","0","18","2052","102.162792000","132.0017","N/A","124.36"
"41.177.26.15","77.197.210.48","354","378977","264","372913","90","6064","102.243015000","1.8829","1584438.29","25764.81"
"41.177.98.127","128.181.211.197","15","1273","7","581","8","692","102.244038000","1.7601","2640.78","3145.30"
"41.177.26.15","77.197.128.142","345","316531","226","307287","119","9244","102.374670000","16.6501","147644.57","4441.54"
"41.177.26.176","77.197.128.13","2166","1284235","1254","1193815","912","90420","102.452391000","132.0254","72338.53","5478.95"
"41.177.26.176","77.197.128.224","1210","760619","726","711598","484","49021","102.534050000","116.3797","48915.62","3369.73"
"81.67.210.26","244.3.160.239","200","116877","111","98556","89","18321","102.636402000","49.6852","15868.87","2949.93"
"177.71.203.41","244.3.210.197","1956","1809401","702","96577","1254","1712824","102.647386000","72.2014","10700.85","189782.92"
"41.177.26.176","77.197.128.55","1035","625092","616","582642","419","42450","102.738202000","131.6613","35402.46","2579.34"
"41.177.26.91","77.197.210.218","21","17145","13","16329","8","816","102.771950000","0.4090","319366.31","15959.51"
"253.37.253.43","253.180.253.142","10","8879","10","8879","0","0","102.812736000","73.9636","960.36","N/A"
"16.225.66.90","41.177.26.176","229","117720","100","14357","129","103363","102.835927000","126.4183","908.54","6541.02"
"48.244.145.177","244.3.210.197","287","223385","128","43340","159","180045","102.956188000","70.0350","4950.67","20566.29"
"68.224.84.106","244.3.210.197","49","39880","19","1621","30","38259","103.425248000","61.1354","212.12","5006.46"
"244.3.153.34","244.3.202.202","30","4164","15","1275","15","2889","103.761180000","73.1482","139.44","315.96"
"253.37.253.43","253.160.31.248","77","59502","77","59502","0","0","104.072891000","0.6552","726541.22","N/A"
"41.177.26.176","77.197.128.92","371","214026","222","199105","149","14921","104.234227000","125.1533","12727.11","953.77"
"122.145.57.132","244.3.210.197","198","139170","96","34791","102","104379","104.260899000","69.5189","4003.63","12011.58"
"41.177.26.91","77.197.210.198","22","17735","14","16911","8","824","104.392439000","0.4159","325285.82","15849.77"
"41.177.26.176","77.197.128.46","867","521526","512","485840","355","35686","104.432393000","53.9919","71987.14","5287.61"
"41.177.98.143","153.103.26.253","4","362","2","204","2","158","104.610815000","0.1730","9434.83","7307.37"
"41.151.113.41","244.3.210.197","1156","981102","432","56180","724","924922","104.949207000","4.5473","98837.24","1627211.38"
"41.177.98.220","244.3.164.138","49","14327","22","11546","27","2781","105.099729000","109.8252","841.05","202.58"
"244.3.41.71","244.3.41.91","4","1014","4","1014","0","0","105.631205000","0.0002","44817679.56","N/A"
"41.177.26.91","154.176.214.143","2922","3015278","1966","2952269","956","63009","105.796040000","112.4832","209970.43","4481.31"
"253.37.253.43","253.201.253.231","4","3771","4","3771","0","0","105.844968000","17.0403","1770.39","N/A"
"41.177.26.176","77.197.128.108","113","64849","67","60133","46","4716","105.876740000","115.2687","4173.41","327.30"
"253.37.253.167","253.94.153.215","158","14928","66","7024","92","7904","106.008242000","124.8550","450.06","506.44"
"41.177.24.241","244.3.153.55","70","16975","36","7759","34","9216","106.568890000","0.7054","87997.09","104521.35"
"41.177.26.176","77.197.128.150","87","49355","52","45851","35","3504","106.842884000","115.6245","3172.41","242.44"
"41.177.98.98","41.177.230.31","2","188","1","94","1","94","107.680979000","0.0001","N/A","N/A"
"41.177.26.176","244.157.156.98","4","376","2","188","2","188","108.294311000","90.0003","16.71","16.71"
"244.3.31.251","244.3.153.239","12","1368","0","0","12","1368","108.926454000","122.9978","N/A","88.98"
"244.3.4.177","244.3.41.91","3","741","3","741","0","0","108.957775000","0.0006","9320754.72","N/A"
"244.3.202.41","244.3.202.235","1","247","1","247","0","0","108.957895000","0.0000","N/A","N/A"
"41.177.26.176","77.197.128.117","39","25922","23","24274","16","1648","109.464265000","23.5999","8228.52","558.65"
"41.177.46.26","41.177.46.91","12","1720","12","1720","0","0","109.547874000","54.0042","254.80","N/A"
"122.168.72.208","244.3.160.239","9","2694","3","1441","6","1253","109.716944000","0.1359","84825.21","73758.49"
"41.177.161.3","41.177.161.91","9","864","9","864","0","0","110.200671000","1.4998","4608.64","N/A"
"41.177.230.224","253.37.253.167","2","204","1","102","1","102","110.806638000","0.0002","N/A","N/A"
"41.177.98.79","68.157.168.46","16","6240","7","5329","9","911","111.330413000","4.9308","8646.12","1478.07"
"145.95.176.246","244.3.160.239","224","90779","99","20839","125","69940","111.611777000","3.0052","55475.34","186186.74"
"77.91.159.163","244.3.160.239","26","5012","11","1044","15","3968","111.993118000","7.4366","1123.09","4268.60"
"244.3.153.91","244.3.153.235","3","741","0","0","3","741","112.417838000","0.0002","N/A","38000000.00"
"41.177.26.176","149.214.94.34","25","12091","12","10559","13","1532","112.797605000","1.7317","48779.95","7077.46"
"15.71.149.111","41.177.26.46","597","625741","166","12645","431","613096","112.885721000","4.7789","21168.03","1026337.20"
"18.181.90.197","41.177.98.176","358","249123","158","30507","200","218616","113.390120000","96.2578","2535.44","18169.22"
"41.177.26.91","66.163.119.41","649","641198","426","625273","223","15925","113.428616000","2.9875","1674364.49","42644.18"
"41.177.98.176","145.95.149.185","62","46811","38","42469","24","4342","113.817710000","22.3746","15184.75","1552.48"
"41.177.98.143","241.192.102.239","3","298","1","140","2","158","114.033467000","0.1871","N/A","6756.68"
"117.218.106.199","244.3.210.197","529","358726","249","95308","280","263418","114.622806000","55.6284","13706.37","37882.50"
"209.244.18.90","244.3.210.197","48","39971","18","3078","30","36893","114.854149000","57.9717","424.76","5091.17"
"41.177.98.176","151.77.151.91","175","145045","111","135876","64","9169","115.584002000","52.4272","20733.65","1399.12"
"41.177.26.211","244.3.160.254","62","5180","30","2746","32","2434","115.834237000","0.8613","25506.96","22608.87"
"40.248.176.176","244.3.160.239","24","6039","11","2461","13","3578","117.791000000","18.6619","1054.98","1533.82"
"41.177.26.176","77.197.127.110","92","56748","54","52756","38","3992","117.820055000","13.9374","30281.59","2291.38"
"41.177.98.127","68.122.210.16","14","1158","7","529","7","629","117.841132000","1.8256","2318.08","2756.28"
"41.177.13.251","244.3.41.84","73","15887","42","4706","31","11181","118.048685000","33.6683","1118.20","2656.75"
"41.177.98.143","244.160.201.209","3","298","1","140","2","158","118.285956000","0.2186","N/A","5782.33"
"253.37.253.43","253.213.253.214","6","3362","6","3362","0","0","119.013808000","10.1451","2651.12","N/A"
"168.22.164.224","244.3.160.239","12","2734","6","2161","6","573","119.173227000","0.2007","86145.38","22841.88"
"151.72.95.110","244.3.210.197","6","384","0","0","6","384","120.282358000","0.0000","N/A","65361702.13"
"41.177.230.252","244.3.153.48","2","128","1","64","1","64","120.976546000","0.0947","N/A","N/A"
"41.177.230.119","244.3.153.48","2","128","1","64","1","64","120.976551000","0.0949","N/A","N/A"
"244.3.160.239","244.176.48.13","60","9711","30","5589","30","4122","121.094285000","2.0739","21559.22","15900.36"
"41.177.3.91","41.177.3.145","2","244","0","0","2","244","121.098805000","0.0001","N/A","33084745.76"
"244.3.39.102","244.3.39.235","2","494","2","494","0","0","121.145720000","0.0002","23384615.38","N/A"
"244.3.39.95","244.3.39.235","2","494","2","494","0","0","121.145894000","0.0001","27068493.15","N/A"
"244.3.39.61","244.3.39.235","2","494","2","494","0","0","121.145999000","0.0001","26346666.67","N/A"
"41.177.127.194","253.37.253.43","2","174","0","0","2","174","121.196374000","0.0036","N/A","386237.51"
"41.177.71.0","253.37.253.43","3","238","0","0","3","238","121.196523000","0.2849","N/A","6682.11"
"94.2.202.98","244.3.160.239","30","6345","12","2828","18","3517","121.609489000","42.8703","527.73","656.31"
"41.177.98.127","241.16.181.164","14","1145","8","622","6","523","121.768315000","37.5940","132.36","111.29"
"41.177.230.15","41.177.230.117","1","97","1","97","0","0","122.538399000","0.0000","N/A","N/A"
"41.177.98.98","244.3.202.202","16","1408","8","704","8","704","122.905307000","0.9268","6076.78","6076.78"
"41.177.98.142","209.71.102.241","2","128","0","0","2","128","122.994643000","0.0003","N/A","3190031.15"
"244.3.164.108","244.3.164.161","12","1152","12","1152","0","0","123.228014000","1.5397","5985.77","N/A"
"41.177.98.43","244.157.67.98","2","188","1","94","1","94","123.549657000","0.0003","N/A","N/A"
"210.218.218.3","244.3.164.51","2","128","0","0","2","128","123.645720000","0.0004","N/A","2797814.21"
"41.177.116.91","41.177.116.198","1","247","0","0","1","247","123.837636000","0.0000","N/A","N/A"
"253.37.253.43","253.213.108.229","16","14053","16","14053","0","0","124.192791000","45.9998","2444.01","N/A"
"210.218.218.164","244.3.47.229","4","256","0","0","4","256","124.303582000","59.5209","N/A","34.41"
"253.37.253.43","253.213.108.31","13","2628","13","2628","0","0","124.348750000","0.0342","615474.69","N/A"
"41.177.98.143","244.239.193.215","3","298","1","140","2","158","124.916752000","0.1554","N/A","8132.64"
"253.37.253.43","253.116.185.77","11","1767","11","1767","0","0","125.271847000","0.2476","57085.40","N/A"
"40.193.220.98","244.3.210.197","1","64","0","0","1","64","125.282328000","0.0000","N/A","N/A"
"253.37.253.43","253.116.185.84","11","1744","11","1744","0","0","125.283768000","0.3178","43898.37","N/A"
"253.37.253.43","253.213.108.167","11","1670","11","1670","0","0","125.292939000","0.0375","355962.91","N/A"
"253.37.253.43","253.77.108.145","11","1767","11","1767","0","0","125.301823000","0.3140","45019.97","N/A"
"253.37.253.43","253.142.160.113","11","1670","11","1670","0","0","125.309875000","0.0505","264554.46","N/A"
"253.37.253.43","253.205.160.160","11","1647","11","1647","0","0","125.333979000","0.0255","517172.35","N/A"
"18.40.188.181","244.3.61.106","2","132","2","132","0","0","125.371721000","2.9514","357.79","N/A"
"122.188.116.253","244.3.210.197","30","23348","13","2229","17","21119","125.389767000","1.1338","15727.00","149007.89"
"244.3.202.89","244.3.202.235","1","247","1","247","0","0","125.391655000","0.0000","N/A","N/A"
"244.3.4.122","244.3.41.91","3","741","3","741","0","0","125.720580000","0.0006","9409523.81","N/A"
"244.3.202.235","244.3.202.241","1","247","0","0","1","247","125.720691000","0.0000","N/A","N/A"
"41.177.98.143","41.194.224.218","3","298","1","140","2","158","125.838339000","0.1561","N/A","8099.60"
"244.3.31.251","244.3.153.25","15","1548","0","0","15","1548","126.164079000","80.1352","N/A","154.54"
"41.177.116.184","253.37.253.43","1","64","0","0","1","64","126.190203000","0.0000","N/A","N/A"
"41.177.98.98","244.3.31.41","2","128","1","64","1","64","126.297621000","0.0001","N/A","N/A"
"244.3.40.203","244.3.124.91","4","988","4","988","0","0","126.670673000","15.9978","494.07","N/A"
"41.177.31.176","41.177.31.197","4","988","0","0","4","988","126.671568000","15.9980","N/A","494.06"
"90.108.47.67","244.3.210.197","364","261809","164","52565","200","209244","127.265898000","78.1765","5379.11","21412.47"
"33.64.77.46","41.177.230.55","1","66","1","66","0","0","127.354262000","0.0000","N/A","N/A"
"41.177.26.176","224.47.38.154","31","16450","14","13558","17","2892","127.435797000","89.0716","1217.72","259.75"
"241.122.106.43","244.3.210.197","1019","749288","538","61986","481","687302","127.807739000","59.5918","8321.41","92267.94"
"151.241.241.198","244.3.160.239","202","169001","126","161045","76","7956","127.865315000","1.2943","995372.96","49173.75"
"193.90.39.90","244.3.61.142","2","132","2","132","0","0","128.216757000","2.9905","353.12","N/A"
"41.177.4.43","41.177.4.91","1","261","1","261","0","0","128.232199000","0.0000","N/A","N/A"
"253.37.253.121","253.160.108.83","30","15525","17","5683","13","9842","128.350022000","7.2109","6304.92","10919.06"
"253.37.253.43","253.142.253.66","26","11062","26","11062","0","0","128.566988000","51.0645","1733.02","N/A"
"253.37.253.43","253.142.253.210","6","4904","6","4904","0","0","129.024854000","7.6306","5141.43","N/A"
"41.177.26.176","77.197.128.18","2221","1321376","1316","1231254","905","90122","129.030052000","105.3676","93482.56","6842.48"
"77.197.128.12","244.3.210.197","22","16114","10","964","12","15150","129.051648000","0.8799","8764.39","137739.17"
"41.177.26.176","77.197.210.82","878","531366","524","495314","354","36052","129.307807000","61.1399","64810.60","4717.31"
"77.197.210.231","244.3.210.197","27","20309","12","1120","15","19189","129.775165000","1.0863","8248.18","141316.40"
"41.177.98.3","41.225.241.128","6","435","0","0","6","435","130.352677000","10.5240","N/A","330.67"
"253.37.253.251","253.160.108.127","21","4738","11","2160","10","2578","130.374726000","9.2554","1867.01","2228.31"
"41.177.26.91","77.197.128.167","22","17311","13","16426","9","885","130.443147000","0.4157","316107.26","17031.23"
"41.177.26.176","77.197.128.41","1517","919464","898","856674","619","62790","130.501234000","103.4549","66245.20","4855.45"
"41.177.26.15","77.197.210.106","37","30634","23","29435","14","1199","130.721572000","0.9776","240867.98","9811.47"
"244.3.31.251","244.3.153.156","9","1026","0","0","9","1026","131.259377000","11.9992","N/A","684.05"
"90.55.40.204","244.3.160.239","20","4026","10","2103","10","1923","131.265441000","0.1240","135636.95","124027.51"
"41.177.98.127","144.154.4.18","5","322","2","128","3","194","131.692269000","0.0803","12750.59","19325.12"
"41.177.3.81","41.177.106.139","1","102","1","102","0","0","131.849538000","0.0000","N/A","N/A"
"41.177.26.91","77.197.128.143","67","54283","42","51737","25","2546","132.551463000","10.2301","40458.73","1990.99"
"41.177.26.91","77.197.210.81","42","35440","27","33873","15","1567","132.605478000","8.3115","32603.34","1508.26"
"41.177.26.23","41.177.176.254","1","78","0","0","1","78","132.788307000","0.0000","N/A","N/A"
"41.177.26.176","79.108.222.84","7","460","3","198","4","262","133.092899000","0.5761","2749.36","3638.04"
"253.37.253.43","253.160.108.241","188","108191","188","108191","0","0","133.163069000","49.3874","17525.30","N/A"
"41.177.26.91","242.13.197.91","24","14399","12","13197","12","1202","133.551305000","0.3225","327399.93","29820.01"
"91.91.91.91","244.3.31.34","18","1152","0","0","18","1152","133.792277000","0.1252","N/A","73634.93"
"244.3.210.91","244.3.210.241","2","494","0","0","2","494","133.880342000","0.0002","N/A","23807228.92"
"41.177.26.91","77.197.210.2","43","31260","24","29421","19","1839","133.905692000","12.2041","19286.02","1205.50"
"41.177.98.31","41.177.202.202","8","1326","4","352","4","974","134.369886000","0.1622","17359.78","48035.31"
"244.3.210.90","244.3.210.176","36","3456","36","3456","0","0","134.593051000","3.0150","9170.11","N/A"
"203.210.244.128","244.3.210.197","148","119116","63","28849","85","90267","135.054215000","71.1212","3245.05","10153.60"
"41.177.26.15","77.197.128.211","371","358368","253","349829","118","8539","135.124932000","14.1675","197538.60","4821.73"
"41.177.98.127","83.202.121.77","28","2318","14","1062","14","1256","135.174026000","2.0186","4208.95","4977.82"
"244.3.153.25","244.3.153.91","36","3456","36","3456","0","0","135.174067000","6.5886","4196.33","N/A"
"165.33.138.84","244.3.210.197","665","596798","263","45628","402","551170","135.265531000","17.8401","20460.83","247159.56"
"41.177.26.176","95.34.105.67","163","97203","104","87692","59","9511","136.647414000","20.2020","34726.10","3766.36"
"41.177.98.220","244.3.142.106","1190","984291","756","949227","434","35064","137.170821000","89.5648","84785.68","3131.94"
"253.37.253.43","253.176.160.57","45","23386","45","23386","0","0","137.206857000","10.9578","17073.54","N/A"
"41.177.98.142","209.57.198.106","17","8914","9","8143","8","771","137.463553000","17.4096","3741.85","354.29"
"253.37.253.43","253.108.164.75","17","17077","17","17077","0","0","137.752168000","18.1923","7509.54","N/A"
"41.177.230.253","244.3.31.40","4523","2222651","2065","407892","2458","1814759","137.861557000","56.9170","57331.49","255074.47"
"41.177.93.199","244.3.41.84","16","6500","8","711","8","5789","138.215547000","17.8497","318.66","2594.55"
"41.177.26.91","77.197.128.47","26","19921","15","18908","11","1013","138.311293000","0.5030","300702.73","16110.21"
"15.71.149.89","244.3.210.197","179","139867","84","6112","95","133755","139.360013000","1.5073","32438.82","709891.00"
"41.177.3.18","244.3.153.30","52","7793","25","4724","27","3069","139.732666000","60.3279","626.44","406.98"
"244.3.160.239","244.3.164.46","877","337841","486","268372","391","69469","139.766890000","16.2761","131910.06","34145.36"
"92.188.204.180","244.3.160.239","295","79082","138","53340","157","25742","139.792594000","5.0710","84149.73","40610.84"
"253.37.253.43","253.213.108.40","3","1110","3","1110","0","0","139.833264000","3.4997","2537.33","N/A"
"41.13.93.230","244.3.210.197","773","658534","275","36878","498","621656","139.879895000","34.4105","8573.67","144527.19"
"244.3.210.91","244.3.210.225","2","494","0","0","2","494","140.010935000","0.0023","N/A","1689610.94"
"41.177.26.46","223.198.244.193","94","72509","53","69004","41","3505","140.359349000","22.0301","25058.04","1272.80"
"253.37.253.43","253.160.128.224","11","1532","11","1532","0","0","141.059929000","0.2521","48618.91","N/A"
"225.176.139.18","244.3.210.197","1","64","1","64","0","0","141.216988000","0.0000","N/A","N/A"
"41.177.98.176","244.3.177.130","121","82685","73","73909","48","8776","141.793725000","81.9504","7215.00","856.71"
"41.177.98.176","241.82.68.241","455","367394","270","335037","185","32357","143.210477000","51.4077","52137.98","5035.35"
"41.177.218.48","41.177.218.222","1","247","0","0","1","247","143.219883000","0.0000","N/A","N/A"
"41.177.161.91","41.177.161.193","3","741","0","0","3","741","143.220000000","0.0010","N/A","5963782.70"
"253.37.253.43","253.213.108.30","22","20132","22","20132","0","0","143.508399000","90.4697","1780.22","N/A"
"223.75.41.154","244.3.41.120","1","66","1","66","0","0","143.919414000","0.0000","N/A","N/A"
"41.177.98.143","244.56.202.204","3","298","1","140","2","158","144.130401000","0.1834","N/A","6892.87"
"244.3.210.91","244.3.210.203","2","192","0","0","2","192","144.536912000","0.0002","N/A","10172185.43"
"244.3.153.91","244.3.153.111","45","5436","0","0","45","5436","144.910335000","23.2605","N/A","1869.60"
"244.3.31.251","244.3.153.111","3","288","0","0","3","288","144.910740000","2.9989","N/A","768.27"
"244.3.153.34","244.3.153.91","60","6744","60","6744","0","0","145.825824000","64.6350","834.72","N/A"
"253.37.253.43","253.142.108.39","8","5448","8","5448","0","0","146.253789000","74.0344","588.70","N/A"
"41.177.26.176","204.41.197.117","121","69026","66","61881","55","7145","146.265230000","84.1467","5883.15","679.29"
"41.177.26.176","77.197.127.164","12","4941","6","4252","6","689","146.603742000","0.5499","61859.53","10023.80"
"41.177.98.143","224.47.199.136","3","298","1","140","2","158","146.683589000","0.2214","N/A","5707.83"
"41.177.98.142","90.117.252.64","17","8922","9","8143","8","779","147.696918000","17.5906","3703.34","354.28"
"41.177.98.220","244.3.79.163","95","64955","53","61178","42","3777","147.737584000","81.6806","5991.92","369.93"
"244.3.39.235","244.3.39.241","2","494","0","0","2","494","149.668190000","0.0002","N/A","24700000.00"
"41.177.24.241","244.3.153.77","120","38765","68","34328","52","4437","150.121086000","3.2697","83990.35","10856.01"
"41.177.98.176","151.77.205.22","615","477529","354","426717","261","50812","152.381747000","72.8829","46838.66","5577.39"
"81.67.217.159","244.3.160.239","102","108952","79","106443","23","2509","152.406431000","0.7778","1094860.27","25807.28"
"244.3.41.84","244.3.47.24","4","256","2","128","2","128","153.455103000","0.3407","3005.85","3005.85"
"194.66.204.4","244.3.41.84","5","320","2","128","3","192","153.455910000","0.3024","3386.30","5079.45"
"244.3.41.84","244.3.167.79","5","359","2","146","3","213","153.456417000","0.0147","79283.19","115666.58"
"41.177.142.167","244.3.41.84","4","256","2","128","2","128","153.456781000","0.1702","6014.75","6014.75"
"41.177.93.23","244.3.41.84","4","256","2","128","2","128","153.457478000","0.2192","4672.07","4672.07"
"244.3.34.145","244.3.41.84","4","256","2","128","2","128","153.458284000","0.1584","6463.91","6463.91"
"41.177.43.106","244.3.41.84","4","256","2","128","2","128","153.458612000","0.1278","8010.76","8010.76"
"244.3.34.121","244.3.41.84","4","256","2","128","2","128","153.458972000","0.1585","6458.65","6458.65"
"194.66.108.214","244.3.41.84","10","3060","4","274","6","2786","153.459483000","59.8337","36.63","372.50"
"244.3.41.84","244.3.161.161","4","256","2","128","2","128","153.460037000","0.1264","8101.33","8101.33"
"194.66.220.177","244.3.41.84","5","320","2","128","3","192","153.460733000","0.2978","3438.26","5157.39"
"244.3.41.84","244.3.92.253","5","359","2","146","3","213","153.460986000","0.0112","104072.00","151831.06"
"41.177.142.244","244.3.41.84","4","256","2","128","2","128","153.461156000","0.2114","4844.81","4844.81"
"41.177.13.193","244.3.41.84","4","256","2","128","2","128","153.461290000","0.1861","5502.09","5502.09"
"244.3.41.84","244.3.77.218","4","256","2","128","2","128","153.461667000","0.2053","4987.36","4987.36"
"47.167.92.130","244.3.41.84","4","256","2","128","2","128","153.461979000","0.2296","4460.30","4460.30"
"41.177.159.241","244.3.41.84","4","256","2","128","2","128","153.462486000","0.1454","7044.53","7044.53"
"203.22.116.244","244.3.41.84","5","320","2","128","3","192","153.463288000","0.2941","3482.00","5223.00"
"41.177.181.145","244.3.41.84","4","256","2","128","2","128","153.463603000","0.2113","4846.10","4846.10"
"41.177.103.151","244.3.41.84","4","289","2","143","2","146","153.463993000","0.1489","7683.83","7845.03"
"41.177.150.71","244.3.41.84","4","256","2","128","2","128","153.464420000","0.1353","7569.21","7569.21"
"47.167.92.164","244.3.41.84","4","256","2","128","2","128","153.464731000","0.1311","7813.51","7813.51"
"194.66.204.151","244.3.41.84","5","320","2","128","3","192","153.465167000","0.2927","3498.51","5247.77"
"244.3.41.84","244.3.106.12","3","192","2","128","1","64","153.466048000","0.2924","3502.24","N/A"
"194.66.204.46","244.3.41.84","5","362","2","146","3","216","153.466418000","0.2917","4004.07","5923.83"
"41.177.100.56","244.3.41.84","4","256","2","128","2","128","153.466801000","0.1798","5696.64","5696.64"
"41.177.161.111","244.3.41.84","4","256","2","128","2","128","153.467487000","0.2109","4855.57","4855.57"
"41.177.181.38","244.3.41.84","4","256","2","128","2","128","153.468292000","0.2002","5114.94","5114.94"
"47.167.26.34","244.3.41.84","4","256","2","128","2","128","153.468613000","0.1868","5482.86","5482.86"
"244.3.20.25","244.3.41.84","4","256","2","128","2","128","153.468984000","0.2119","4832.10","4832.10"
"203.22.57.0","244.3.41.84","5","320","2","128","3","192","153.469740000","0.2874","3562.42","5343.63"
"244.3.41.84","244.3.149.55","4","256","2","128","2","128","153.470116000","0.2162","4735.79","4735.79"
"41.177.43.119","244.3.41.84","4","256","2","128","2","128","153.470487000","0.1979","5173.26","5173.26"
"194.66.143.80","244.3.41.84","5","320","2","128","3","192","153.470983000","0.2866","3573.27","5359.91"
"41.177.142.84","244.3.41.84","4","289","2","143","2","146","153.471672000","0.0172","66639.48","68037.51"
"41.177.242.152","244.3.41.84","2","128","2","128","0","0","153.471808000","0.2599","3939.70","N/A"
"244.3.41.84","244.3.41.161","4","256","2","128","2","128","153.472048000","0.1225","8356.93","8356.93"
"41.177.64.0","244.3.41.84","4","256","2","128","2","128","153.473048000","0.1739","5888.58","5888.58"
"41.177.93.235","244.3.41.84","4","256","2","128","2","128","153.473552000","0.1381","7414.43","7414.43"
"41.177.136.15","244.3.41.84","4","256","2","128","2","128","153.473926000","0.1304","7851.62","7851.62"
"47.124.77.164","244.3.41.84","4","256","2","128","2","128","153.474991000","0.2452","4175.59","4175.59"
"41.177.72.67","244.3.41.84","4","256","2","128","2","128","153.475556000","0.2204","4645.85","4645.85"
"41.197.164.55","244.3.41.84","4","256","2","128","2","128","153.476110000","0.1442","7103.51","7103.51"
"244.3.41.84","244.3.241.123","4","256","2","128","2","128","153.476493000","0.1389","7374.07","7374.07"
"41.177.181.208","244.3.41.84","4","256","2","128","2","128","153.476924000","0.2139","4788.22","4788.22"
"41.177.93.34","244.3.41.84","4","256","2","128","2","128","153.477381000","0.1458","7023.27","7023.27"
"41.177.142.26","244.3.41.84","4","256","2","128","2","128","153.477616000","0.2129","4809.68","4809.68"
"244.3.41.84","244.3.235.84","4","256","2","128","2","128","153.478305000","0.1412","7252.79","7252.79"
"41.177.37.102","244.3.41.84","4","256","2","128","2","128","153.478555000","0.1574","6506.54","6506.54"
"41.177.142.91","244.3.41.84","4","256","2","128","2","128","153.479060000","0.1865","5490.32","5490.32"
"94.145.155.113","244.3.41.84","5","320","2","128","3","192","153.479617000","0.2772","3694.23","5541.35"
"41.197.164.47","244.3.41.84","4","256","2","128","2","128","153.480061000","0.1968","5202.01","5202.01"
"194.66.204.159","244.3.41.84","5","320","2","128","3","192","153.480308000","0.2774","3691.74","5537.61"
"194.66.13.193","244.3.41.84","5","362","2","146","3","216","153.480874000","0.2761","4229.97","6258.04"
"244.3.41.84","244.3.77.160","4","256","2","128","2","128","153.481432000","0.1577","6494.66","6494.66"
"41.177.90.57","244.3.41.84","4","256","2","128","2","128","153.481624000","0.1646","6221.52","6221.52"
"145.95.75.108","244.3.41.84","4","256","2","128","2","128","153.482061000","0.1915","5347.48","5347.48"
"244.3.41.84","244.3.47.26","4","256","2","128","2","128","153.482995000","0.3171","3229.55","3229.55"
"41.177.242.231","244.3.41.84","2","128","2","128","0","0","153.483322000","0.1816","5638.83","N/A"
"224.143.111.111","244.3.41.84","5","320","2","128","3","192","153.483825000","0.2729","3752.80","5629.20"
"244.3.41.84","244.3.157.123","4","256","2","128","2","128","153.484363000","0.1335","7669.89","7669.89"
"244.3.153.91","244.3.153.156","3","741","0","0","3","741","154.493154000","0.0002","N/A","37518987.34"
"244.3.31.251","244.3.153.77","6","576","0","0","6","576","154.681574000","62.1079","N/A","74.19"
"15.225.98.142","41.177.98.142","21","9188","12","1041","9","8147","155.096958000","20.1287","413.74","3237.96"
"48.90.252.46","244.3.210.197","997","743312","485","61859","512","681453","155.221901000","59.5110","8315.64","91607.00"
"253.37.253.43","253.213.108.230","3","194","3","194","0","0","155.448296000","0.1158","13399.29","N/A"
"41.177.24.241","244.3.153.22","19","5132","10","3126","9","2006","155.509124000","0.7772","32177.13","20648.53"
"91.91.91.91","244.3.39.71","4","1002","0","0","4","1002","155.912718000","0.0002","N/A","32987654.32"
"41.177.155.193","215.108.241.38","1","64","0","0","1","64","156.349536000","0.0000","N/A","N/A"
"41.177.26.91","151.43.219.4","23","10112","11","8705","12","1407","156.645679000","9.0081","7730.86","1249.55"
"41.177.98.197","244.3.185.120","201","38162","100","21044","101","17118","156.786128000","0.4994","337103.13","274212.67"
"41.177.98.127","197.193.211.106","28","2320","14","1060","14","1260","157.120348000","36.3239","233.45","277.50"
"122.155.141.12","244.3.160.239","238","137704","100","17006","138","120698","158.181962000","2.4538","55442.76","393498.21"
"41.177.211.185","244.3.160.239","2469","1152990","1036","204400","1433","948590","158.350084000","52.0474","31417.53","145804.10"
"244.3.153.22","244.3.153.91","45","5436","45","5436","0","0","158.716614000","23.2606","1869.60","N/A"
"77.197.128.153","244.3.210.197","22","16142","10","968","12","15174","159.061689000","0.8565","9041.28","141727.65"
"77.197.210.128","244.3.210.197","68","54618","27","2275","41","52343","159.217618000","7.2548","2508.69","57719.75"
"244.3.202.202","244.3.210.197","8","1628","4","1268","4","360","159.352688000","6.5144","1557.15","442.09"
"41.177.26.91","77.197.210.202","19","15142","12","14367","7","775","159.479410000","0.4697","244702.96","13200.03"
"244.3.41.81","244.3.41.91","42","4298","42","4298","0","0","159.490452000","4.0016","8592.61","N/A"
"41.177.3.77","41.177.3.91","12","1152","12","1152","0","0","159.500423000","31.9766","288.21","N/A"
"41.177.46.91","41.177.46.241","2","494","0","0","2","494","159.557533000","0.0002","N/A","19959595.96"
"41.177.26.91","77.197.217.218","22","17313","13","16433","9","880","160.209091000","0.4255","308963.57","16545.24"
"41.177.26.15","77.197.217.152","14","9337","8","8595","6","742","160.355535000","0.6745","101942.94","8800.66"
"41.177.26.91","100.176.176.67","893","1161782","763","1152096","130","9686","160.707388000","5.6144","1641631.85","13801.67"
"79.46.215.185","244.3.210.90","31","4539","13","1506","18","3033","160.890938000","2.1038","5726.91","11533.68"
"41.177.192.117","244.3.160.239","1809","1097096","693","82565","1116","1014531","161.112282000","16.9475","38974.55","478906.14"
"41.177.254.197","244.3.160.239","1512","1074733","890","995196","622","79537","161.183246000","16.4823","483037.59","38604.82"
"41.177.116.45","244.3.153.13","271","126434","155","104805","116","21629","161.461434000","51.9415","16142.01","3331.29"
"41.177.26.91","77.197.128.82","91","72959","56","69471","35","3488","161.716575000","13.0665","42533.79","2135.54"
"41.177.26.176","68.157.168.203","111","40386","55","35329","56","5057","161.803098000","63.9315","4420.85","632.80"
"41.177.98.220","244.3.142.41","478","91652","229","59972","249","31680","162.241007000","66.5240","7212.07","3809.75"
"145.95.48.71","244.3.41.13","4","325","2","151","2","174","162.626584000","0.2231","5415.39","6240.25"
"106.145.117.39","244.3.61.142","3","198","3","198","0","0","162.669732000","9.0772","174.50","N/A"
"41.177.26.15","77.197.210.159","7","1015","3","391","4","624","162.816803000","0.2052","15242.40","24325.47"
"41.177.230.130","244.3.153.22","3","288","0","0","3","288","163.216733000","2.9998","N/A","768.04"
"244.3.153.77","244.3.176.118","1078","472863","478","47557","600","425306","163.229006000","71.0472","5354.97","47889.96"
"41.177.98.143","241.75.202.251","11","4096","11","4096","0","0","163.418429000","69.1109","474.14","N/A"
"244.3.41.56","244.3.41.91","2","458","2","458","0","0","163.491782000","0.0002","22900000.00","N/A"
"244.3.41.91","244.3.41.224","4","916","0","0","4","916","163.491833000","0.0002","N/A","35921568.63"
"244.3.153.77","244.3.153.91","21","2469","21","2469","0","0","163.691880000","60.6086","325.89","N/A"
"41.177.98.142","244.157.156.98","2","188","1","94","1","94","164.130578000","0.0004","N/A","N/A"
"82.193.18.57","244.3.210.197","671","622093","255","32949","416","589144","164.483910000","7.6760","34339.87","614013.38"
"181.89.145.48","244.3.176.210","1","64","1","64","0","0","164.610460000","0.0000","N/A","N/A"
"41.177.26.176","239.152.13.68","7","460","3","198","4","262","164.653093000","0.5035","3146.19","4163.14"
"18.181.168.132","244.3.210.197","514","207193","279","69205","235","137988","165.161214000","47.3810","11684.85","23298.46"
"41.177.26.176","77.197.128.84","608","361134","355","336030","253","25104","165.599193000","43.8586","61293.30","4579.08"
"41.177.46.61","41.177.46.91","2","494","2","494","0","0","166.586234000","0.0001","26523489.93","N/A"
"244.3.41.26","244.3.41.91","12","1152","12","1152","0","0","166.956611000","1.3829","6664.06","N/A"
"41.177.98.220","244.3.185.176","42","16615","20","7750","22","8865","167.021301000","35.1961","1761.56","2014.99"
"41.177.98.127","194.252.160.64","15","1221","7","525","8","696","167.517475000","1.8027","2329.89","3088.77"
"41.177.26.176","165.22.155.38","2","128","1","64","1","64","167.557986000","0.0003","N/A","N/A"
"41.177.26.176","145.188.2.106","30","15019","15","12495","15","2524","167.570803000","15.2631","6549.11","1322.93"
"41.177.3.91","41.177.3.241","2","494","0","0","2","494","167.762075000","0.0002","N/A","19091787.44"
"41.177.64.33","244.3.41.84","68","17297","32","2547","36","14750","168.289358000","56.4482","360.97","2090.41"
"246.142.91.91","246.142.244.160","1","550","0","0","1","550","168.404355000","0.0000","N/A","N/A"
"41.177.230.91","41.177.230.156","4","2200","0","0","4","2200","168.404429000","0.0002","N/A","93617021.27"
"41.177.98.176","244.3.185.40","429","344677","261","311043","168","33634","169.082788000","59.3356","41936.81","4534.75"
"41.177.98.142","244.3.199.165","194","116369","112","96220","82","20149","169.519238000","60.5002","12723.27","2664.32"
"244.3.210.98","244.3.210.176","2","510","2","510","0","0","169.673510000","0.0000","815999997.42","N/A"
"244.3.31.124","244.3.34.248","23","3944","9","2291","14","1653","170.389605000","0.0261","702141.52","506608.44"
"41.177.98.143","244.56.202.67","76","16192","36","12092","40","4100","170.623826000","54.8676","1763.08","597.80"
"41.177.98.143","203.25.39.39","3","328","1","152","2","176","170.729110000","0.1354","N/A","10401.89"
"253.37.253.43","253.160.211.176","2","128","2","128","0","0","171.138594000","0.1003","10208.76","N/A"
"41.177.3.91","41.177.3.215","10","1226","0","0","10","1226","171.793045000","4.0209","N/A","2439.28"
"41.177.26.210","244.3.34.194","834","93980","341","47576","493","46404","172.082897000","57.3792","6633.20","6469.80"
"246.142.244.138","246.142.244.205","2","362","1","298","1","64","172.474484000","0.0018","N/A","N/A"
"41.177.98.210","41.177.202.202","2","340","1","91","1","249","172.497908000","0.0002","N/A","N/A"
"41.177.26.210","41.177.202.202","2","340","1","91","1","249","172.558804000","0.0002","N/A","N/A"
"41.177.3.117","244.3.153.40","35","5183","16","2414","19","2769","172.647843000","10.6550","1812.49","2079.03"
"41.177.241.128","41.177.241.177","4","543","0","0","4","543","172.920481000","25.9657","N/A","167.30"
"41.177.26.91","47.241.184.51","93","66876","60","62180","33","4696","172.958527000","55.4807","8966.00","677.14"
"117.255.177.145","244.3.210.197","357","277281","151","49669","206","227612","173.112562000","10.0235","39641.90","181662.04"
"244.3.153.33","244.3.202.202","4","626","2","173","2","453","173.134294000","33.1154","41.79","109.44"
"41.177.4.167","244.3.153.33","37","10284","16","4637","21","5647","173.159544000","2.7637","13422.62","16346.24"
"15.22.79.239","41.177.26.176","13","5349","5","455","8","4894","173.707867000","0.2462","14783.35","159010.33"
"68.64.225.84","244.3.210.197","823","774314","312","61107","511","713207","174.713983000","10.7673","45401.85","529905.18"
"145.95.41.31","145.95.81.118","2220","313263","1110","152058","1110","161205","176.415409000","20.4084","59605.97","63191.55"
"41.177.98.176","151.77.12.31","413","296292","219","257848","194","38444","176.439296000","49.9304","41313.15","6159.61"
"41.177.98.220","244.3.185.121","37","17768","19","9969","18","7799","176.581360000","27.1861","2933.56","2295.00"
"41.177.26.176","77.197.127.128","67","37106","38","34046","29","3060","176.731918000","2.3308","116856.52","10502.88"
"41.177.26.176","154.130.246.40","674","521576","409","492085","265","29491","176.921034000","27.7726","141746.94","8494.99"
"210.218.218.3","244.3.210.254","8","744","0","0","8","744","177.057529000","0.1009","N/A","58966.89"
"210.218.218.3","244.3.210.31","6","586","0","0","6","586","177.057578000","0.1009","N/A","46479.81"
"77.194.20.202","244.3.210.197","385","265309","191","66523","194","198786","177.115944000","13.4643","39525.70","118111.86"
"244.3.31.251","244.3.153.103","9","1026","0","0","9","1026","178.425433000","20.9979","N/A","390.90"
"41.177.98.98","244.3.31.43","11","1181","6","676","5","505","178.507036000","0.5839","9262.10","6919.17"
"41.177.26.15","210.176.151.45","906","868869","607","847974","299","20895","178.722677000","28.2672","239988.31","5913.57"
"41.177.230.130","244.3.153.117","9","1026","0","0","9","1026","178.768114000","21.1616","N/A","387.87"
"244.3.31.251","244.3.153.248","18","2052","0","0","18","2052","179.119495000","43.8820","N/A","374.09"
"85.186.156.144","244.3.210.197","877","774906","361","58942","516","715964","179.384691000","5.6550","83384.48","1012864.99"
"41.177.26.91","77.197.128.117","12","5411","5","4684","7","727","179.728711000","30.5962","1224.73","190.09"
"244.3.153.48","244.3.160.80","21","6585","10","3549","11","3036","180.155637000","15.2587","1860.71","1591.75"
"203.22.57.22","244.3.41.84","8","1822","5","343","3","1479","180.421030000","1.2882","2130.04","9184.64"
"41.177.98.143","244.145.41.106","3","298","1","140","2","158","181.219442000","0.1893","N/A","6676.28"
"67.91.20.26","244.3.210.255","2","132","2","132","0","0","181.553897000","3.0101","350.82","N/A"
"67.91.20.26","244.3.210.197","2","132","2","132","0","0","181.563536000","2.9953","352.55","N/A"
"67.91.20.26","244.3.210.230","2","132","2","132","0","0","181.579595000","2.9813","354.21","N/A"
"67.91.20.26","244.3.210.98","2","132","2","132","0","0","181.610355000","2.9494","358.04","N/A"
"67.91.20.26","244.3.210.39","3","198","3","198","0","0","181.699727000","5.0680","312.55","N/A"
"67.91.20.26","244.3.210.64","1","66","1","66","0","0","181.736054000","0.0000","N/A","N/A"
"67.91.20.26","244.3.210.108","1","66","1","66","0","0","181.743276000","0.0000","N/A","N/A"
"67.91.20.26","244.3.210.31","1","66","1","66","0","0","181.778353000","0.0000","N/A","N/A"
"41.177.98.220","41.177.211.208","24","4764","9","2964","15","1800","182.776310000","48.2336","491.61","298.55"
"210.218.218.3","244.3.164.155","2","128","0","0","2","128","183.403454000","0.0004","N/A","2892655.37"
"67.91.20.26","244.3.210.153","1","66","1","66","0","0","183.579696000","0.0000","N/A","N/A"
"67.91.20.26","244.3.210.224","2","132","2","132","0","0","183.611930000","0.0138","76284.04","N/A"
"67.91.20.26","244.3.210.94","1","66","1","66","0","0","183.633953000","0.0000","N/A","N/A"
"67.91.20.26","244.3.210.203","1","66","1","66","0","0","183.654032000","0.0000","N/A","N/A"
"67.91.20.26","244.3.210.144","1","66","1","66","0","0","183.669346000","0.0000","N/A","N/A"
"67.91.20.26","244.3.210.184","1","66","1","66","0","0","183.684380000","0.0000","N/A","N/A"
"67.91.20.26","244.3.210.41","1","66","1","66","0","0","183.699580000","0.0000","N/A","N/A"
"67.91.20.26","244.3.210.43","1","66","1","66","0","0","183.719628000","0.0000","N/A","N/A"
"67.91.20.26","244.3.210.145","1","66","1","66","0","0","183.735116000","0.0000","N/A","N/A"
"67.91.20.26","244.3.210.130","1","66","1","66","0","0","183.751213000","0.0000","N/A","N/A"
"67.91.20.26","244.3.210.61","1","66","1","66","0","0","183.758587000","0.0000","N/A","N/A"
"18.91.139.163","244.3.160.239","280","265938","92","7835","188","258103","183.766244000","2.6807","23382.01","770257.54"
"67.91.20.26","244.3.210.117","3","198","3","198","0","0","183.797763000","2.9727","532.85","N/A"
"41.177.3.124","210.218.218.3","2","128","2","128","0","0","183.824326000","0.0003","2959537.57","N/A"
"244.3.160.239","244.239.197.117","256","264343","70","6232","186","258111","183.862360000","2.5451","19589.38","811333.99"
"244.3.41.3","244.3.41.91","12","1152","12","1152","0","0","183.884130000","8.2507","1117.00","N/A"
"67.91.20.26","244.3.210.77","2","132","2","132","0","0","183.891639000","2.8836","366.21","N/A"
"67.91.20.26","244.3.210.181","2","132","2","132","0","0","183.907605000","2.8729","367.57","N/A"
"67.91.20.26","244.3.210.71","2","132","2","132","0","0","183.922438000","2.8562","369.72","N/A"
"67.91.20.26","244.3.210.103","2","132","2","132","0","0","183.931140000","2.8354","372.44","N/A"
"67.91.20.26","244.3.210.81","2","132","2","132","0","0","183.947093000","2.8233","374.03","N/A"
"67.91.20.26","244.3.210.26","2","132","2","132","0","0","183.966416000","2.9128","362.54","N/A"
"67.91.20.26","244.3.210.231","2","132","2","132","0","0","183.977908000","2.8927","365.06","N/A"
"67.91.20.26","244.3.210.111","2","132","2","132","0","0","183.993932000","2.8780","366.93","N/A"
"67.91.20.26","244.3.210.241","2","132","2","132","0","0","184.017194000","2.8627","368.88","N/A"
"67.91.20.26","244.3.210.40","2","132","2","132","0","0","184.032029000","2.8540","370.01","N/A"
"41.177.202.202","41.177.241.34","6","1018","3","764","3","254","184.473328000","0.0061","1010080.98","335812.26"
"40.193.71.79","41.177.241.34","14","1026","8","592","6","434","184.475781000","0.1108","42731.34","31326.69"
"41.177.31.203","210.218.218.3","3","192","3","192","0","0","184.957342000","0.0099","155875.79","N/A"
"41.177.202.17","244.3.153.34","1","346","0","0","1","346","185.775783000","0.0000","N/A","N/A"
"41.177.204.31","41.177.204.176","13","1381","13","1381","0","0","186.228241000","4.0020","2760.62","N/A"
"246.142.41.31","246.142.41.91","5","613","5","613","0","0","186.228339000","4.0020","1225.39","N/A"
"246.142.186.31","246.142.186.91","5","613","5","613","0","0","186.228370000","4.0020","1225.40","N/A"
"145.202.231.208","244.3.210.197","103","42571","34","3670","69","38901","186.230081000","5.6594","5187.81","54989.32"
"151.77.108.208","244.3.160.239","113","56542","49","8777","64","47765","186.491952000","1.4341","48963.08","266460.26"
"41.177.98.43","41.177.108.224","2","188","1","94","1","94","186.547424000","0.0002","N/A","N/A"
"41.177.98.176","90.218.72.90","34","24816","21","22034","13","2782","186.563451000","31.4382","5606.93","707.93"
"41.177.26.13","94.224.184.106","558","385591","329","343335","229","42256","186.595572000","46.0655","59625.58","7338.43"
"244.3.153.117","244.3.202.202","2","228","1","85","1","143","186.843085000","0.0011","N/A","N/A"
"244.3.210.39","244.3.210.203","93","26290","47","13704","46","12586","187.052616000","1.4118","77651.91","71316.91"
"244.3.41.152","244.3.153.197","20","2980","8","1140","12","1840","187.312868000","0.2382","38288.92","61799.66"
"41.177.3.203","244.3.164.39","2","188","1","94","1","94","187.326000000","0.0001","N/A","N/A"
"67.91.20.26","244.3.40.83","2","132","2","132","0","0","188.283837000","3.0119","350.61","N/A"
"244.3.210.153","244.3.210.203","70","18216","35","9383","35","8833","188.357258000","1.4097","53250.06","50128.72"
"67.91.20.26","244.3.40.80","1","66","1","66","0","0","188.793742000","0.0000","N/A","N/A"
"67.91.20.26","244.3.40.176","1","66","1","66","0","0","188.794504000","0.0000","N/A","N/A"
"67.91.20.26","244.3.40.198","1","66","1","66","0","0","188.807133000","0.0000","N/A","N/A"
"194.66.204.111","244.3.41.84","5","2843","2","219","3","2624","188.845814000","0.6461","2711.85","32492.64"
"77.197.128.108","244.3.210.197","48","38618","19","1915","29","36703","188.858937000","11.2678","1359.62","26058.61"
"41.177.98.220","244.3.3.249","7","1959","4","1601","3","358","188.983942000","0.3581","35767.44","7997.97"
"41.177.26.15","77.197.210.247","32","25237","19","24102","13","1135","189.333642000","0.7073","272623.16","12838.24"
"184.75.94.223","244.3.41.84","4","838","2","201","2","637","189.642364000","0.2574","6247.13","19798.13"
"244.3.34.239","244.3.41.84","3","701","1","66","2","635","189.650121000","0.0032","N/A","1602523.66"
"244.3.41.84","244.3.151.202","4","838","2","637","2","201","189.651420000","0.1567","32516.59","10260.34"
"244.3.41.84","244.3.77.194","4","769","2","637","2","132","189.651708000","0.1994","25553.85","5295.30"
"244.3.4.24","244.3.41.91","3","288","3","288","0","0","189.896329000","0.0005","4562376.24","N/A"
"41.177.26.176","77.197.128.225","655","384999","389","358419","266","26580","189.995406000","44.4488","64509.04","4783.93"
"18.239.218.37","244.3.210.197","323","265993","138","62291","185","203702","190.154494000","7.5451","66046.56","215983.30"
"41.177.204.176","41.177.204.251","1","229","0","0","1","229","190.230259000","0.0000","N/A","N/A"
"41.177.204.90","41.177.204.176","1","229","1","229","0","0","190.230307000","0.0000","N/A","N/A"
"30.222.71.108","244.3.160.239","741","265387","326","176064","415","89323","190.418291000","20.1097","70041.31","35534.24"
"41.177.26.15","77.197.210.241","474","490999","342","481944","132","9055","190.648119000","8.0525","478802.70","8995.98"
"41.177.26.15","77.197.128.127","588","563658","395","550094","193","13564","190.977332000","12.5381","350990.57","8654.59"
"66.218.67.128","244.3.31.40","4","320","2","132","2","188","191.129392000","3.0157","350.16","498.72"
"41.177.26.91","77.197.210.80","20","17580","13","16827","7","753","191.266980000","0.4134","325656.56","14572.97"
"41.177.26.15","77.197.217.218","170","157273","111","152837","59","4436","191.742847000","17.1604","71251.02","2068.02"
"253.37.253.251","253.160.108.83","30","15533","17","5681","13","9852","191.982815000","18.2116","2495.55","4327.79"
"41.177.98.220","244.3.93.242","1","64","0","0","1","64","192.034676000","0.0000","N/A","N/A"
"41.177.98.142","66.116.46.204","18","8988","9","8142","9","846","192.485636000","19.0533","3418.61","355.21"
"41.177.26.15","77.197.217.224","197","184222","130","179328","67","4894","192.842692000","10.5700","135726.47","3704.08"
"41.177.230.130","244.3.153.89","9","1026","0","0","9","1026","193.102224000","11.9998","N/A","684.01"
"41.177.26.15","77.197.128.55","485","453525","320","441392","165","12133","193.131957000","26.0183","135717.30","3730.60"
"68.83.160.23","244.3.210.197","2","142","1","64","1","78","193.336762000","0.0052","N/A","N/A"
"41.177.46.91","41.177.46.242","4","686","0","0","4","686","193.464941000","1.8598","N/A","2950.82"
"41.177.26.91","77.197.217.224","24","18635","14","17726","10","909","193.873217000","0.4677","303186.05","15547.56"
"41.177.26.176","168.82.241.192","57","43979","31","42098","26","1881","194.145605000","10.5288","31987.03","1429.23"
"184.4.145.77","244.3.41.84","46","9058","26","1860","20","7198","194.410639000","37.0615","401.49","1553.74"
"41.177.98.143","194.120.155.106","3","298","1","140","2","158","194.594454000","0.1629","N/A","7760.50"
"244.3.41.71","244.3.41.85","1","550","1","550","0","0","194.704991000","0.0000","N/A","N/A"
"41.177.98.220","244.3.185.254","27","4821","14","2929","13","1892","195.247342000","3.8701","6054.70","3911.06"
"15.38.91.90","41.177.26.176","26","10654","11","1201","15","9453","195.248318000","15.1595","633.79","4988.55"
"41.177.197.48","41.177.197.141","1","70","0","0","1","70","196.687603000","0.0000","N/A","N/A"
"41.177.3.47","91.91.91.91","4","1014","4","1014","0","0","196.736404000","0.0002","45830508.47","N/A"
"244.3.153.102","244.3.160.80","541","244509","234","40987","307","203522","197.006417000","36.2794","9038.07","44878.75"
"244.3.153.102","244.3.160.128","21","6387","11","2725","10","3662","197.620474000","13.1641","1656.03","2225.45"
"41.177.46.91","41.177.46.231","2","494","0","0","2","494","198.359811000","0.0002","N/A","26000000.00"
"41.177.26.91","41.177.159.151","2","128","1","64","1","64","198.535992000","0.0004","N/A","N/A"
"253.37.253.43","253.213.108.79","20","21357","20","21357","0","0","198.846186000","35.3785","4829.37","N/A"
"67.202.142.239","244.3.31.41","4","320","2","132","2","188","200.278999000","3.0305","348.46","496.30"
"244.3.31.156","244.3.41.84","195","59764","94","29081","101","30683","200.400944000","6.2276","37357.61","39415.54"
"41.177.197.43","41.177.197.91","2","494","2","494","0","0","200.548970000","0.0001","50025316.46","N/A"
"41.177.197.91","41.177.197.218","2","494","0","0","2","494","200.549054000","0.0001","N/A","58117647.06"
"41.177.230.91","41.177.230.118","4","988","0","0","4","988","200.549154000","0.0003","N/A","30996078.43"
"40.193.23.224","41.177.98.176","401","259722","162","21148","239","238574","200.765580000","19.8111","8539.87","96339.65"
"91.123.197.210","244.3.31.244","6","480","3","198","3","282","200.815689000","8.9363","177.25","252.45"
"41.177.202.202","41.177.241.23","6","1018","3","764","3","254","201.286154000","0.0069","885797.10","294492.75"
"40.193.71.79","41.177.241.23","14","1026","8","592","6","434","201.289476000","0.1050","45102.18","33064.78"
"41.177.98.57","244.157.67.98","2","188","1","94","1","94","201.294260000","0.0004","N/A","N/A"
"79.242.145.77","244.3.41.71","1","66","1","66","0","0","201.424147000","0.0000","N/A","N/A"
"244.3.31.251","244.3.153.56","3","288","0","0","3","288","201.716746000","2.9993","N/A","768.17"
"41.177.244.39","244.3.210.197","6","1459","4","1143","2","316","201.758113000","0.1945","47019.38","12999.23"
"85.210.77.218","244.3.210.98","15","7782","8","7257","7","525","201.920998000","2.2184","26170.26","1893.26"
"41.177.98.142","168.176.95.55","17","8922","9","8145","8","777","202.007220000","17.8708","3646.17","347.83"
"186.77.47.194","244.3.210.98","11","1145","5","669","6","476","202.122641000","8.1578","656.06","466.79"
"122.136.142.116","244.3.210.98","58","48308","34","46684","24","1624","202.199626000","0.3046","1226134.55","42653.64"
"244.3.3.145","244.3.160.239","844","430995","355","44913","489","386082","202.225686000","1.5175","236771.30","2035338.04"
"30.251.75.92","244.3.61.225","2","132","2","132","0","0","202.278822000","2.9396","359.24","N/A"
"41.177.3.81","145.95.48.57","1","70","0","0","1","70","202.394693000","0.0000","N/A","N/A"
"77.197.64.211","244.3.210.98","30","17630","15","16449","15","1181","202.488309000","0.9193","143145.25","10277.50"
"41.177.93.93","244.3.41.84","15","5501","8","634","7","4867","203.643356000","13.2534","382.69","2937.82"
"41.177.26.176","79.108.231.127","7","460","3","198","4","262","203.664790000","0.5754","2753.04","3642.90"
"41.177.98.98","41.177.108.224","2","188","1","94","1","94","205.680795000","0.0002","N/A","N/A"
"151.77.39.25","244.3.160.239","1041","675569","358","28980","683","646589","205.730167000","11.1638","20767.20","463348.72"
"244.3.160.239","246.220.26.95","1071","995888","378","29797","693","966091","205.733846000","11.2216","21242.60","688736.54"
"41.177.26.176","77.197.13.80","108","74666","66","70766","42","3900","206.042993000","4.1718","135702.88","7478.75"
"244.3.31.156","244.3.153.33","35","10134","16","4627","19","5507","206.254596000","1.9856","18642.40","22187.96"
"41.177.3.203","41.177.108.224","2","188","1","94","1","94","206.325772000","0.0002","N/A","N/A"
"244.3.31.251","244.3.153.252","9","1026","0","0","9","1026","206.379858000","21.0003","N/A","390.85"
"41.177.26.13","225.176.204.185","93","85022","62","81523","31","3499","206.838754000","15.8259","41209.97","1768.75"
"177.202.57.176","244.3.210.197","631","592891","233","31033","398","561858","207.339821000","9.6791","25649.60","464390.60"
"41.177.92.61","41.177.98.176","161","94345","75","35333","86","59012","207.355687000","23.5610","11997.12","20037.18"
"77.197.106.167","244.3.210.197","14","8919","7","853","7","8066","208.553726000","0.3380","20187.56","190894.30"
"244.3.153.56","244.3.202.202","6","848","3","274","3","574","208.620635000","0.4329","5063.10","10606.65"
"90.150.181.71","244.3.210.197","778","744378","278","52182","500","692196","209.000809000","8.1420","51272.02","680125.06"
"193.211.164.18","244.3.61.225","2","132","2","132","0","0","209.109709000","2.9555","357.30","N/A"
"253.37.253.43","253.180.253.254","70","23561","70","23561","0","0","209.330555000","18.8908","9977.79","N/A"
"16.119.77.194","41.177.26.15","21","9841","10","1122","11","8719","209.979346000","21.6652","414.30","3219.53"
"253.37.253.43","253.98.22.203","13","6400","13","6400","0","0","210.295247000","19.6053","2611.54","N/A"
"16.181.176.168","244.3.31.26","4","320","2","132","2","188","210.324257000","2.9186","361.82","515.31"
"41.177.26.46","106.37.77.3","9","1135","4","452","5","683","210.415001000","0.3847","9400.44","14204.64"
"244.3.153.56","244.3.153.91","9","864","9","864","0","0","210.726832000","1.5001","4607.68","N/A"
"215.13.66.186","244.3.160.239","12","3273","6","1509","6","1764","210.735125000","0.5248","23002.22","26889.27"
"244.3.160.239","244.193.156.82","10","3107","6","1395","4","1712","210.897837000","0.3755","29721.24","36475.10"
"244.3.153.248","244.3.202.202","4","598","2","195","2","403","211.224034000","6.0072","259.69","536.69"
"41.177.98.143","41.194.210.239","3","298","1","140","2","158","211.648317000","0.2087","N/A","6056.51"
"41.177.132.22","244.3.160.239","198","82013","85","18165","113","63848","211.956383000","1.8189","79895.23","280823.06"
"41.177.98.143","186.45.149.203","3","328","1","152","2","176","211.994022000","0.2000","N/A","7041.69"
"41.177.93.39","244.3.41.84","5","2106","2","149","3","1957","212.007989000","1.0001","1191.86","15654.17"
"244.3.197.47","253.37.253.43","1","127","0","0","1","127","214.640666000","0.0000","N/A","N/A"
"41.177.26.15","48.176.68.231","167","150608","105","145563","62","5045","215.056767000","16.4789","70666.44","2449.20"
"41.177.26.176","249.18.39.225","278","143217","160","125719","118","17498","215.997706000","18.4741","54441.32","7577.33"
"41.177.98.220","244.3.185.118","4","1477","2","1271","2","206","216.260516000","0.2235","45502.96","7374.99"
"41.177.26.15","241.203.149.40","11","1328","5","580","6","748","216.600772000","2.2480","2064.10","2661.98"
"244.3.160.239","244.3.253.224","575","231308","307","179562","268","51746","216.807235000","6.2289","230618.63","66459.45"
"197.154.128.255","244.3.160.239","12","3330","5","1900","7","1430","217.816635000","0.0147","1032608.70","777173.91"
"41.177.26.176","145.219.142.106","1247","1066157","830","991215","417","74942","218.232768000","15.9521","497096.93","37583.61"
"244.3.41.47","244.3.41.84","4","325","2","151","2","174","218.473422000","0.2188","5521.23","6362.21"
"41.177.26.15","77.197.210.160","130","119279","85","115747","45","3532","218.846712000","7.4141","124894.39","3811.13"
"244.3.31.34","244.3.31.91","6","576","6","576","0","0","218.967198000","1.4976","3076.97","N/A"
"244.3.34.223","244.3.41.84","8","2742","4","318","4","2424","219.194525000","0.8916","2853.35","21750.05"
"41.177.26.15","77.197.210.152","31","20076","18","18561","13","1515","219.212635000","2.7899","53222.90","4344.20"
"41.177.26.176","77.197.128.193","363","222483","216","207357","147","15126","219.644394000","14.6473","113253.26","8261.45"
"244.3.2.111","244.3.210.197","23","16722","10","1972","13","14750","219.676959000","0.2123","74306.44","555791.06"
"41.177.24.154","244.3.31.46","51","25713","31","24229","20","1484","219.747021000","0.0572","3388908.32","207566.96"
"253.37.253.43","253.142.253.37","12","8891","12","8891","0","0","220.174445000","14.1079","5041.71","N/A"
"41.177.26.15","77.197.210.111","152","150611","106","147364","46","3247","220.414917000","1.0899","1081687.74","23833.77"
"41.177.26.15","77.197.128.165","635","609613","425","594959","210","14654","220.718708000","10.6199","448185.40","11038.93"
"244.3.202.130","244.3.202.235","1","247","1","247","0","0","220.739327000","0.0000","N/A","N/A"
"244.3.4.157","244.3.41.91","3","741","3","741","0","0","220.739432000","0.0005","11808764.94","N/A"
"41.177.26.15","77.197.210.231","14","9337","8","8595","6","742","221.224699000","0.6848","100412.10","8668.50"
"41.177.26.91","77.197.210.37","17","12677","10","11931","7","746","221.381305000","0.3926","243102.82","15200.29"
"41.177.3.38","210.218.218.3","2","128","2","128","0","0","221.473566000","0.0005","2077079.11","N/A"
"41.177.98.176","244.3.185.176","53","47012","38","43107","15","3905","221.563963000","4.2920","80348.41","7278.64"
"244.3.31.57","244.3.31.91","2","192","2","192","0","0","221.847581000","0.0002","9600000.00","N/A"
"41.177.26.15","77.197.210.117","39","33782","25","32583","14","1199","222.329843000","0.8662","300918.81","11073.31"
"47.3.161.202","244.3.41.84","8","1480","5","332","3","1148","223.046433000","1.2574","2112.25","7303.81"
"210.218.218.3","244.3.41.77","1","117","0","0","1","117","223.182276000","0.0000","N/A","N/A"
"210.218.218.3","244.3.176.161","1","90","0","0","1","90","223.453108000","0.0000","N/A","N/A"
"41.177.26.91","77.197.210.117","55","44444","32","42310","23","2134","223.501459000","8.8458","38264.52","1929.96"
"41.177.26.46","254.194.155.203","1101","1124119","769","1099271","332","24848","223.711716000","10.6921","822492.12","18591.67"
"41.177.26.15","77.197.128.251","126","114189","80","110942","46","3247","224.741379000","1.0903","814036.63","23824.85"
"41.177.26.91","77.197.128.55","22","18552","14","17728","8","824","225.483845000","0.5044","281173.11","13068.97"
"41.177.230.130","244.3.153.48","3","342","0","0","3","342","225.548899000","2.9995","N/A","912.17"
"244.3.153.91","244.3.153.248","3","741","0","0","3","741","226.847309000","0.0002","N/A","36819875.78"
"244.3.41.84","244.3.77.193","2","128","0","0","2","128","227.141562000","0.0268","N/A","38257.49"
"41.177.26.176","142.117.244.30","27","10350","16","9326","11","1024","227.417113000","1.5570","47917.21","5261.34"
"244.3.210.197","252.66.75.111","585","643039","428","597355","157","45684","227.691108000","6.5076","734342.79","56160.43"
"68.157.168.135","244.3.210.197","12","3125","7","755","5","2370","228.048994000","4.1775","1445.85","4538.63"
"18.22.43.17","41.177.26.15","360","305286","132","12255","228","293031","228.227456000","5.0060","19584.67","468291.86"
"26.39.254.244","41.177.26.91","26","15022","12","1000","14","14022","228.267303000","0.7637","10475.40","146886.06"
"41.177.34.163","41.177.98.176","318","228762","141","25905","177","202857","231.129174000","2.2703","91281.52","714807.79"
"244.3.153.0","244.3.153.91","3","660","3","660","0","0","231.802655000","0.0002","29010989.01","N/A"
"184.75.94.39","244.3.41.84","4","2287","2","159","2","2128","232.541726000","0.1275","9980.23","133571.85"
"41.177.218.40","41.177.218.48","1","96","1","96","0","0","232.603966000","0.0000","N/A","N/A"
"41.177.202.249","244.3.153.106","2","128","1","64","1","64","232.754613000","0.1439","N/A","N/A"
"41.177.26.176","239.152.156.75","7","460","3","198","4","262","233.140813000","0.5111","3099.42","4101.26"
"5ba4:dada:dada:dada:dada:dada:daa0:daa4","caf4:dada:dada:dada:a46c:8e5b:cae1:ca82","2","220","0","0","2","220","1.130406000","121.0603","N/A","14.54"
"5ba4:dada:dada:dada:dada:dada:daa0:daa4","caf4:dada:dada:dada:a46c:8e5b:cae1:8e37","2","220","0","0","2","220","8.302300000","126.3167","N/A","13.93"
"5ba4:dada:dada:dada:dada:dada:daa0:daa4","caf4:dada:dada:dada:a46c:8e5b:cae1:80e0","2","220","0","0","2","220","21.182759000","119.6321","N/A","14.71"
"5ba4:dada:dada:dada:dada:dada:daa0:daa4","caf4:dada:dada:dada:a46c:8e5b:cae1:80d2","1","110","0","0","1","110","34.426799000","0.0000","N/A","N/A"
"5ba4:dada:dada:dada:dada:dada:daa0:daa4","caf4:dada:dada:dada:a46c:8e5b:cae1:4df4","1","110","0","0","1","110","55.467230000","0.0000","N/A","N/A"
"5ba4:dada:dada:dada:dada:dada:daa0:daa4","caf4:dada:dada:dada:a46c:8e5b:cae1:e02d","2","220","0","0","2","220","55.660447000","108.8799","N/A","16.16"
"5ba4:dada:dada:dada:dada:dada:daa0:daa4","caf4:dada:dada:dada:a46c:8e5b:cae1:4dc2","2","220","0","0","2","220","84.263423000","116.3809","N/A","15.12"
"5ba4:dada:dada:dada:dada:dada:daa0:daa4","caf4:dada:dada:dada:a46c:8e5b:cae1:4d9d","2","220","0","0","2","220","90.378212000","124.2041","N/A","14.17"
"5ba4:dada:dada:dada:dada:dada:dada:daa0","caf4:dada:dada:dada:a46a:5f5b:cab0:b4da","2","244","0","0","2","244","107.013562000","18.0681","N/A","108.04"
"5ba4:dada:dada:dada:dada:dada:daa0:daa4","caf4:dada:dada:dada:a46c:8e5b:cae1:846a","1","110","0","0","1","110","123.130003000","0.0000","N/A","N/A"
